PokerStars Home Game Hand #225900992531: {Club #4781089}  Hold'em No Limit (50/100) - 2021/04/16 23:01:08 EET [2021/04/16 16:01:08 ET]
Table 'NLHE Session 2' 2-max (Play Money) Seat #1 is the button
Seat 1: FDIBA2009 (10000 in chips) 
Seat 2: s70n3fac3 (10000 in chips) 
FDIBA2009: posts small blind 50
s70n3fac3: posts big blind 100
*** HOLE CARDS ***
FDIBA2009: raises 100 to 200
s70n3fac3: folds 
Uncalled bet (100) returned to FDIBA2009
FDIBA2009 collected 200 from pot
*** SUMMARY ***
Total pot 200 | Rake 0 
Seat 1: FDIBA2009 (button) (small blind) collected (200)
Seat 2: s70n3fac3 (big blind) folded before Flop



PokerStars Home Game Hand #225901000401: {Club #4781089}  Hold'em No Limit (50/100) - 2021/04/16 23:01:21 EET [2021/04/16 16:01:21 ET]
Table 'NLHE Session 2' 2-max (Play Money) Seat #2 is the button
Seat 1: FDIBA2009 (10100 in chips) 
Seat 2: s70n3fac3 (9900 in chips) 
s70n3fac3: posts small blind 50
FDIBA2009: posts big blind 100
*** HOLE CARDS ***
s70n3fac3: folds 
Uncalled bet (50) returned to FDIBA2009
FDIBA2009 collected 100 from pot
*** SUMMARY ***
Total pot 100 | Rake 0 
Seat 1: FDIBA2009 (big blind) collected (100)
Seat 2: s70n3fac3 (button) (small blind) folded before Flop



PokerStars Home Game Hand #225901005640: {Club #4781089}  Hold'em No Limit (50/100) - 2021/04/16 23:01:30 EET [2021/04/16 16:01:30 ET]
Table 'NLHE Session 2' 2-max (Play Money) Seat #1 is the button
Seat 1: FDIBA2009 (10150 in chips) 
Seat 2: s70n3fac3 (9850 in chips) 
FDIBA2009: posts small blind 50
s70n3fac3: posts big blind 100
*** HOLE CARDS ***
FDIBA2009: raises 100 to 200
s70n3fac3: calls 100
*** FLOP *** [4c Tc 8c]
s70n3fac3: checks 
FDIBA2009: checks 
*** TURN *** [4c Tc 8c] [5h]
s70n3fac3: checks 
FDIBA2009: checks 
*** RIVER *** [4c Tc 8c 5h] [4d]
s70n3fac3 said, "+95.69 ÑÐ¸ Ð¾Ñ Ð²ÑÐµÑÐ°"
s70n3fac3 said, "si ot vhcera"
s70n3fac3 has timed out
s70n3fac3: checks 
FDIBA2009 said, "?"
FDIBA2009: checks 
*** SHOW DOWN ***
s70n3fac3: shows [9h 6c] (a pair of Fours)
FDIBA2009: shows [3h Kh] (a pair of Fours - King kicker)
s70n3fac3 said, "+95.69"
FDIBA2009 collected 378 from pot
*** SUMMARY ***
Total pot 400 | Rake 22 
Board [4c Tc 8c 5h 4d]
Seat 1: FDIBA2009 (button) (small blind) showed [3h Kh] and won (378) with a pair of Fours
Seat 2: s70n3fac3 (big blind) showed [9h 6c] and lost with a pair of Fours



PokerStars Home Game Hand #225901041748: {Club #4781089}  Hold'em No Limit (50/100) - 2021/04/16 23:02:25 EET [2021/04/16 16:02:25 ET]
Table 'NLHE Session 2' 2-max (Play Money) Seat #2 is the button
Seat 1: FDIBA2009 (10328 in chips) 
Seat 2: s70n3fac3 (9650 in chips) 
s70n3fac3: posts small blind 50
FDIBA2009: posts big blind 100
*** HOLE CARDS ***
FDIBA2009 said, "ok"
s70n3fac3: raises 220 to 320
FDIBA2009: calls 220
*** FLOP *** [6d Ad 3s]
FDIBA2009: checks 
s70n3fac3: bets 345
FDIBA2009: calls 345
*** TURN *** [6d Ad 3s] [Js]
FDIBA2009: checks 
s70n3fac3: checks 
*** RIVER *** [6d Ad 3s Js] [Kh]
FDIBA2009: checks 
s70n3fac3: bets 777
FDIBA2009: folds 
Uncalled bet (777) returned to s70n3fac3
s70n3fac3 collected 1257 from pot
s70n3fac3: doesn't show hand 
*** SUMMARY ***
Total pot 1330 | Rake 73 
Board [6d Ad 3s Js Kh]
Seat 1: FDIBA2009 (big blind) folded on the River
Seat 2: s70n3fac3 (button) (small blind) collected (1257)



PokerStars Home Game Hand #225901076642: {Club #4781089}  Hold'em No Limit (50/100) - 2021/04/16 23:03:17 EET [2021/04/16 16:03:17 ET]
Table 'NLHE Session 2' 2-max (Play Money) Seat #1 is the button
Seat 1: FDIBA2009 (9663 in chips) 
Seat 2: s70n3fac3 (10242 in chips) 
FDIBA2009: posts small blind 50
s70n3fac3: posts big blind 100
*** HOLE CARDS ***
FDIBA2009: folds 
Uncalled bet (50) returned to s70n3fac3
s70n3fac3 collected 100 from pot
s70n3fac3: doesn't show hand 
*** SUMMARY ***
Total pot 100 | Rake 0 
Seat 1: FDIBA2009 (button) (small blind) folded before Flop
Seat 2: s70n3fac3 (big blind) collected (100)



PokerStars Home Game Hand #225901079718: {Club #4781089}  Hold'em No Limit (50/100) - 2021/04/16 23:03:22 EET [2021/04/16 16:03:22 ET]
Table 'NLHE Session 2' 2-max (Play Money) Seat #2 is the button
Seat 1: FDIBA2009 (9613 in chips) 
Seat 2: s70n3fac3 (10292 in chips) 
s70n3fac3: posts small blind 50
FDIBA2009: posts big blind 100
*** HOLE CARDS ***
s70n3fac3: calls 50
FDIBA2009: raises 200 to 300
s70n3fac3: folds 
Uncalled bet (200) returned to FDIBA2009
FDIBA2009 collected 200 from pot
*** SUMMARY ***
Total pot 200 | Rake 0 
Seat 1: FDIBA2009 (big blind) collected (200)
Seat 2: s70n3fac3 (button) (small blind) folded before Flop



PokerStars Home Game Hand #225901086602: {Club #4781089}  Hold'em No Limit (50/100) - 2021/04/16 23:03:32 EET [2021/04/16 16:03:32 ET]
Table 'NLHE Session 2' 2-max (Play Money) Seat #1 is the button
Seat 1: FDIBA2009 (9713 in chips) 
Seat 2: s70n3fac3 (10192 in chips) 
FDIBA2009: posts small blind 50
s70n3fac3: posts big blind 100
*** HOLE CARDS ***
FDIBA2009: raises 200 to 300
s70n3fac3: raises 400 to 700
FDIBA2009: calls 400
*** FLOP *** [8c 5d 9c]
s70n3fac3: bets 656
FDIBA2009: folds 
Uncalled bet (656) returned to s70n3fac3
s70n3fac3 collected 1323 from pot
s70n3fac3: doesn't show hand 
*** SUMMARY ***
Total pot 1400 | Rake 77 
Board [8c 5d 9c]
Seat 1: FDIBA2009 (button) (small blind) folded on the Flop
Seat 2: s70n3fac3 (big blind) collected (1323)



PokerStars Home Game Hand #225901103575: {Club #4781089}  Hold'em No Limit (50/100) - 2021/04/16 23:03:58 EET [2021/04/16 16:03:58 ET]
Table 'NLHE Session 2' 2-max (Play Money) Seat #2 is the button
Seat 1: FDIBA2009 (9013 in chips) 
Seat 2: s70n3fac3 (10815 in chips) 
s70n3fac3: posts small blind 50
FDIBA2009: posts big blind 100
*** HOLE CARDS ***
s70n3fac3: calls 50
FDIBA2009: raises 200 to 300
s70n3fac3: folds 
Uncalled bet (200) returned to FDIBA2009
FDIBA2009 collected 200 from pot
*** SUMMARY ***
Total pot 200 | Rake 0 
Seat 1: FDIBA2009 (big blind) collected (200)
Seat 2: s70n3fac3 (button) (small blind) folded before Flop



PokerStars Home Game Hand #225901112634: {Club #4781089}  Hold'em No Limit (50/100) - 2021/04/16 23:04:11 EET [2021/04/16 16:04:11 ET]
Table 'NLHE Session 2' 2-max (Play Money) Seat #1 is the button
Seat 1: FDIBA2009 (9113 in chips) 
Seat 2: s70n3fac3 (10715 in chips) 
FDIBA2009: posts small blind 50
s70n3fac3: posts big blind 100
*** HOLE CARDS ***
FDIBA2009: raises 100 to 200
s70n3fac3: calls 100
*** FLOP *** [4h 8s Kc]
s70n3fac3: checks 
FDIBA2009: bets 378
s70n3fac3: folds 
Uncalled bet (378) returned to FDIBA2009
FDIBA2009 collected 378 from pot
*** SUMMARY ***
Total pot 400 | Rake 22 
Board [4h 8s Kc]
Seat 1: FDIBA2009 (button) (small blind) collected (378)
Seat 2: s70n3fac3 (big blind) folded on the Flop



PokerStars Home Game Hand #225901125455: {Club #4781089}  Hold'em No Limit (50/100) - 2021/04/16 23:04:30 EET [2021/04/16 16:04:30 ET]
Table 'NLHE Session 2' 2-max (Play Money) Seat #2 is the button
Seat 1: FDIBA2009 (9291 in chips) 
Seat 2: s70n3fac3 (10515 in chips) 
s70n3fac3: posts small blind 50
FDIBA2009: posts big blind 100
*** HOLE CARDS ***
s70n3fac3: raises 160 to 260
FDIBA2009: folds 
Uncalled bet (160) returned to s70n3fac3
s70n3fac3 collected 200 from pot
s70n3fac3: doesn't show hand 
*** SUMMARY ***
Total pot 200 | Rake 0 
Seat 1: FDIBA2009 (big blind) folded before Flop
Seat 2: s70n3fac3 (button) (small blind) collected (200)



PokerStars Home Game Hand #225901131081: {Club #4781089}  Hold'em No Limit (50/100) - 2021/04/16 23:04:38 EET [2021/04/16 16:04:38 ET]
Table 'NLHE Session 2' 2-max (Play Money) Seat #1 is the button
Seat 1: FDIBA2009 (9191 in chips) 
Seat 2: s70n3fac3 (10615 in chips) 
FDIBA2009: posts small blind 50
s70n3fac3: posts big blind 100
*** HOLE CARDS ***
FDIBA2009: raises 100 to 200
s70n3fac3: folds 
Uncalled bet (100) returned to FDIBA2009
FDIBA2009 collected 200 from pot
*** SUMMARY ***
Total pot 200 | Rake 0 
Seat 1: FDIBA2009 (button) (small blind) collected (200)
Seat 2: s70n3fac3 (big blind) folded before Flop



PokerStars Home Game Hand #225901135877: {Club #4781089}  Hold'em No Limit (50/100) - 2021/04/16 23:04:45 EET [2021/04/16 16:04:45 ET]
Table 'NLHE Session 2' 2-max (Play Money) Seat #2 is the button
Seat 1: FDIBA2009 (9291 in chips) 
Seat 2: s70n3fac3 (10515 in chips) 
s70n3fac3: posts small blind 50
FDIBA2009: posts big blind 100
*** HOLE CARDS ***
s70n3fac3: folds 
Uncalled bet (50) returned to FDIBA2009
FDIBA2009 collected 100 from pot
*** SUMMARY ***
Total pot 100 | Rake 0 
Seat 1: FDIBA2009 (big blind) collected (100)
Seat 2: s70n3fac3 (button) (small blind) folded before Flop



PokerStars Home Game Hand #225901139307: {Club #4781089}  Hold'em No Limit (50/100) - 2021/04/16 23:04:50 EET [2021/04/16 16:04:50 ET]
Table 'NLHE Session 2' 2-max (Play Money) Seat #1 is the button
Seat 1: FDIBA2009 (9341 in chips) 
Seat 2: s70n3fac3 (10465 in chips) 
FDIBA2009: posts small blind 50
s70n3fac3: posts big blind 100
*** HOLE CARDS ***
FDIBA2009: raises 100 to 200
s70n3fac3: raises 200 to 400
FDIBA2009: calls 200
*** FLOP *** [9c As 8s]
s70n3fac3: bets 425
FDIBA2009: folds 
Uncalled bet (425) returned to s70n3fac3
s70n3fac3 collected 756 from pot
s70n3fac3: doesn't show hand 
*** SUMMARY ***
Total pot 800 | Rake 44 
Board [9c As 8s]
Seat 1: FDIBA2009 (button) (small blind) folded on the Flop
Seat 2: s70n3fac3 (big blind) collected (756)



PokerStars Home Game Hand #225901152468: {Club #4781089}  Hold'em No Limit (50/100) - 2021/04/16 23:05:09 EET [2021/04/16 16:05:09 ET]
Table 'NLHE Session 2' 2-max (Play Money) Seat #2 is the button
Seat 1: FDIBA2009 (8941 in chips) 
Seat 2: s70n3fac3 (10821 in chips) 
s70n3fac3: posts small blind 50
FDIBA2009: posts big blind 100
*** HOLE CARDS ***
s70n3fac3: raises 130 to 230
FDIBA2009: folds 
Uncalled bet (130) returned to s70n3fac3
s70n3fac3 collected 200 from pot
s70n3fac3: doesn't show hand 
*** SUMMARY ***
Total pot 200 | Rake 0 
Seat 1: FDIBA2009 (big blind) folded before Flop
Seat 2: s70n3fac3 (button) (small blind) collected (200)



PokerStars Home Game Hand #225901157578: {Club #4781089}  Hold'em No Limit (50/100) - 2021/04/16 23:05:16 EET [2021/04/16 16:05:16 ET]
Table 'NLHE Session 2' 2-max (Play Money) Seat #1 is the button
Seat 1: FDIBA2009 (8841 in chips) 
Seat 2: s70n3fac3 (10921 in chips) 
FDIBA2009: posts small blind 50
s70n3fac3: posts big blind 100
*** HOLE CARDS ***
FDIBA2009: raises 100 to 200
s70n3fac3: folds 
Uncalled bet (100) returned to FDIBA2009
FDIBA2009 collected 200 from pot
*** SUMMARY ***
Total pot 200 | Rake 0 
Seat 1: FDIBA2009 (button) (small blind) collected (200)
Seat 2: s70n3fac3 (big blind) folded before Flop



PokerStars Home Game Hand #225901162118: {Club #4781089}  Hold'em No Limit (50/100) - 2021/04/16 23:05:23 EET [2021/04/16 16:05:23 ET]
Table 'NLHE Session 2' 2-max (Play Money) Seat #2 is the button
Seat 1: FDIBA2009 (8941 in chips) 
Seat 2: s70n3fac3 (10821 in chips) 
s70n3fac3: posts small blind 50
FDIBA2009: posts big blind 100
*** HOLE CARDS ***
s70n3fac3: folds 
Uncalled bet (50) returned to FDIBA2009
FDIBA2009 collected 100 from pot
*** SUMMARY ***
Total pot 100 | Rake 0 
Seat 1: FDIBA2009 (big blind) collected (100)
Seat 2: s70n3fac3 (button) (small blind) folded before Flop



PokerStars Home Game Hand #225901165218: {Club #4781089}  Hold'em No Limit (50/100) - 2021/04/16 23:05:28 EET [2021/04/16 16:05:28 ET]
Table 'NLHE Session 2' 2-max (Play Money) Seat #1 is the button
Seat 1: FDIBA2009 (8991 in chips) 
Seat 2: s70n3fac3 (10771 in chips) 
FDIBA2009: posts small blind 50
s70n3fac3: posts big blind 100
*** HOLE CARDS ***
FDIBA2009: raises 100 to 200
s70n3fac3: calls 100
*** FLOP *** [6c 9h 2d]
s70n3fac3: bets 185
FDIBA2009: calls 185
*** TURN *** [6c 9h 2d] [3h]
s70n3fac3: bets 313
FDIBA2009: calls 313
*** RIVER *** [6c 9h 2d 3h] [2h]
s70n3fac3: bets 566
FDIBA2009: folds 
Uncalled bet (566) returned to s70n3fac3
s70n3fac3 collected 1319 from pot
s70n3fac3: doesn't show hand 
*** SUMMARY ***
Total pot 1396 | Rake 77 
Board [6c 9h 2d 3h 2h]
Seat 1: FDIBA2009 (button) (small blind) folded on the River
Seat 2: s70n3fac3 (big blind) collected (1319)



PokerStars Home Game Hand #225901187479: {Club #4781089}  Hold'em No Limit (50/100) - 2021/04/16 23:06:01 EET [2021/04/16 16:06:01 ET]
Table 'NLHE Session 2' 2-max (Play Money) Seat #2 is the button
Seat 1: FDIBA2009 (8293 in chips) 
Seat 2: s70n3fac3 (11392 in chips) 
s70n3fac3: posts small blind 50
FDIBA2009: posts big blind 100
*** HOLE CARDS ***
s70n3fac3: folds 
Uncalled bet (50) returned to FDIBA2009
FDIBA2009 collected 100 from pot
*** SUMMARY ***
Total pot 100 | Rake 0 
Seat 1: FDIBA2009 (big blind) collected (100)
Seat 2: s70n3fac3 (button) (small blind) folded before Flop



PokerStars Home Game Hand #225901190366: {Club #4781089}  Hold'em No Limit (50/100) - 2021/04/16 23:06:05 EET [2021/04/16 16:06:05 ET]
Table 'NLHE Session 2' 2-max (Play Money) Seat #1 is the button
Seat 1: FDIBA2009 (8343 in chips) 
Seat 2: s70n3fac3 (11342 in chips) 
FDIBA2009: posts small blind 50
s70n3fac3: posts big blind 100
*** HOLE CARDS ***
FDIBA2009: raises 200 to 300
s70n3fac3: folds 
Uncalled bet (200) returned to FDIBA2009
FDIBA2009 collected 200 from pot
*** SUMMARY ***
Total pot 200 | Rake 0 
Seat 1: FDIBA2009 (button) (small blind) collected (200)
Seat 2: s70n3fac3 (big blind) folded before Flop



PokerStars Home Game Hand #225901195084: {Club #4781089}  Hold'em No Limit (50/100) - 2021/04/16 23:06:12 EET [2021/04/16 16:06:12 ET]
Table 'NLHE Session 2' 2-max (Play Money) Seat #2 is the button
Seat 1: FDIBA2009 (8443 in chips) 
Seat 2: s70n3fac3 (11242 in chips) 
s70n3fac3: posts small blind 50
FDIBA2009: posts big blind 100
*** HOLE CARDS ***
s70n3fac3: raises 100 to 200
FDIBA2009: folds 
Uncalled bet (100) returned to s70n3fac3
s70n3fac3 collected 200 from pot
s70n3fac3: doesn't show hand 
*** SUMMARY ***
Total pot 200 | Rake 0 
Seat 1: FDIBA2009 (big blind) folded before Flop
Seat 2: s70n3fac3 (button) (small blind) collected (200)



PokerStars Home Game Hand #225901199347: {Club #4781089}  Hold'em No Limit (50/100) - 2021/04/16 23:06:18 EET [2021/04/16 16:06:18 ET]
Table 'NLHE Session 2' 2-max (Play Money) Seat #1 is the button
Seat 1: FDIBA2009 (8343 in chips) 
Seat 2: s70n3fac3 (11342 in chips) 
FDIBA2009: posts small blind 50
s70n3fac3: posts big blind 100
*** HOLE CARDS ***
FDIBA2009: raises 100 to 200
s70n3fac3: raises 285 to 485
FDIBA2009: raises 970 to 1455
s70n3fac3: raises 1470 to 2925
FDIBA2009: calls 1470
*** FLOP *** [5d 8d 5s]
s70n3fac3: bets 3655
FDIBA2009: folds 
Uncalled bet (3655) returned to s70n3fac3
s70n3fac3 collected 5528 from pot
s70n3fac3: doesn't show hand 
*** SUMMARY ***
Total pot 5850 | Rake 322 
Board [5d 8d 5s]
Seat 1: FDIBA2009 (button) (small blind) folded on the Flop
Seat 2: s70n3fac3 (big blind) collected (5528)



PokerStars Home Game Hand #225901235597: {Club #4781089}  Hold'em No Limit (50/100) - 2021/04/16 23:07:12 EET [2021/04/16 16:07:12 ET]
Table 'NLHE Session 2' 2-max (Play Money) Seat #2 is the button
Seat 1: FDIBA2009 (5418 in chips) 
Seat 2: s70n3fac3 (13945 in chips) 
s70n3fac3: posts small blind 50
FDIBA2009: posts big blind 100
*** HOLE CARDS ***
s70n3fac3: raises 120 to 220
FDIBA2009: raises 5198 to 5418 and is all-in
s70n3fac3: folds 
Uncalled bet (5198) returned to FDIBA2009
FDIBA2009 collected 440 from pot
*** SUMMARY ***
Total pot 440 | Rake 0 
Seat 1: FDIBA2009 (big blind) collected (440)
Seat 2: s70n3fac3 (button) (small blind) folded before Flop



PokerStars Home Game Hand #225901244950: {Club #4781089}  Hold'em No Limit (50/100) - 2021/04/16 23:07:25 EET [2021/04/16 16:07:25 ET]
Table 'NLHE Session 2' 2-max (Play Money) Seat #1 is the button
Seat 1: FDIBA2009 (5638 in chips) 
Seat 2: s70n3fac3 (13725 in chips) 
FDIBA2009: posts small blind 50
s70n3fac3: posts big blind 100
*** HOLE CARDS ***
FDIBA2009: raises 200 to 300
s70n3fac3: folds 
Uncalled bet (200) returned to FDIBA2009
FDIBA2009 collected 200 from pot
*** SUMMARY ***
Total pot 200 | Rake 0 
Seat 1: FDIBA2009 (button) (small blind) collected (200)
Seat 2: s70n3fac3 (big blind) folded before Flop



PokerStars Home Game Hand #225901252183: {Club #4781089}  Hold'em No Limit (50/100) - 2021/04/16 23:07:36 EET [2021/04/16 16:07:36 ET]
Table 'NLHE Session 2' 2-max (Play Money) Seat #2 is the button
Seat 1: FDIBA2009 (5738 in chips) 
Seat 2: s70n3fac3 (13625 in chips) 
s70n3fac3: posts small blind 50
FDIBA2009: posts big blind 100
*** HOLE CARDS ***
s70n3fac3: raises 150 to 250
FDIBA2009: folds 
Uncalled bet (150) returned to s70n3fac3
s70n3fac3 collected 200 from pot
s70n3fac3: doesn't show hand 
*** SUMMARY ***
Total pot 200 | Rake 0 
Seat 1: FDIBA2009 (big blind) folded before Flop
Seat 2: s70n3fac3 (button) (small blind) collected (200)



PokerStars Home Game Hand #225901257473: {Club #4781089}  Hold'em No Limit (50/100) - 2021/04/16 23:07:44 EET [2021/04/16 16:07:44 ET]
Table 'NLHE Session 2' 2-max (Play Money) Seat #1 is the button
Seat 1: FDIBA2009 (5638 in chips) 
Seat 2: s70n3fac3 (13725 in chips) 
FDIBA2009: posts small blind 50
s70n3fac3: posts big blind 100
*** HOLE CARDS ***
FDIBA2009: raises 200 to 300
s70n3fac3: calls 200
*** FLOP *** [7s 9c Ts]
s70n3fac3: checks 
FDIBA2009: bets 567
s70n3fac3: calls 567
*** TURN *** [7s 9c Ts] [7h]
s70n3fac3: checks 
FDIBA2009: bets 1639
s70n3fac3: folds 
Uncalled bet (1639) returned to FDIBA2009
FDIBA2009 collected 1639 from pot
*** SUMMARY ***
Total pot 1734 | Rake 95 
Board [7s 9c Ts 7h]
Seat 1: FDIBA2009 (button) (small blind) collected (1639)
Seat 2: s70n3fac3 (big blind) folded on the Turn



PokerStars Home Game Hand #225901282864: {Club #4781089}  Hold'em No Limit (50/100) - 2021/04/16 23:08:22 EET [2021/04/16 16:08:22 ET]
Table 'NLHE Session 2' 2-max (Play Money) Seat #2 is the button
Seat 1: FDIBA2009 (6410 in chips) 
Seat 2: s70n3fac3 (12858 in chips) 
s70n3fac3: posts small blind 50
FDIBA2009: posts big blind 100
*** HOLE CARDS ***
s70n3fac3: raises 150 to 250
FDIBA2009: folds 
Uncalled bet (150) returned to s70n3fac3
s70n3fac3 collected 200 from pot
s70n3fac3: doesn't show hand 
*** SUMMARY ***
Total pot 200 | Rake 0 
Seat 1: FDIBA2009 (big blind) folded before Flop
Seat 2: s70n3fac3 (button) (small blind) collected (200)



PokerStars Home Game Hand #225901287332: {Club #4781089}  Hold'em No Limit (50/100) - 2021/04/16 23:08:28 EET [2021/04/16 16:08:28 ET]
Table 'NLHE Session 2' 2-max (Play Money) Seat #1 is the button
Seat 1: FDIBA2009 (6310 in chips) 
Seat 2: s70n3fac3 (12958 in chips) 
FDIBA2009: posts small blind 50
s70n3fac3: posts big blind 100
*** HOLE CARDS ***
FDIBA2009: raises 100 to 200
s70n3fac3: folds 
Uncalled bet (100) returned to FDIBA2009
FDIBA2009 collected 200 from pot
*** SUMMARY ***
Total pot 200 | Rake 0 
Seat 1: FDIBA2009 (button) (small blind) collected (200)
Seat 2: s70n3fac3 (big blind) folded before Flop



PokerStars Home Game Hand #225901293180: {Club #4781089}  Hold'em No Limit (50/100) - 2021/04/16 23:08:37 EET [2021/04/16 16:08:37 ET]
Table 'NLHE Session 2' 2-max (Play Money) Seat #2 is the button
Seat 1: FDIBA2009 (6410 in chips) 
Seat 2: s70n3fac3 (12858 in chips) 
s70n3fac3: posts small blind 50
FDIBA2009: posts big blind 100
*** HOLE CARDS ***
s70n3fac3: raises 150 to 250
FDIBA2009: raises 500 to 750
s70n3fac3: folds 
Uncalled bet (500) returned to FDIBA2009
FDIBA2009 collected 500 from pot
*** SUMMARY ***
Total pot 500 | Rake 0 
Seat 1: FDIBA2009 (big blind) collected (500)
Seat 2: s70n3fac3 (button) (small blind) folded before Flop



PokerStars Home Game Hand #225901301522: {Club #4781089}  Hold'em No Limit (50/100) - 2021/04/16 23:08:50 EET [2021/04/16 16:08:50 ET]
Table 'NLHE Session 2' 2-max (Play Money) Seat #1 is the button
Seat 1: FDIBA2009 (6660 in chips) 
Seat 2: s70n3fac3 (12608 in chips) 
FDIBA2009: posts small blind 50
s70n3fac3: posts big blind 100
*** HOLE CARDS ***
FDIBA2009: raises 100 to 200
s70n3fac3: raises 400 to 600
FDIBA2009: calls 400
*** FLOP *** [6c 8h Ts]
s70n3fac3: bets 820
FDIBA2009: folds 
Uncalled bet (820) returned to s70n3fac3
s70n3fac3 collected 1134 from pot
s70n3fac3: doesn't show hand 
*** SUMMARY ***
Total pot 1200 | Rake 66 
Board [6c 8h Ts]
Seat 1: FDIBA2009 (button) (small blind) folded on the Flop
Seat 2: s70n3fac3 (big blind) collected (1134)



PokerStars Home Game Hand #225901317754: {Club #4781089}  Hold'em No Limit (50/100) - 2021/04/16 23:09:14 EET [2021/04/16 16:09:14 ET]
Table 'NLHE Session 2' 2-max (Play Money) Seat #2 is the button
Seat 1: FDIBA2009 (6060 in chips) 
Seat 2: s70n3fac3 (13142 in chips) 
s70n3fac3: posts small blind 50
FDIBA2009: posts big blind 100
*** HOLE CARDS ***
s70n3fac3: raises 130 to 230
FDIBA2009: raises 460 to 690
s70n3fac3: folds 
Uncalled bet (460) returned to FDIBA2009
FDIBA2009 collected 460 from pot
*** SUMMARY ***
Total pot 460 | Rake 0 
Seat 1: FDIBA2009 (big blind) collected (460)
Seat 2: s70n3fac3 (button) (small blind) folded before Flop



PokerStars Home Game Hand #225901329449: {Club #4781089}  Hold'em No Limit (50/100) - 2021/04/16 23:09:31 EET [2021/04/16 16:09:31 ET]
Table 'NLHE Session 2' 2-max (Play Money) Seat #1 is the button
Seat 1: FDIBA2009 (6290 in chips) 
Seat 2: s70n3fac3 (12912 in chips) 
FDIBA2009: posts small blind 50
s70n3fac3: posts big blind 100
*** HOLE CARDS ***
FDIBA2009: raises 100 to 200
s70n3fac3: raises 300 to 500
FDIBA2009: calls 300
*** FLOP *** [5h Ac Kh]
s70n3fac3: bets 450
FDIBA2009: calls 450
*** TURN *** [5h Ac Kh] [3c]
s70n3fac3: bets 755
FDIBA2009: raises 4585 to 5340 and is all-in
s70n3fac3: calls 4585
*** RIVER *** [5h Ac Kh 3c] [2d]
*** SHOW DOWN ***
s70n3fac3: shows [As 5s] (two pair, Aces and Fives)
FDIBA2009: shows [7c 5c] (a pair of Fives)
s70n3fac3 collected 11888 from pot
*** SUMMARY ***
Total pot 12580 | Rake 692 
Board [5h Ac Kh 3c 2d]
Seat 1: FDIBA2009 (button) (small blind) showed [7c 5c] and lost with a pair of Fives
Seat 2: s70n3fac3 (big blind) showed [As 5s] and won (11888) with two pair, Aces and Fives



PokerStars Home Game Hand #225901365265: {Club #4781089}  Hold'em No Limit (50/100) - 2021/04/16 23:10:24 EET [2021/04/16 16:10:24 ET]
Table 'NLHE Session 2' 2-max (Play Money) Seat #2 is the button
Seat 1: FDIBA2009 (10000 in chips) 
Seat 2: s70n3fac3 (18510 in chips) 
s70n3fac3: posts small blind 50
FDIBA2009: posts big blind 100
*** HOLE CARDS ***
s70n3fac3: raises 120 to 220
FDIBA2009: folds 
Uncalled bet (120) returned to s70n3fac3
s70n3fac3 collected 200 from pot
s70n3fac3: doesn't show hand 
*** SUMMARY ***
Total pot 200 | Rake 0 
Seat 1: FDIBA2009 (big blind) folded before Flop
Seat 2: s70n3fac3 (button) (small blind) collected (200)



PokerStars Home Game Hand #225901370375: {Club #4781089}  Hold'em No Limit (50/100) - 2021/04/16 23:10:31 EET [2021/04/16 16:10:31 ET]
Table 'NLHE Session 2' 2-max (Play Money) Seat #1 is the button
Seat 1: FDIBA2009 (9900 in chips) 
Seat 2: s70n3fac3 (18610 in chips) 
FDIBA2009: posts small blind 50
s70n3fac3: posts big blind 100
*** HOLE CARDS ***
FDIBA2009: raises 100 to 200
s70n3fac3: raises 375 to 575
FDIBA2009: calls 375
*** FLOP *** [2s 9h 4c]
s70n3fac3: bets 585
FDIBA2009: folds 
Uncalled bet (585) returned to s70n3fac3
s70n3fac3 collected 1087 from pot
s70n3fac3: doesn't show hand 
*** SUMMARY ***
Total pot 1150 | Rake 63 
Board [2s 9h 4c]
Seat 1: FDIBA2009 (button) (small blind) folded on the Flop
Seat 2: s70n3fac3 (big blind) collected (1087)



PokerStars Home Game Hand #225901384116: {Club #4781089}  Hold'em No Limit (50/100) - 2021/04/16 23:10:51 EET [2021/04/16 16:10:51 ET]
Table 'NLHE Session 2' 2-max (Play Money) Seat #2 is the button
Seat 1: FDIBA2009 (9325 in chips) 
Seat 2: s70n3fac3 (19122 in chips) 
s70n3fac3: posts small blind 50
FDIBA2009: posts big blind 100
*** HOLE CARDS ***
s70n3fac3: folds 
Uncalled bet (50) returned to FDIBA2009
FDIBA2009 collected 100 from pot
*** SUMMARY ***
Total pot 100 | Rake 0 
Seat 1: FDIBA2009 (big blind) collected (100)
Seat 2: s70n3fac3 (button) (small blind) folded before Flop



PokerStars Home Game Hand #225901387263: {Club #4781089}  Hold'em No Limit (50/100) - 2021/04/16 23:10:56 EET [2021/04/16 16:10:56 ET]
Table 'NLHE Session 2' 2-max (Play Money) Seat #1 is the button
Seat 1: FDIBA2009 (9375 in chips) 
Seat 2: s70n3fac3 (19072 in chips) 
FDIBA2009: posts small blind 50
s70n3fac3: posts big blind 100
*** HOLE CARDS ***
FDIBA2009: raises 200 to 300
s70n3fac3: calls 200
*** FLOP *** [7d Js 5h]
s70n3fac3: checks 
FDIBA2009: bets 567
s70n3fac3: folds 
Uncalled bet (567) returned to FDIBA2009
FDIBA2009 collected 567 from pot
*** SUMMARY ***
Total pot 600 | Rake 33 
Board [7d Js 5h]
Seat 1: FDIBA2009 (button) (small blind) collected (567)
Seat 2: s70n3fac3 (big blind) folded on the Flop



PokerStars Home Game Hand #225901402923: {Club #4781089}  Hold'em No Limit (50/100) - 2021/04/16 23:11:19 EET [2021/04/16 16:11:19 ET]
Table 'NLHE Session 2' 2-max (Play Money) Seat #2 is the button
Seat 1: FDIBA2009 (9642 in chips) 
Seat 2: s70n3fac3 (18772 in chips) 
s70n3fac3: posts small blind 50
FDIBA2009: posts big blind 100
*** HOLE CARDS ***
s70n3fac3: folds 
Uncalled bet (50) returned to FDIBA2009
FDIBA2009 collected 100 from pot
*** SUMMARY ***
Total pot 100 | Rake 0 
Seat 1: FDIBA2009 (big blind) collected (100)
Seat 2: s70n3fac3 (button) (small blind) folded before Flop



PokerStars Home Game Hand #225901405822: {Club #4781089}  Hold'em No Limit (50/100) - 2021/04/16 23:11:23 EET [2021/04/16 16:11:23 ET]
Table 'NLHE Session 2' 2-max (Play Money) Seat #1 is the button
Seat 1: FDIBA2009 (9692 in chips) 
Seat 2: s70n3fac3 (18722 in chips) 
FDIBA2009: posts small blind 50
s70n3fac3: posts big blind 100
*** HOLE CARDS ***
FDIBA2009: raises 100 to 200
s70n3fac3: folds 
Uncalled bet (100) returned to FDIBA2009
FDIBA2009 collected 200 from pot
*** SUMMARY ***
Total pot 200 | Rake 0 
Seat 1: FDIBA2009 (button) (small blind) collected (200)
Seat 2: s70n3fac3 (big blind) folded before Flop



PokerStars Home Game Hand #225901410993: {Club #4781089}  Hold'em No Limit (50/100) - 2021/04/16 23:11:31 EET [2021/04/16 16:11:31 ET]
Table 'NLHE Session 2' 2-max (Play Money) Seat #2 is the button
Seat 1: FDIBA2009 (9792 in chips) 
Seat 2: s70n3fac3 (18622 in chips) 
s70n3fac3: posts small blind 50
FDIBA2009: posts big blind 100
*** HOLE CARDS ***
s70n3fac3: raises 100 to 200
FDIBA2009: calls 100
*** FLOP *** [5h Kc Qh]
FDIBA2009: checks 
s70n3fac3: bets 205
FDIBA2009: folds 
Uncalled bet (205) returned to s70n3fac3
s70n3fac3 collected 378 from pot
s70n3fac3: doesn't show hand 
*** SUMMARY ***
Total pot 400 | Rake 22 
Board [5h Kc Qh]
Seat 1: FDIBA2009 (big blind) folded on the Flop
Seat 2: s70n3fac3 (button) (small blind) collected (378)



PokerStars Home Game Hand #225901420183: {Club #4781089}  Hold'em No Limit (50/100) - 2021/04/16 23:11:45 EET [2021/04/16 16:11:45 ET]
Table 'NLHE Session 2' 2-max (Play Money) Seat #1 is the button
Seat 1: FDIBA2009 (9592 in chips) 
Seat 2: s70n3fac3 (18800 in chips) 
FDIBA2009: posts small blind 50
s70n3fac3: posts big blind 100
*** HOLE CARDS ***
FDIBA2009: raises 100 to 200
s70n3fac3: calls 100
*** FLOP *** [8h Ac 7c]
s70n3fac3: checks 
FDIBA2009: bets 189
s70n3fac3: folds 
Uncalled bet (189) returned to FDIBA2009
FDIBA2009 collected 378 from pot
*** SUMMARY ***
Total pot 400 | Rake 22 
Board [8h Ac 7c]
Seat 1: FDIBA2009 (button) (small blind) collected (378)
Seat 2: s70n3fac3 (big blind) folded on the Flop



PokerStars Home Game Hand #225901430949: {Club #4781089}  Hold'em No Limit (50/100) - 2021/04/16 23:12:01 EET [2021/04/16 16:12:01 ET]
Table 'NLHE Session 2' 2-max (Play Money) Seat #2 is the button
Seat 1: FDIBA2009 (9770 in chips) 
Seat 2: s70n3fac3 (18600 in chips) 
s70n3fac3: posts small blind 50
FDIBA2009: posts big blind 100
*** HOLE CARDS ***
s70n3fac3: raises 120 to 220
FDIBA2009: folds 
Uncalled bet (120) returned to s70n3fac3
s70n3fac3 collected 200 from pot
s70n3fac3: doesn't show hand 
*** SUMMARY ***
Total pot 200 | Rake 0 
Seat 1: FDIBA2009 (big blind) folded before Flop
Seat 2: s70n3fac3 (button) (small blind) collected (200)



PokerStars Home Game Hand #225901435775: {Club #4781089}  Hold'em No Limit (50/100) - 2021/04/16 23:12:08 EET [2021/04/16 16:12:08 ET]
Table 'NLHE Session 2' 2-max (Play Money) Seat #1 is the button
Seat 1: FDIBA2009 (9670 in chips) 
Seat 2: s70n3fac3 (18700 in chips) 
FDIBA2009: posts small blind 50
s70n3fac3: posts big blind 100
*** HOLE CARDS ***
FDIBA2009: raises 100 to 200
s70n3fac3: folds 
Uncalled bet (100) returned to FDIBA2009
FDIBA2009 collected 200 from pot
*** SUMMARY ***
Total pot 200 | Rake 0 
Seat 1: FDIBA2009 (button) (small blind) collected (200)
Seat 2: s70n3fac3 (big blind) folded before Flop



PokerStars Home Game Hand #225901440974: {Club #4781089}  Hold'em No Limit (50/100) - 2021/04/16 23:12:15 EET [2021/04/16 16:12:15 ET]
Table 'NLHE Session 2' 2-max (Play Money) Seat #2 is the button
Seat 1: FDIBA2009 (9770 in chips) 
Seat 2: s70n3fac3 (18600 in chips) 
s70n3fac3: posts small blind 50
FDIBA2009: posts big blind 100
*** HOLE CARDS ***
s70n3fac3: raises 150 to 250
FDIBA2009: folds 
Uncalled bet (150) returned to s70n3fac3
s70n3fac3 collected 200 from pot
s70n3fac3: doesn't show hand 
*** SUMMARY ***
Total pot 200 | Rake 0 
Seat 1: FDIBA2009 (big blind) folded before Flop
Seat 2: s70n3fac3 (button) (small blind) collected (200)



PokerStars Home Game Hand #225901445837: {Club #4781089}  Hold'em No Limit (50/100) - 2021/04/16 23:12:23 EET [2021/04/16 16:12:23 ET]
Table 'NLHE Session 2' 2-max (Play Money) Seat #1 is the button
Seat 1: FDIBA2009 (9670 in chips) 
Seat 2: s70n3fac3 (18700 in chips) 
FDIBA2009: posts small blind 50
s70n3fac3: posts big blind 100
*** HOLE CARDS ***
FDIBA2009: raises 100 to 200
s70n3fac3: folds 
Uncalled bet (100) returned to FDIBA2009
FDIBA2009 collected 200 from pot
*** SUMMARY ***
Total pot 200 | Rake 0 
Seat 1: FDIBA2009 (button) (small blind) collected (200)
Seat 2: s70n3fac3 (big blind) folded before Flop



PokerStars Home Game Hand #225901449956: {Club #4781089}  Hold'em No Limit (50/100) - 2021/04/16 23:12:29 EET [2021/04/16 16:12:29 ET]
Table 'NLHE Session 2' 2-max (Play Money) Seat #2 is the button
Seat 1: FDIBA2009 (9770 in chips) 
Seat 2: s70n3fac3 (18600 in chips) 
s70n3fac3: posts small blind 50
FDIBA2009: posts big blind 100
*** HOLE CARDS ***
s70n3fac3: raises 150 to 250
FDIBA2009: folds 
Uncalled bet (150) returned to s70n3fac3
s70n3fac3 collected 200 from pot
s70n3fac3: doesn't show hand 
*** SUMMARY ***
Total pot 200 | Rake 0 
Seat 1: FDIBA2009 (big blind) folded before Flop
Seat 2: s70n3fac3 (button) (small blind) collected (200)



PokerStars Home Game Hand #225901453966: {Club #4781089}  Hold'em No Limit (50/100) - 2021/04/16 23:12:35 EET [2021/04/16 16:12:35 ET]
Table 'NLHE Session 2' 2-max (Play Money) Seat #1 is the button
Seat 1: FDIBA2009 (9670 in chips) 
Seat 2: s70n3fac3 (18700 in chips) 
FDIBA2009: posts small blind 50
s70n3fac3: posts big blind 100
*** HOLE CARDS ***
FDIBA2009: raises 100 to 200
s70n3fac3: calls 100
*** FLOP *** [3c 5d 4c]
s70n3fac3: bets 189
FDIBA2009: calls 189
*** TURN *** [3c 5d 4c] [8h]
s70n3fac3: checks 
FDIBA2009: bets 367
s70n3fac3: calls 367
*** RIVER *** [3c 5d 4c 8h] [5h]
s70n3fac3: checks 
FDIBA2009: bets 900
s70n3fac3: calls 900
*** SHOW DOWN ***
FDIBA2009: shows [Kh 5s] (three of a kind, Fives)
s70n3fac3: mucks hand 
FDIBA2009 collected 3130 from pot
*** SUMMARY ***
Total pot 3312 | Rake 182 
Board [3c 5d 4c 8h 5h]
Seat 1: FDIBA2009 (button) (small blind) showed [Kh 5s] and won (3130) with three of a kind, Fives
Seat 2: s70n3fac3 (big blind) mucked [3d 2d]



PokerStars Home Game Hand #225901492844: {Club #4781089}  Hold'em No Limit (50/100) - 2021/04/16 23:13:32 EET [2021/04/16 16:13:32 ET]
Table 'NLHE Session 2' 2-max (Play Money) Seat #2 is the button
Seat 1: FDIBA2009 (11144 in chips) 
Seat 2: s70n3fac3 (17044 in chips) 
s70n3fac3: posts small blind 50
FDIBA2009: posts big blind 100
*** HOLE CARDS ***
s70n3fac3: raises 150 to 250
FDIBA2009: raises 150 to 400
s70n3fac3: calls 150
*** FLOP *** [4c Js Kc]
FDIBA2009: bets 378
s70n3fac3: folds 
Uncalled bet (378) returned to FDIBA2009
FDIBA2009 collected 756 from pot
*** SUMMARY ***
Total pot 800 | Rake 44 
Board [4c Js Kc]
Seat 1: FDIBA2009 (big blind) collected (756)
Seat 2: s70n3fac3 (button) (small blind) folded on the Flop



PokerStars Home Game Hand #225901511538: {Club #4781089}  Hold'em No Limit (50/100) - 2021/04/16 23:14:00 EET [2021/04/16 16:14:00 ET]
Table 'NLHE Session 2' 2-max (Play Money) Seat #1 is the button
Seat 1: FDIBA2009 (11500 in chips) 
Seat 2: s70n3fac3 (16644 in chips) 
FDIBA2009: posts small blind 50
s70n3fac3: posts big blind 100
*** HOLE CARDS ***
FDIBA2009: raises 100 to 200
s70n3fac3: calls 100
*** FLOP *** [Qc 7s Ah]
s70n3fac3: checks 
FDIBA2009: checks 
*** TURN *** [Qc 7s Ah] [2s]
s70n3fac3: bets 200
FDIBA2009: calls 200
*** RIVER *** [Qc 7s Ah 2s] [Ks]
s70n3fac3: checks 
FDIBA2009: checks 
*** SHOW DOWN ***
s70n3fac3: shows [5s 7c] (a pair of Sevens)
FDIBA2009: shows [Tc Td] (a pair of Tens)
FDIBA2009 collected 756 from pot
*** SUMMARY ***
Total pot 800 | Rake 44 
Board [Qc 7s Ah 2s Ks]
Seat 1: FDIBA2009 (button) (small blind) showed [Tc Td] and won (756) with a pair of Tens
Seat 2: s70n3fac3 (big blind) showed [5s 7c] and lost with a pair of Sevens



PokerStars Home Game Hand #225901524502: {Club #4781089}  Hold'em No Limit (50/100) - 2021/04/16 23:14:19 EET [2021/04/16 16:14:19 ET]
Table 'NLHE Session 2' 2-max (Play Money) Seat #2 is the button
Seat 1: FDIBA2009 (11856 in chips) 
Seat 2: s70n3fac3 (16244 in chips) 
s70n3fac3: posts small blind 50
FDIBA2009: posts big blind 100
*** HOLE CARDS ***
s70n3fac3: raises 130 to 230
FDIBA2009: folds 
Uncalled bet (130) returned to s70n3fac3
s70n3fac3 collected 200 from pot
s70n3fac3: doesn't show hand 
*** SUMMARY ***
Total pot 200 | Rake 0 
Seat 1: FDIBA2009 (big blind) folded before Flop
Seat 2: s70n3fac3 (button) (small blind) collected (200)



PokerStars Home Game Hand #225901530173: {Club #4781089}  Hold'em No Limit (50/100) - 2021/04/16 23:14:27 EET [2021/04/16 16:14:27 ET]
Table 'NLHE Session 2' 2-max (Play Money) Seat #1 is the button
Seat 1: FDIBA2009 (11756 in chips) 
Seat 2: s70n3fac3 (16344 in chips) 
FDIBA2009: posts small blind 50
s70n3fac3: posts big blind 100
*** HOLE CARDS ***
FDIBA2009: raises 100 to 200
s70n3fac3: calls 100
*** FLOP *** [Ah Ks 6c]
s70n3fac3: checks 
FDIBA2009: checks 
*** TURN *** [Ah Ks 6c] [5s]
s70n3fac3: checks 
FDIBA2009: checks 
*** RIVER *** [Ah Ks 6c 5s] [8d]
s70n3fac3: bets 444
FDIBA2009: folds 
Uncalled bet (444) returned to s70n3fac3
s70n3fac3 collected 378 from pot
s70n3fac3: doesn't show hand 
*** SUMMARY ***
Total pot 400 | Rake 22 
Board [Ah Ks 6c 5s 8d]
Seat 1: FDIBA2009 (button) (small blind) folded on the River
Seat 2: s70n3fac3 (big blind) collected (378)



PokerStars Home Game Hand #225901547847: {Club #4781089}  Hold'em No Limit (50/100) - 2021/04/16 23:14:54 EET [2021/04/16 16:14:54 ET]
Table 'NLHE Session 2' 2-max (Play Money) Seat #2 is the button
Seat 1: FDIBA2009 (11556 in chips) 
Seat 2: s70n3fac3 (16522 in chips) 
s70n3fac3: posts small blind 50
FDIBA2009: posts big blind 100
*** HOLE CARDS ***
s70n3fac3: raises 100 to 200
FDIBA2009: folds 
Uncalled bet (100) returned to s70n3fac3
s70n3fac3 collected 200 from pot
s70n3fac3: doesn't show hand 
*** SUMMARY ***
Total pot 200 | Rake 0 
Seat 1: FDIBA2009 (big blind) folded before Flop
Seat 2: s70n3fac3 (button) (small blind) collected (200)



PokerStars Home Game Hand #225901553119: {Club #4781089}  Hold'em No Limit (50/100) - 2021/04/16 23:15:01 EET [2021/04/16 16:15:01 ET]
Table 'NLHE Session 2' 2-max (Play Money) Seat #1 is the button
Seat 1: FDIBA2009 (11456 in chips) 
Seat 2: s70n3fac3 (16622 in chips) 
FDIBA2009: posts small blind 50
s70n3fac3: posts big blind 100
*** HOLE CARDS ***
FDIBA2009: raises 100 to 200
s70n3fac3: folds 
Uncalled bet (100) returned to FDIBA2009
FDIBA2009 collected 200 from pot
*** SUMMARY ***
Total pot 200 | Rake 0 
Seat 1: FDIBA2009 (button) (small blind) collected (200)
Seat 2: s70n3fac3 (big blind) folded before Flop



PokerStars Home Game Hand #225901557492: {Club #4781089}  Hold'em No Limit (50/100) - 2021/04/16 23:15:07 EET [2021/04/16 16:15:07 ET]
Table 'NLHE Session 2' 2-max (Play Money) Seat #2 is the button
Seat 1: FDIBA2009 (11556 in chips) 
Seat 2: s70n3fac3 (16522 in chips) 
s70n3fac3: posts small blind 50
FDIBA2009: posts big blind 100
*** HOLE CARDS ***
s70n3fac3: folds 
Uncalled bet (50) returned to FDIBA2009
FDIBA2009 collected 100 from pot
*** SUMMARY ***
Total pot 100 | Rake 0 
Seat 1: FDIBA2009 (big blind) collected (100)
Seat 2: s70n3fac3 (button) (small blind) folded before Flop



PokerStars Home Game Hand #225901560413: {Club #4781089}  Hold'em No Limit (50/100) - 2021/04/16 23:15:11 EET [2021/04/16 16:15:11 ET]
Table 'NLHE Session 2' 2-max (Play Money) Seat #1 is the button
Seat 1: FDIBA2009 (11606 in chips) 
Seat 2: s70n3fac3 (16472 in chips) 
FDIBA2009: posts small blind 50
s70n3fac3: posts big blind 100
*** HOLE CARDS ***
FDIBA2009: raises 100 to 200
s70n3fac3: raises 350 to 550
FDIBA2009: folds 
Uncalled bet (350) returned to s70n3fac3
s70n3fac3 collected 400 from pot
s70n3fac3: doesn't show hand 
*** SUMMARY ***
Total pot 400 | Rake 0 
Seat 1: FDIBA2009 (button) (small blind) folded before Flop
Seat 2: s70n3fac3 (big blind) collected (400)



PokerStars Home Game Hand #225901568504: {Club #4781089}  Hold'em No Limit (50/100) - 2021/04/16 23:15:23 EET [2021/04/16 16:15:23 ET]
Table 'NLHE Session 2' 2-max (Play Money) Seat #2 is the button
Seat 1: FDIBA2009 (11406 in chips) 
Seat 2: s70n3fac3 (16672 in chips) 
s70n3fac3: posts small blind 50
FDIBA2009: posts big blind 100
*** HOLE CARDS ***
s70n3fac3: raises 150 to 250
FDIBA2009: folds 
Uncalled bet (150) returned to s70n3fac3
s70n3fac3 collected 200 from pot
s70n3fac3: doesn't show hand 
*** SUMMARY ***
Total pot 200 | Rake 0 
Seat 1: FDIBA2009 (big blind) folded before Flop
Seat 2: s70n3fac3 (button) (small blind) collected (200)



PokerStars Home Game Hand #225901573062: {Club #4781089}  Hold'em No Limit (50/100) - 2021/04/16 23:15:30 EET [2021/04/16 16:15:30 ET]
Table 'NLHE Session 2' 2-max (Play Money) Seat #1 is the button
Seat 1: FDIBA2009 (11306 in chips) 
Seat 2: s70n3fac3 (16772 in chips) 
FDIBA2009: posts small blind 50
s70n3fac3: posts big blind 100
*** HOLE CARDS ***
FDIBA2009: raises 100 to 200
s70n3fac3: calls 100
*** FLOP *** [9c Td 5c]
s70n3fac3: checks 
FDIBA2009: checks 
*** TURN *** [9c Td 5c] [Ah]
s70n3fac3: bets 200
FDIBA2009: calls 200
*** RIVER *** [9c Td 5c Ah] [4s]
s70n3fac3: checks 
FDIBA2009: bets 400
s70n3fac3: folds 
Uncalled bet (400) returned to FDIBA2009
FDIBA2009 collected 756 from pot
*** SUMMARY ***
Total pot 800 | Rake 44 
Board [9c Td 5c Ah 4s]
Seat 1: FDIBA2009 (button) (small blind) collected (756)
Seat 2: s70n3fac3 (big blind) folded on the River



PokerStars Home Game Hand #225901594590: {Club #4781089}  Hold'em No Limit (50/100) - 2021/04/16 23:16:00 EET [2021/04/16 16:16:00 ET]
Table 'NLHE Session 2' 2-max (Play Money) Seat #2 is the button
Seat 1: FDIBA2009 (11662 in chips) 
Seat 2: s70n3fac3 (16372 in chips) 
s70n3fac3: posts small blind 50
FDIBA2009: posts big blind 100
*** HOLE CARDS ***
s70n3fac3: raises 150 to 250
FDIBA2009: calls 150
*** FLOP *** [4s 2d 4c]
FDIBA2009: checks 
s70n3fac3: checks 
*** TURN *** [4s 2d 4c] [Td]
FDIBA2009: bets 300
s70n3fac3: folds 
Uncalled bet (300) returned to FDIBA2009
FDIBA2009 collected 472 from pot
*** SUMMARY ***
Total pot 500 | Rake 28 
Board [4s 2d 4c Td]
Seat 1: FDIBA2009 (big blind) collected (472)
Seat 2: s70n3fac3 (button) (small blind) folded on the Turn



PokerStars Home Game Hand #225901611252: {Club #4781089}  Hold'em No Limit (50/100) - 2021/04/16 23:16:24 EET [2021/04/16 16:16:24 ET]
Table 'NLHE Session 2' 2-max (Play Money) Seat #1 is the button
Seat 1: FDIBA2009 (11884 in chips) 
Seat 2: s70n3fac3 (16122 in chips) 
FDIBA2009: posts small blind 50
s70n3fac3: posts big blind 100
*** HOLE CARDS ***
FDIBA2009: raises 100 to 200
s70n3fac3: calls 100
*** FLOP *** [Jh 3d 2c]
s70n3fac3: checks 
FDIBA2009: bets 378
s70n3fac3: folds 
Uncalled bet (378) returned to FDIBA2009
FDIBA2009 collected 378 from pot
*** SUMMARY ***
Total pot 400 | Rake 22 
Board [Jh 3d 2c]
Seat 1: FDIBA2009 (button) (small blind) collected (378)
Seat 2: s70n3fac3 (big blind) folded on the Flop



PokerStars Home Game Hand #225901621356: {Club #4781089}  Hold'em No Limit (50/100) - 2021/04/16 23:16:39 EET [2021/04/16 16:16:39 ET]
Table 'NLHE Session 2' 2-max (Play Money) Seat #2 is the button
Seat 1: FDIBA2009 (12062 in chips) 
Seat 2: s70n3fac3 (15922 in chips) 
s70n3fac3: posts small blind 50
FDIBA2009: posts big blind 100
*** HOLE CARDS ***
s70n3fac3: folds 
Uncalled bet (50) returned to FDIBA2009
FDIBA2009 collected 100 from pot
*** SUMMARY ***
Total pot 100 | Rake 0 
Seat 1: FDIBA2009 (big blind) collected (100)
Seat 2: s70n3fac3 (button) (small blind) folded before Flop



PokerStars Home Game Hand #225901624298: {Club #4781089}  Hold'em No Limit (50/100) - 2021/04/16 23:16:43 EET [2021/04/16 16:16:43 ET]
Table 'NLHE Session 2' 2-max (Play Money) Seat #1 is the button
Seat 1: FDIBA2009 (12112 in chips) 
Seat 2: s70n3fac3 (15872 in chips) 
FDIBA2009: posts small blind 50
s70n3fac3: posts big blind 100
*** HOLE CARDS ***
FDIBA2009: raises 100 to 200
s70n3fac3: calls 100
*** FLOP *** [6c 7s 4s]
s70n3fac3: checks 
FDIBA2009: bets 189
s70n3fac3: folds 
Uncalled bet (189) returned to FDIBA2009
FDIBA2009 collected 378 from pot
*** SUMMARY ***
Total pot 400 | Rake 22 
Board [6c 7s 4s]
Seat 1: FDIBA2009 (button) (small blind) collected (378)
Seat 2: s70n3fac3 (big blind) folded on the Flop



PokerStars Home Game Hand #225901634183: {Club #4781089}  Hold'em No Limit (50/100) - 2021/04/16 23:16:57 EET [2021/04/16 16:16:57 ET]
Table 'NLHE Session 2' 2-max (Play Money) Seat #2 is the button
Seat 1: FDIBA2009 (12290 in chips) 
Seat 2: s70n3fac3 (15672 in chips) 
s70n3fac3: posts small blind 50
FDIBA2009: posts big blind 100
*** HOLE CARDS ***
s70n3fac3: raises 150 to 250
FDIBA2009: calls 150
*** FLOP *** [6d 3s Td]
FDIBA2009: checks 
s70n3fac3: bets 270
FDIBA2009: calls 270
*** TURN *** [6d 3s Td] [Jc]
FDIBA2009: checks 
s70n3fac3: bets 425
FDIBA2009: calls 425
*** RIVER *** [6d 3s Td Jc] [3c]
FDIBA2009: checks 
s70n3fac3: checks 
*** SHOW DOWN ***
FDIBA2009: shows [6h Kd] (two pair, Sixes and Threes)
s70n3fac3: shows [7c 7h] (two pair, Sevens and Threes)
s70n3fac3 collected 1786 from pot
*** SUMMARY ***
Total pot 1890 | Rake 104 
Board [6d 3s Td Jc 3c]
Seat 1: FDIBA2009 (big blind) showed [6h Kd] and lost with two pair, Sixes and Threes
Seat 2: s70n3fac3 (button) (small blind) showed [7c 7h] and won (1786) with two pair, Sevens and Threes



PokerStars Home Game Hand #225901656472: {Club #4781089}  Hold'em No Limit (50/100) - 2021/04/16 23:17:29 EET [2021/04/16 16:17:29 ET]
Table 'NLHE Session 2' 2-max (Play Money) Seat #1 is the button
Seat 1: FDIBA2009 (11345 in chips) 
Seat 2: s70n3fac3 (16513 in chips) 
FDIBA2009: posts small blind 50
s70n3fac3: posts big blind 100
*** HOLE CARDS ***
FDIBA2009: raises 200 to 300
s70n3fac3: calls 200
*** FLOP *** [Qs Ac Th]
s70n3fac3: checks 
FDIBA2009: bets 567
s70n3fac3: calls 567
*** TURN *** [Qs Ac Th] [Kd]
s70n3fac3: checks 
FDIBA2009: checks 
*** RIVER *** [Qs Ac Th Kd] [4d]
s70n3fac3: checks 
FDIBA2009: bets 1800
s70n3fac3: raises 4745 to 6545
FDIBA2009: folds 
Uncalled bet (4745) returned to s70n3fac3
s70n3fac3 collected 5041 from pot
s70n3fac3: doesn't show hand 
*** SUMMARY ***
Total pot 5334 | Rake 293 
Board [Qs Ac Th Kd 4d]
Seat 1: FDIBA2009 (button) (small blind) folded on the River
Seat 2: s70n3fac3 (big blind) collected (5041)



PokerStars Home Game Hand #225901697935: {Club #4781089}  Hold'em No Limit (50/100) - 2021/04/16 23:18:28 EET [2021/04/16 16:18:28 ET]
Table 'NLHE Session 2' 2-max (Play Money) Seat #2 is the button
Seat 1: FDIBA2009 (8678 in chips) 
Seat 2: s70n3fac3 (18887 in chips) 
s70n3fac3: posts small blind 50
FDIBA2009: posts big blind 100
*** HOLE CARDS ***
s70n3fac3: raises 150 to 250
FDIBA2009: folds 
Uncalled bet (150) returned to s70n3fac3
s70n3fac3 collected 200 from pot
s70n3fac3: doesn't show hand 
*** SUMMARY ***
Total pot 200 | Rake 0 
Seat 1: FDIBA2009 (big blind) folded before Flop
Seat 2: s70n3fac3 (button) (small blind) collected (200)



PokerStars Home Game Hand #225901702409: {Club #4781089}  Hold'em No Limit (50/100) - 2021/04/16 23:18:34 EET [2021/04/16 16:18:34 ET]
Table 'NLHE Session 2' 2-max (Play Money) Seat #1 is the button
Seat 1: FDIBA2009 (8578 in chips) 
Seat 2: s70n3fac3 (18987 in chips) 
FDIBA2009: posts small blind 50
s70n3fac3: posts big blind 100
*** HOLE CARDS ***
FDIBA2009: raises 100 to 200
s70n3fac3: folds 
Uncalled bet (100) returned to FDIBA2009
FDIBA2009 collected 200 from pot
*** SUMMARY ***
Total pot 200 | Rake 0 
Seat 1: FDIBA2009 (button) (small blind) collected (200)
Seat 2: s70n3fac3 (big blind) folded before Flop



PokerStars Home Game Hand #225901708464: {Club #4781089}  Hold'em No Limit (50/100) - 2021/04/16 23:18:43 EET [2021/04/16 16:18:43 ET]
Table 'NLHE Session 2' 2-max (Play Money) Seat #2 is the button
Seat 1: FDIBA2009 (8678 in chips) 
Seat 2: s70n3fac3 (18887 in chips) 
s70n3fac3: posts small blind 50
FDIBA2009: posts big blind 100
*** HOLE CARDS ***
s70n3fac3: folds 
Uncalled bet (50) returned to FDIBA2009
FDIBA2009 collected 100 from pot
*** SUMMARY ***
Total pot 100 | Rake 0 
Seat 1: FDIBA2009 (big blind) collected (100)
Seat 2: s70n3fac3 (button) (small blind) folded before Flop



PokerStars Home Game Hand #225901711876: {Club #4781089}  Hold'em No Limit (50/100) - 2021/04/16 23:18:48 EET [2021/04/16 16:18:48 ET]
Table 'NLHE Session 2' 2-max (Play Money) Seat #1 is the button
Seat 1: FDIBA2009 (8728 in chips) 
Seat 2: s70n3fac3 (18837 in chips) 
FDIBA2009: posts small blind 50
s70n3fac3: posts big blind 100
*** HOLE CARDS ***
FDIBA2009: raises 100 to 200
s70n3fac3: calls 100
*** FLOP *** [4d 4c Js]
s70n3fac3: checks 
FDIBA2009: bets 378
s70n3fac3: folds 
Uncalled bet (378) returned to FDIBA2009
FDIBA2009 collected 378 from pot
*** SUMMARY ***
Total pot 400 | Rake 22 
Board [4d 4c Js]
Seat 1: FDIBA2009 (button) (small blind) collected (378)
Seat 2: s70n3fac3 (big blind) folded on the Flop



PokerStars Home Game Hand #225901722863: {Club #4781089}  Hold'em No Limit (50/100) - 2021/04/16 23:19:04 EET [2021/04/16 16:19:04 ET]
Table 'NLHE Session 2' 2-max (Play Money) Seat #2 is the button
Seat 1: FDIBA2009 (8906 in chips) 
Seat 2: s70n3fac3 (18637 in chips) 
s70n3fac3: posts small blind 50
FDIBA2009: posts big blind 100
*** HOLE CARDS ***
s70n3fac3: calls 50
FDIBA2009: raises 100 to 200
s70n3fac3: calls 100
*** FLOP *** [9s 9c 2s]
FDIBA2009: checks 
s70n3fac3: checks 
*** TURN *** [9s 9c 2s] [8h]
FDIBA2009: checks 
s70n3fac3: checks 
*** RIVER *** [9s 9c 2s 8h] [Jc]
FDIBA2009: checks 
s70n3fac3: bets 200
FDIBA2009: folds 
Uncalled bet (200) returned to s70n3fac3
s70n3fac3 collected 378 from pot
s70n3fac3: doesn't show hand 
*** SUMMARY ***
Total pot 400 | Rake 22 
Board [9s 9c 2s 8h Jc]
Seat 1: FDIBA2009 (big blind) folded on the River
Seat 2: s70n3fac3 (button) (small blind) collected (378)



PokerStars Home Game Hand #225901738978: {Club #4781089}  Hold'em No Limit (50/100) - 2021/04/16 23:19:27 EET [2021/04/16 16:19:27 ET]
Table 'NLHE Session 2' 2-max (Play Money) Seat #1 is the button
Seat 1: FDIBA2009 (8706 in chips) 
Seat 2: s70n3fac3 (18815 in chips) 
FDIBA2009: posts small blind 50
s70n3fac3: posts big blind 100
*** HOLE CARDS ***
FDIBA2009: raises 100 to 200
s70n3fac3: calls 100
*** FLOP *** [Kd 4d 8s]
s70n3fac3: checks 
FDIBA2009: checks 
*** TURN *** [Kd 4d 8s] [4s]
s70n3fac3: bets 200
FDIBA2009: folds 
Uncalled bet (200) returned to s70n3fac3
s70n3fac3 collected 378 from pot
s70n3fac3: doesn't show hand 
*** SUMMARY ***
Total pot 400 | Rake 22 
Board [Kd 4d 8s 4s]
Seat 1: FDIBA2009 (button) (small blind) folded on the Turn
Seat 2: s70n3fac3 (big blind) collected (378)



PokerStars Home Game Hand #225901748097: {Club #4781089}  Hold'em No Limit (50/100) - 2021/04/16 23:19:40 EET [2021/04/16 16:19:40 ET]
Table 'NLHE Session 2' 2-max (Play Money) Seat #2 is the button
Seat 1: FDIBA2009 (8506 in chips) 
Seat 2: s70n3fac3 (18993 in chips) 
s70n3fac3: posts small blind 50
FDIBA2009: posts big blind 100
*** HOLE CARDS ***
s70n3fac3: raises 130 to 230
FDIBA2009: raises 460 to 690
s70n3fac3: folds 
Uncalled bet (460) returned to FDIBA2009
FDIBA2009 collected 460 from pot
*** SUMMARY ***
Total pot 460 | Rake 0 
Seat 1: FDIBA2009 (big blind) collected (460)
Seat 2: s70n3fac3 (button) (small blind) folded before Flop



PokerStars Home Game Hand #225901756588: {Club #4781089}  Hold'em No Limit (50/100) - 2021/04/16 23:19:52 EET [2021/04/16 16:19:52 ET]
Table 'NLHE Session 2' 2-max (Play Money) Seat #1 is the button
Seat 1: FDIBA2009 (8736 in chips) 
Seat 2: s70n3fac3 (18763 in chips) 
FDIBA2009: posts small blind 50
s70n3fac3: posts big blind 100
*** HOLE CARDS ***
FDIBA2009: raises 100 to 200
s70n3fac3: calls 100
*** FLOP *** [6d Js 6h]
s70n3fac3: checks 
FDIBA2009: checks 
*** TURN *** [6d Js 6h] [7d]
s70n3fac3: checks 
FDIBA2009: bets 189
s70n3fac3: folds 
Uncalled bet (189) returned to FDIBA2009
FDIBA2009 collected 378 from pot
*** SUMMARY ***
Total pot 400 | Rake 22 
Board [6d Js 6h 7d]
Seat 1: FDIBA2009 (button) (small blind) collected (378)
Seat 2: s70n3fac3 (big blind) folded on the Turn



PokerStars Home Game Hand #225901771634: {Club #4781089}  Hold'em No Limit (50/100) - 2021/04/16 23:20:13 EET [2021/04/16 16:20:13 ET]
Table 'NLHE Session 2' 2-max (Play Money) Seat #2 is the button
Seat 1: FDIBA2009 (8914 in chips) 
Seat 2: s70n3fac3 (18563 in chips) 
s70n3fac3: posts small blind 50
FDIBA2009: posts big blind 100
*** HOLE CARDS ***
s70n3fac3: raises 150 to 250
FDIBA2009: calls 150
*** FLOP *** [2c Jh 7c]
FDIBA2009: checks 
s70n3fac3: bets 270
FDIBA2009: calls 270
*** TURN *** [2c Jh 7c] [Kc]
FDIBA2009: checks 
s70n3fac3: bets 425
FDIBA2009: calls 425
*** RIVER *** [2c Jh 7c Kc] [4h]
FDIBA2009: checks 
s70n3fac3: checks 
*** SHOW DOWN ***
FDIBA2009: shows [Tc 7s] (a pair of Sevens)
s70n3fac3: mucks hand 
FDIBA2009 collected 1786 from pot
*** SUMMARY ***
Total pot 1890 | Rake 104 
Board [2c Jh 7c Kc 4h]
Seat 1: FDIBA2009 (big blind) showed [Tc 7s] and won (1786) with a pair of Sevens
Seat 2: s70n3fac3 (button) (small blind) mucked [7h 9d]



PokerStars Home Game Hand #225901792624: {Club #4781089}  Hold'em No Limit (50/100) - 2021/04/16 23:20:43 EET [2021/04/16 16:20:43 ET]
Table 'NLHE Session 2' 2-max (Play Money) Seat #1 is the button
Seat 1: FDIBA2009 (9755 in chips) 
Seat 2: s70n3fac3 (17618 in chips) 
FDIBA2009: posts small blind 50
s70n3fac3: posts big blind 100
*** HOLE CARDS ***
FDIBA2009: raises 100 to 200
s70n3fac3: folds 
Uncalled bet (100) returned to FDIBA2009
FDIBA2009 collected 200 from pot
*** SUMMARY ***
Total pot 200 | Rake 0 
Seat 1: FDIBA2009 (button) (small blind) collected (200)
Seat 2: s70n3fac3 (big blind) folded before Flop



PokerStars Home Game Hand #225901801609: {Club #4781089}  Hold'em No Limit (50/100) - 2021/04/16 23:20:56 EET [2021/04/16 16:20:56 ET]
Table 'NLHE Session 2' 2-max (Play Money) Seat #2 is the button
Seat 1: FDIBA2009 (9855 in chips) 
Seat 2: s70n3fac3 (17518 in chips) 
s70n3fac3: posts small blind 50
FDIBA2009: posts big blind 100
*** HOLE CARDS ***
s70n3fac3: folds 
Uncalled bet (50) returned to FDIBA2009
FDIBA2009 collected 100 from pot
*** SUMMARY ***
Total pot 100 | Rake 0 
Seat 1: FDIBA2009 (big blind) collected (100)
Seat 2: s70n3fac3 (button) (small blind) folded before Flop



PokerStars Home Game Hand #225901804430: {Club #4781089}  Hold'em No Limit (50/100) - 2021/04/16 23:21:00 EET [2021/04/16 16:21:00 ET]
Table 'NLHE Session 2' 2-max (Play Money) Seat #1 is the button
Seat 1: FDIBA2009 (9905 in chips) 
Seat 2: s70n3fac3 (17468 in chips) 
FDIBA2009: posts small blind 50
s70n3fac3: posts big blind 100
*** HOLE CARDS ***
FDIBA2009: raises 100 to 200
s70n3fac3: calls 100
*** FLOP *** [7h Ah 2d]
s70n3fac3: checks 
FDIBA2009: bets 378
s70n3fac3: calls 378
*** TURN *** [7h Ah 2d] [2h]
s70n3fac3: checks 
FDIBA2009: bets 1092
s70n3fac3: folds 
Uncalled bet (1092) returned to FDIBA2009
FDIBA2009 collected 1092 from pot
*** SUMMARY ***
Total pot 1156 | Rake 64 
Board [7h Ah 2d 2h]
Seat 1: FDIBA2009 (button) (small blind) collected (1092)
Seat 2: s70n3fac3 (big blind) folded on the Turn



PokerStars Home Game Hand #225901836009: {Club #4781089}  Hold'em No Limit (50/100) - 2021/04/16 23:21:37 EET [2021/04/16 16:21:37 ET]
Table 'NLHE Session 2' 2-max (Play Money) Seat #2 is the button
Seat 1: FDIBA2009 (10419 in chips) 
Seat 2: s70n3fac3 (16890 in chips) 
s70n3fac3: posts small blind 50
FDIBA2009: posts big blind 100
*** HOLE CARDS ***
s70n3fac3: raises 150 to 250
FDIBA2009: folds 
Uncalled bet (150) returned to s70n3fac3
s70n3fac3 collected 200 from pot
s70n3fac3: doesn't show hand 
*** SUMMARY ***
Total pot 200 | Rake 0 
Seat 1: FDIBA2009 (big blind) folded before Flop
Seat 2: s70n3fac3 (button) (small blind) collected (200)



PokerStars Home Game Hand #225901840325: {Club #4781089}  Hold'em No Limit (50/100) - 2021/04/16 23:21:43 EET [2021/04/16 16:21:43 ET]
Table 'NLHE Session 2' 2-max (Play Money) Seat #1 is the button
Seat 1: FDIBA2009 (10319 in chips) 
Seat 2: s70n3fac3 (16990 in chips) 
FDIBA2009: posts small blind 50
s70n3fac3: posts big blind 100
*** HOLE CARDS ***
FDIBA2009: raises 100 to 200
s70n3fac3: raises 325 to 525
FDIBA2009: raises 375 to 900
s70n3fac3: raises 880 to 1780
FDIBA2009: calls 880
*** FLOP *** [5d 9d As]
s70n3fac3: checks 
FDIBA2009: checks 
*** TURN *** [5d 9d As] [9c]
s70n3fac3: checks 
FDIBA2009: checks 
*** RIVER *** [5d 9d As 9c] [6s]
s70n3fac3: bets 1540
FDIBA2009: folds 
Uncalled bet (1540) returned to s70n3fac3
s70n3fac3 collected 3364 from pot
s70n3fac3: doesn't show hand 
*** SUMMARY ***
Total pot 3560 | Rake 196 
Board [5d 9d As 9c 6s]
Seat 1: FDIBA2009 (button) (small blind) folded on the River
Seat 2: s70n3fac3 (big blind) collected (3364)



PokerStars Home Game Hand #225901891275: {Club #4781089}  Hold'em No Limit (50/100) - 2021/04/16 23:22:56 EET [2021/04/16 16:22:56 ET]
Table 'NLHE Session 2' 2-max (Play Money) Seat #2 is the button
Seat 1: FDIBA2009 (8539 in chips) 
Seat 2: s70n3fac3 (18574 in chips) 
s70n3fac3: posts small blind 50
FDIBA2009: posts big blind 100
*** HOLE CARDS ***
s70n3fac3: raises 150 to 250
FDIBA2009: folds 
Uncalled bet (150) returned to s70n3fac3
s70n3fac3 collected 200 from pot
s70n3fac3: doesn't show hand 
*** SUMMARY ***
Total pot 200 | Rake 0 
Seat 1: FDIBA2009 (big blind) folded before Flop
Seat 2: s70n3fac3 (button) (small blind) collected (200)



PokerStars Home Game Hand #225901895793: {Club #4781089}  Hold'em No Limit (50/100) - 2021/04/16 23:23:02 EET [2021/04/16 16:23:02 ET]
Table 'NLHE Session 2' 2-max (Play Money) Seat #1 is the button
Seat 1: FDIBA2009 (8439 in chips) 
Seat 2: s70n3fac3 (18674 in chips) 
FDIBA2009: posts small blind 50
s70n3fac3: posts big blind 100
*** HOLE CARDS ***
FDIBA2009: raises 100 to 200
s70n3fac3: folds 
Uncalled bet (100) returned to FDIBA2009
FDIBA2009 collected 200 from pot
*** SUMMARY ***
Total pot 200 | Rake 0 
Seat 1: FDIBA2009 (button) (small blind) collected (200)
Seat 2: s70n3fac3 (big blind) folded before Flop



PokerStars Home Game Hand #225901902451: {Club #4781089}  Hold'em No Limit (50/100) - 2021/04/16 23:23:12 EET [2021/04/16 16:23:12 ET]
Table 'NLHE Session 2' 2-max (Play Money) Seat #2 is the button
Seat 1: FDIBA2009 (8539 in chips) 
Seat 2: s70n3fac3 (18574 in chips) 
s70n3fac3: posts small blind 50
FDIBA2009: posts big blind 100
*** HOLE CARDS ***
s70n3fac3: raises 100 to 200
FDIBA2009: raises 400 to 600
s70n3fac3: calls 400
*** FLOP *** [6d 9d Ks]
FDIBA2009: bets 900
s70n3fac3: folds 
Uncalled bet (900) returned to FDIBA2009
FDIBA2009 collected 1134 from pot
*** SUMMARY ***
Total pot 1200 | Rake 66 
Board [6d 9d Ks]
Seat 1: FDIBA2009 (big blind) collected (1134)
Seat 2: s70n3fac3 (button) (small blind) folded on the Flop



PokerStars Home Game Hand #225901918293: {Club #4781089}  Hold'em No Limit (50/100) - 2021/04/16 23:23:34 EET [2021/04/16 16:23:34 ET]
Table 'NLHE Session 2' 2-max (Play Money) Seat #1 is the button
Seat 1: FDIBA2009 (9073 in chips) 
Seat 2: s70n3fac3 (17974 in chips) 
FDIBA2009: posts small blind 50
s70n3fac3: posts big blind 100
*** HOLE CARDS ***
FDIBA2009: raises 100 to 200
s70n3fac3: calls 100
*** FLOP *** [6d 4h 8h]
s70n3fac3: checks 
FDIBA2009: bets 378
s70n3fac3: folds 
Uncalled bet (378) returned to FDIBA2009
FDIBA2009 collected 378 from pot
*** SUMMARY ***
Total pot 400 | Rake 22 
Board [6d 4h 8h]
Seat 1: FDIBA2009 (button) (small blind) collected (378)
Seat 2: s70n3fac3 (big blind) folded on the Flop



PokerStars Home Game Hand #225901931687: {Club #4781089}  Hold'em No Limit (50/100) - 2021/04/16 23:23:54 EET [2021/04/16 16:23:54 ET]
Table 'NLHE Session 2' 2-max (Play Money) Seat #2 is the button
Seat 1: FDIBA2009 (9251 in chips) 
Seat 2: s70n3fac3 (17774 in chips) 
s70n3fac3: posts small blind 50
FDIBA2009: posts big blind 100
*** HOLE CARDS ***
s70n3fac3: raises 100 to 200
FDIBA2009: raises 400 to 600
s70n3fac3: folds 
Uncalled bet (400) returned to FDIBA2009
FDIBA2009 collected 400 from pot
*** SUMMARY ***
Total pot 400 | Rake 0 
Seat 1: FDIBA2009 (big blind) collected (400)
Seat 2: s70n3fac3 (button) (small blind) folded before Flop



PokerStars Home Game Hand #225901938899: {Club #4781089}  Hold'em No Limit (50/100) - 2021/04/16 23:24:04 EET [2021/04/16 16:24:04 ET]
Table 'NLHE Session 2' 2-max (Play Money) Seat #1 is the button
Seat 1: FDIBA2009 (9451 in chips) 
Seat 2: s70n3fac3 (17574 in chips) 
FDIBA2009: posts small blind 50
s70n3fac3: posts big blind 100
*** HOLE CARDS ***
FDIBA2009: raises 100 to 200
s70n3fac3: calls 100
*** FLOP *** [3c 4d Jc]
s70n3fac3: checks 
FDIBA2009: bets 189
s70n3fac3: calls 189
*** TURN *** [3c 4d Jc] [4s]
s70n3fac3: checks 
FDIBA2009: checks 
*** RIVER *** [3c 4d Jc 4s] [7c]
s70n3fac3: checks 
FDIBA2009: checks 
*** SHOW DOWN ***
s70n3fac3: shows [Qd 9c] (a pair of Fours)
FDIBA2009: shows [8h 7h] (two pair, Sevens and Fours)
FDIBA2009 collected 735 from pot
*** SUMMARY ***
Total pot 778 | Rake 43 
Board [3c 4d Jc 4s 7c]
Seat 1: FDIBA2009 (button) (small blind) showed [8h 7h] and won (735) with two pair, Sevens and Fours
Seat 2: s70n3fac3 (big blind) showed [Qd 9c] and lost with a pair of Fours



PokerStars Home Game Hand #225901964654: {Club #4781089}  Hold'em No Limit (50/100) - 2021/04/16 23:24:41 EET [2021/04/16 16:24:41 ET]
Table 'NLHE Session 2' 2-max (Play Money) Seat #2 is the button
Seat 1: FDIBA2009 (9797 in chips) 
Seat 2: s70n3fac3 (17185 in chips) 
s70n3fac3: posts small blind 50
FDIBA2009: posts big blind 100
*** HOLE CARDS ***
s70n3fac3: raises 100 to 200
FDIBA2009: raises 400 to 600
s70n3fac3: folds 
Uncalled bet (400) returned to FDIBA2009
FDIBA2009 collected 400 from pot
*** SUMMARY ***
Total pot 400 | Rake 0 
Seat 1: FDIBA2009 (big blind) collected (400)
Seat 2: s70n3fac3 (button) (small blind) folded before Flop



PokerStars Home Game Hand #225901971896: {Club #4781089}  Hold'em No Limit (50/100) - 2021/04/16 23:24:51 EET [2021/04/16 16:24:51 ET]
Table 'NLHE Session 2' 2-max (Play Money) Seat #1 is the button
Seat 1: FDIBA2009 (9997 in chips) 
Seat 2: s70n3fac3 (16985 in chips) 
FDIBA2009: posts small blind 50
s70n3fac3: posts big blind 100
*** HOLE CARDS ***
FDIBA2009: raises 100 to 200
s70n3fac3: calls 100
*** FLOP *** [Td 9d Ad]
s70n3fac3: checks 
FDIBA2009: checks 
*** TURN *** [Td 9d Ad] [3s]
s70n3fac3: checks 
FDIBA2009: bets 200
s70n3fac3: folds 
Uncalled bet (200) returned to FDIBA2009
FDIBA2009 collected 378 from pot
*** SUMMARY ***
Total pot 400 | Rake 22 
Board [Td 9d Ad 3s]
Seat 1: FDIBA2009 (button) (small blind) collected (378)
Seat 2: s70n3fac3 (big blind) folded on the Turn



PokerStars Home Game Hand #225901984448: {Club #4781089}  Hold'em No Limit (50/100) - 2021/04/16 23:25:10 EET [2021/04/16 16:25:10 ET]
Table 'NLHE Session 2' 2-max (Play Money) Seat #2 is the button
Seat 1: FDIBA2009 (10175 in chips) 
Seat 2: s70n3fac3 (16785 in chips) 
s70n3fac3: posts small blind 50
FDIBA2009: posts big blind 100
*** HOLE CARDS ***
s70n3fac3: folds 
Uncalled bet (50) returned to FDIBA2009
FDIBA2009 collected 100 from pot
*** SUMMARY ***
Total pot 100 | Rake 0 
Seat 1: FDIBA2009 (big blind) collected (100)
Seat 2: s70n3fac3 (button) (small blind) folded before Flop



PokerStars Home Game Hand #225901987440: {Club #4781089}  Hold'em No Limit (50/100) - 2021/04/16 23:25:14 EET [2021/04/16 16:25:14 ET]
Table 'NLHE Session 2' 2-max (Play Money) Seat #1 is the button
Seat 1: FDIBA2009 (10225 in chips) 
Seat 2: s70n3fac3 (16735 in chips) 
FDIBA2009: posts small blind 50
s70n3fac3: posts big blind 100
*** HOLE CARDS ***
FDIBA2009: raises 100 to 200
s70n3fac3: raises 300 to 500
FDIBA2009: folds 
Uncalled bet (300) returned to s70n3fac3
s70n3fac3 collected 400 from pot
*** SUMMARY ***
Total pot 400 | Rake 0 
Seat 1: FDIBA2009 (button) (small blind) folded before Flop
Seat 2: s70n3fac3 (big blind) collected (400)



PokerStars Home Game Hand #225901993293: {Club #4781089}  Hold'em No Limit (50/100) - 2021/04/16 23:25:22 EET [2021/04/16 16:25:22 ET]
Table 'NLHE Session 2' 2-max (Play Money) Seat #2 is the button
Seat 1: FDIBA2009 (10025 in chips) 
Seat 2: s70n3fac3 (16935 in chips) 
s70n3fac3: posts small blind 50
FDIBA2009: posts big blind 100
*** HOLE CARDS ***
s70n3fac3: folds 
Uncalled bet (50) returned to FDIBA2009
FDIBA2009 collected 100 from pot
*** SUMMARY ***
Total pot 100 | Rake 0 
Seat 1: FDIBA2009 (big blind) collected (100)
Seat 2: s70n3fac3 (button) (small blind) folded before Flop



PokerStars Home Game Hand #225901996116: {Club #4781089}  Hold'em No Limit (50/100) - 2021/04/16 23:25:27 EET [2021/04/16 16:25:27 ET]
Table 'NLHE Session 2' 2-max (Play Money) Seat #1 is the button
Seat 1: FDIBA2009 (10075 in chips) 
Seat 2: s70n3fac3 (16885 in chips) 
FDIBA2009: posts small blind 50
s70n3fac3: posts big blind 100
*** HOLE CARDS ***
FDIBA2009: raises 100 to 200
s70n3fac3: raises 300 to 500
FDIBA2009: folds 
Uncalled bet (300) returned to s70n3fac3
s70n3fac3 collected 400 from pot
s70n3fac3: doesn't show hand 
*** SUMMARY ***
Total pot 400 | Rake 0 
Seat 1: FDIBA2009 (button) (small blind) folded before Flop
Seat 2: s70n3fac3 (big blind) collected (400)



PokerStars Home Game Hand #225902001896: {Club #4781089}  Hold'em No Limit (50/100) - 2021/04/16 23:25:35 EET [2021/04/16 16:25:35 ET]
Table 'NLHE Session 2' 2-max (Play Money) Seat #2 is the button
Seat 1: FDIBA2009 (9875 in chips) 
Seat 2: s70n3fac3 (17085 in chips) 
s70n3fac3: posts small blind 50
FDIBA2009: posts big blind 100
*** HOLE CARDS ***
s70n3fac3: raises 100 to 200
FDIBA2009: folds 
Uncalled bet (100) returned to s70n3fac3
s70n3fac3 collected 200 from pot
s70n3fac3: doesn't show hand 
*** SUMMARY ***
Total pot 200 | Rake 0 
Seat 1: FDIBA2009 (big blind) folded before Flop
Seat 2: s70n3fac3 (button) (small blind) collected (200)



PokerStars Home Game Hand #225902005382: {Club #4781089}  Hold'em No Limit (50/100) - 2021/04/16 23:25:40 EET [2021/04/16 16:25:40 ET]
Table 'NLHE Session 2' 2-max (Play Money) Seat #1 is the button
Seat 1: FDIBA2009 (9775 in chips) 
Seat 2: s70n3fac3 (17185 in chips) 
FDIBA2009: posts small blind 50
s70n3fac3: posts big blind 100
*** HOLE CARDS ***
FDIBA2009: raises 100 to 200
s70n3fac3: calls 100
*** FLOP *** [Jc As 4c]
s70n3fac3: checks 
FDIBA2009: bets 378
s70n3fac3: calls 378
*** TURN *** [Jc As 4c] [Qh]
s70n3fac3: checks 
FDIBA2009: bets 900
s70n3fac3: folds 
Uncalled bet (900) returned to FDIBA2009
FDIBA2009 collected 1092 from pot
*** SUMMARY ***
Total pot 1156 | Rake 64 
Board [Jc As 4c Qh]
Seat 1: FDIBA2009 (button) (small blind) collected (1092)
Seat 2: s70n3fac3 (big blind) folded on the Turn



PokerStars Home Game Hand #225902032597: {Club #4781089}  Hold'em No Limit (50/100) - 2021/04/16 23:26:19 EET [2021/04/16 16:26:19 ET]
Table 'NLHE Session 2' 2-max (Play Money) Seat #2 is the button
Seat 1: FDIBA2009 (10289 in chips) 
Seat 2: s70n3fac3 (16607 in chips) 
s70n3fac3: posts small blind 50
FDIBA2009: posts big blind 100
*** HOLE CARDS ***
s70n3fac3: raises 150 to 250
FDIBA2009: calls 150
*** FLOP *** [3s Ad Kc]
FDIBA2009: checks 
s70n3fac3: bets 225
FDIBA2009: folds 
Uncalled bet (225) returned to s70n3fac3
s70n3fac3 collected 472 from pot
s70n3fac3: doesn't show hand 
*** SUMMARY ***
Total pot 500 | Rake 28 
Board [3s Ad Kc]
Seat 1: FDIBA2009 (big blind) folded on the Flop
Seat 2: s70n3fac3 (button) (small blind) collected (472)



PokerStars Home Game Hand #225902041574: {Club #4781089}  Hold'em No Limit (50/100) - 2021/04/16 23:26:33 EET [2021/04/16 16:26:33 ET]
Table 'NLHE Session 2' 2-max (Play Money) Seat #1 is the button
Seat 1: FDIBA2009 (10039 in chips) 
Seat 2: s70n3fac3 (16829 in chips) 
FDIBA2009: posts small blind 50
s70n3fac3: posts big blind 100
*** HOLE CARDS ***
FDIBA2009: raises 100 to 200
s70n3fac3: raises 300 to 500
FDIBA2009: calls 300
*** FLOP *** [Jh 8d 8s]
s70n3fac3: bets 489
FDIBA2009: calls 489
*** TURN *** [Jh 8d 8s] [4h]
s70n3fac3: checks 
FDIBA2009: bets 800
s70n3fac3: calls 800
*** RIVER *** [Jh 8d 8s 4h] [Kd]
s70n3fac3: bets 1750
FDIBA2009 has timed out
FDIBA2009: folds 
Uncalled bet (1750) returned to s70n3fac3
s70n3fac3 collected 3381 from pot
s70n3fac3: doesn't show hand 
*** SUMMARY ***
Total pot 3578 | Rake 197 
Board [Jh 8d 8s 4h Kd]
Seat 1: FDIBA2009 (button) (small blind) folded on the River
Seat 2: s70n3fac3 (big blind) collected (3381)



PokerStars Home Game Hand #225902088293: {Club #4781089}  Hold'em No Limit (50/100) - 2021/04/16 23:27:40 EET [2021/04/16 16:27:40 ET]
Table 'NLHE Session 2' 2-max (Play Money) Seat #2 is the button
Seat 1: FDIBA2009 (8250 in chips) 
Seat 2: s70n3fac3 (18421 in chips) 
s70n3fac3: posts small blind 50
FDIBA2009: posts big blind 100
*** HOLE CARDS ***
s70n3fac3: raises 150 to 250
FDIBA2009: folds 
Uncalled bet (150) returned to s70n3fac3
s70n3fac3 collected 200 from pot
s70n3fac3: doesn't show hand 
*** SUMMARY ***
Total pot 200 | Rake 0 
Seat 1: FDIBA2009 (big blind) folded before Flop
Seat 2: s70n3fac3 (button) (small blind) collected (200)



PokerStars Home Game Hand #225902092945: {Club #4781089}  Hold'em No Limit (50/100) - 2021/04/16 23:27:47 EET [2021/04/16 16:27:47 ET]
Table 'NLHE Session 2' 2-max (Play Money) Seat #1 is the button
Seat 1: FDIBA2009 (8150 in chips) 
Seat 2: s70n3fac3 (18521 in chips) 
FDIBA2009: posts small blind 50
s70n3fac3: posts big blind 100
*** HOLE CARDS ***
FDIBA2009: raises 100 to 200
s70n3fac3: folds 
Uncalled bet (100) returned to FDIBA2009
FDIBA2009 collected 200 from pot
*** SUMMARY ***
Total pot 200 | Rake 0 
Seat 1: FDIBA2009 (button) (small blind) collected (200)
Seat 2: s70n3fac3 (big blind) folded before Flop



PokerStars Home Game Hand #225902097363: {Club #4781089}  Hold'em No Limit (50/100) - 2021/04/16 23:27:53 EET [2021/04/16 16:27:53 ET]
Table 'NLHE Session 2' 2-max (Play Money) Seat #2 is the button
Seat 1: FDIBA2009 (8250 in chips) 
Seat 2: s70n3fac3 (18421 in chips) 
s70n3fac3: posts small blind 50
FDIBA2009: posts big blind 100
*** HOLE CARDS ***
s70n3fac3: raises 130 to 230
FDIBA2009: folds 
Uncalled bet (130) returned to s70n3fac3
s70n3fac3 collected 200 from pot
s70n3fac3: doesn't show hand 
*** SUMMARY ***
Total pot 200 | Rake 0 
Seat 1: FDIBA2009 (big blind) folded before Flop
Seat 2: s70n3fac3 (button) (small blind) collected (200)



PokerStars Home Game Hand #225902102424: {Club #4781089}  Hold'em No Limit (50/100) - 2021/04/16 23:28:00 EET [2021/04/16 16:28:00 ET]
Table 'NLHE Session 2' 2-max (Play Money) Seat #1 is the button
Seat 1: FDIBA2009 (8150 in chips) 
Seat 2: s70n3fac3 (18521 in chips) 
FDIBA2009: posts small blind 50
s70n3fac3: posts big blind 100
*** HOLE CARDS ***
FDIBA2009: raises 100 to 200
s70n3fac3: calls 100
*** FLOP *** [8h 6h 2c]
s70n3fac3: checks 
FDIBA2009: bets 378
s70n3fac3: folds 
Uncalled bet (378) returned to FDIBA2009
FDIBA2009 collected 378 from pot
*** SUMMARY ***
Total pot 400 | Rake 22 
Board [8h 6h 2c]
Seat 1: FDIBA2009 (button) (small blind) collected (378)
Seat 2: s70n3fac3 (big blind) folded on the Flop



PokerStars Home Game Hand #225902113205: {Club #4781089}  Hold'em No Limit (50/100) - 2021/04/16 23:28:16 EET [2021/04/16 16:28:16 ET]
Table 'NLHE Session 2' 2-max (Play Money) Seat #2 is the button
Seat 1: FDIBA2009 (8328 in chips) 
Seat 2: s70n3fac3 (18321 in chips) 
s70n3fac3: posts small blind 50
FDIBA2009: posts big blind 100
*** HOLE CARDS ***
s70n3fac3: folds 
Uncalled bet (50) returned to FDIBA2009
FDIBA2009 collected 100 from pot
*** SUMMARY ***
Total pot 100 | Rake 0 
Seat 1: FDIBA2009 (big blind) collected (100)
Seat 2: s70n3fac3 (button) (small blind) folded before Flop



PokerStars Home Game Hand #225902116008: {Club #4781089}  Hold'em No Limit (50/100) - 2021/04/16 23:28:20 EET [2021/04/16 16:28:20 ET]
Table 'NLHE Session 2' 2-max (Play Money) Seat #1 is the button
Seat 1: FDIBA2009 (8378 in chips) 
Seat 2: s70n3fac3 (18271 in chips) 
FDIBA2009: posts small blind 50
s70n3fac3: posts big blind 100
*** HOLE CARDS ***
FDIBA2009: raises 200 to 300
s70n3fac3: folds 
Uncalled bet (200) returned to FDIBA2009
FDIBA2009 collected 200 from pot
*** SUMMARY ***
Total pot 200 | Rake 0 
Seat 1: FDIBA2009 (button) (small blind) collected (200)
Seat 2: s70n3fac3 (big blind) folded before Flop



PokerStars Home Game Hand #225902121069: {Club #4781089}  Hold'em No Limit (50/100) - 2021/04/16 23:28:27 EET [2021/04/16 16:28:27 ET]
Table 'NLHE Session 2' 2-max (Play Money) Seat #2 is the button
Seat 1: FDIBA2009 (8478 in chips) 
Seat 2: s70n3fac3 (18171 in chips) 
s70n3fac3: posts small blind 50
FDIBA2009: posts big blind 100
*** HOLE CARDS ***
s70n3fac3: raises 150 to 250
FDIBA2009: calls 150
*** FLOP *** [6s Ad Ks]
FDIBA2009: checks 
s70n3fac3: bets 260
FDIBA2009: folds 
Uncalled bet (260) returned to s70n3fac3
s70n3fac3 collected 472 from pot
s70n3fac3: doesn't show hand 
*** SUMMARY ***
Total pot 500 | Rake 28 
Board [6s Ad Ks]
Seat 1: FDIBA2009 (big blind) folded on the Flop
Seat 2: s70n3fac3 (button) (small blind) collected (472)



PokerStars Home Game Hand #225902131669: {Club #4781089}  Hold'em No Limit (50/100) - 2021/04/16 23:28:43 EET [2021/04/16 16:28:43 ET]
Table 'NLHE Session 2' 2-max (Play Money) Seat #1 is the button
Seat 1: FDIBA2009 (8228 in chips) 
Seat 2: s70n3fac3 (18393 in chips) 
FDIBA2009: posts small blind 50
s70n3fac3: posts big blind 100
*** HOLE CARDS ***
FDIBA2009: raises 100 to 200
s70n3fac3: raises 300 to 500
FDIBA2009: calls 300
*** FLOP *** [2c Qh 4d]
s70n3fac3: bets 450
FDIBA2009: folds 
Uncalled bet (450) returned to s70n3fac3
s70n3fac3 collected 945 from pot
s70n3fac3: doesn't show hand 
*** SUMMARY ***
Total pot 1000 | Rake 55 
Board [2c Qh 4d]
Seat 1: FDIBA2009 (button) (small blind) folded on the Flop
Seat 2: s70n3fac3 (big blind) collected (945)



PokerStars Home Game Hand #225902142928: {Club #4781089}  Hold'em No Limit (50/100) - 2021/04/16 23:28:59 EET [2021/04/16 16:28:59 ET]
Table 'NLHE Session 2' 2-max (Play Money) Seat #2 is the button
Seat 1: FDIBA2009 (7728 in chips) 
Seat 2: s70n3fac3 (18838 in chips) 
s70n3fac3: posts small blind 50
FDIBA2009: posts big blind 100
*** HOLE CARDS ***
s70n3fac3: raises 100 to 200
FDIBA2009: raises 400 to 600
s70n3fac3: calls 400
*** FLOP *** [Ah 4d 6d]
FDIBA2009: checks 
s70n3fac3: checks 
*** TURN *** [Ah 4d 6d] [7h]
FDIBA2009: bets 600
s70n3fac3: folds 
Uncalled bet (600) returned to FDIBA2009
FDIBA2009 collected 1134 from pot
*** SUMMARY ***
Total pot 1200 | Rake 66 
Board [Ah 4d 6d 7h]
Seat 1: FDIBA2009 (big blind) collected (1134)
Seat 2: s70n3fac3 (button) (small blind) folded on the Turn



PokerStars Home Game Hand #225902164999: {Club #4781089}  Hold'em No Limit (50/100) - 2021/04/16 23:29:31 EET [2021/04/16 16:29:31 ET]
Table 'NLHE Session 2' 2-max (Play Money) Seat #1 is the button
Seat 1: FDIBA2009 (8262 in chips) 
Seat 2: s70n3fac3 (18238 in chips) 
FDIBA2009: posts small blind 50
s70n3fac3: posts big blind 100
*** HOLE CARDS ***
FDIBA2009: raises 100 to 200
s70n3fac3: raises 300 to 500
FDIBA2009: calls 300
*** FLOP *** [6s Jc 9c]
s70n3fac3: checks 
FDIBA2009: bets 700
s70n3fac3: calls 700
*** TURN *** [6s Jc 9c] [8s]
s70n3fac3: checks 
FDIBA2009: bets 1600
s70n3fac3: folds 
Uncalled bet (1600) returned to FDIBA2009
FDIBA2009 collected 2268 from pot
*** SUMMARY ***
Total pot 2400 | Rake 132 
Board [6s Jc 9c 8s]
Seat 1: FDIBA2009 (button) (small blind) collected (2268)
Seat 2: s70n3fac3 (big blind) folded on the Turn



PokerStars Home Game Hand #225902199009: {Club #4781089}  Hold'em No Limit (50/100) - 2021/04/16 23:30:21 EET [2021/04/16 16:30:21 ET]
Table 'NLHE Session 2' 2-max (Play Money) Seat #2 is the button
Seat 1: FDIBA2009 (9330 in chips) 
Seat 2: s70n3fac3 (17038 in chips) 
s70n3fac3: posts small blind 50
FDIBA2009: posts big blind 100
*** HOLE CARDS ***
s70n3fac3: raises 150 to 250
FDIBA2009: folds 
Uncalled bet (150) returned to s70n3fac3
s70n3fac3 collected 200 from pot
s70n3fac3: doesn't show hand 
*** SUMMARY ***
Total pot 200 | Rake 0 
Seat 1: FDIBA2009 (big blind) folded before Flop
Seat 2: s70n3fac3 (button) (small blind) collected (200)



PokerStars Home Game Hand #225902202786: {Club #4781089}  Hold'em No Limit (50/100) - 2021/04/16 23:30:26 EET [2021/04/16 16:30:26 ET]
Table 'NLHE Session 2' 2-max (Play Money) Seat #1 is the button
Seat 1: FDIBA2009 (9230 in chips) 
Seat 2: s70n3fac3 (17138 in chips) 
FDIBA2009: posts small blind 50
s70n3fac3: posts big blind 100
*** HOLE CARDS ***
FDIBA2009: raises 100 to 200
s70n3fac3: calls 100
*** FLOP *** [7d 3d 3s]
s70n3fac3: checks 
FDIBA2009: bets 189
s70n3fac3: folds 
Uncalled bet (189) returned to FDIBA2009
FDIBA2009 collected 378 from pot
*** SUMMARY ***
Total pot 400 | Rake 22 
Board [7d 3d 3s]
Seat 1: FDIBA2009 (button) (small blind) collected (378)
Seat 2: s70n3fac3 (big blind) folded on the Flop



PokerStars Home Game Hand #225902211871: {Club #4781089}  Hold'em No Limit (50/100) - 2021/04/16 23:30:40 EET [2021/04/16 16:30:40 ET]
Table 'NLHE Session 2' 2-max (Play Money) Seat #2 is the button
Seat 1: FDIBA2009 (9408 in chips) 
Seat 2: s70n3fac3 (16938 in chips) 
s70n3fac3: posts small blind 50
FDIBA2009: posts big blind 100
*** HOLE CARDS ***
s70n3fac3: folds 
Uncalled bet (50) returned to FDIBA2009
FDIBA2009 collected 100 from pot
*** SUMMARY ***
Total pot 100 | Rake 0 
Seat 1: FDIBA2009 (big blind) collected (100)
Seat 2: s70n3fac3 (button) (small blind) folded before Flop



PokerStars Home Game Hand #225902214602: {Club #4781089}  Hold'em No Limit (50/100) - 2021/04/16 23:30:44 EET [2021/04/16 16:30:44 ET]
Table 'NLHE Session 2' 2-max (Play Money) Seat #1 is the button
Seat 1: FDIBA2009 (9458 in chips) 
Seat 2: s70n3fac3 (16888 in chips) 
FDIBA2009: posts small blind 50
s70n3fac3: posts big blind 100
*** HOLE CARDS ***
FDIBA2009: raises 100 to 200
s70n3fac3: calls 100
*** FLOP *** [Ac Jd 8c]
s70n3fac3: checks 
FDIBA2009: bets 378
s70n3fac3: folds 
Uncalled bet (378) returned to FDIBA2009
FDIBA2009 collected 378 from pot
*** SUMMARY ***
Total pot 400 | Rake 22 
Board [Ac Jd 8c]
Seat 1: FDIBA2009 (button) (small blind) collected (378)
Seat 2: s70n3fac3 (big blind) folded on the Flop



PokerStars Home Game Hand #225902223994: {Club #4781089}  Hold'em No Limit (50/100) - 2021/04/16 23:30:57 EET [2021/04/16 16:30:57 ET]
Table 'NLHE Session 2' 2-max (Play Money) Seat #2 is the button
Seat 1: FDIBA2009 (9636 in chips) 
Seat 2: s70n3fac3 (16688 in chips) 
s70n3fac3: posts small blind 50
FDIBA2009: posts big blind 100
*** HOLE CARDS ***
s70n3fac3: raises 100 to 200
FDIBA2009: calls 100
*** FLOP *** [Ad 5h 9c]
FDIBA2009: checks 
s70n3fac3: bets 220
FDIBA2009: calls 220
*** TURN *** [Ad 5h 9c] [Tc]
FDIBA2009: checks 
s70n3fac3: checks 
*** RIVER *** [Ad 5h 9c Tc] [3s]
FDIBA2009: bets 794
s70n3fac3: folds 
Uncalled bet (794) returned to FDIBA2009
FDIBA2009 collected 794 from pot
*** SUMMARY ***
Total pot 840 | Rake 46 
Board [Ad 5h 9c Tc 3s]
Seat 1: FDIBA2009 (big blind) collected (794)
Seat 2: s70n3fac3 (button) (small blind) folded on the River



PokerStars Home Game Hand #225902250424: {Club #4781089}  Hold'em No Limit (50/100) - 2021/04/16 23:31:36 EET [2021/04/16 16:31:36 ET]
Table 'NLHE Session 2' 2-max (Play Money) Seat #1 is the button
Seat 1: FDIBA2009 (10010 in chips) 
Seat 2: s70n3fac3 (16268 in chips) 
FDIBA2009: posts small blind 50
s70n3fac3: posts big blind 100
*** HOLE CARDS ***
FDIBA2009: raises 100 to 200
s70n3fac3: calls 100
*** FLOP *** [Ad Kd 6c]
s70n3fac3: checks 
FDIBA2009: bets 189
s70n3fac3: folds 
Uncalled bet (189) returned to FDIBA2009
FDIBA2009 collected 378 from pot
*** SUMMARY ***
Total pot 400 | Rake 22 
Board [Ad Kd 6c]
Seat 1: FDIBA2009 (button) (small blind) collected (378)
Seat 2: s70n3fac3 (big blind) folded on the Flop



PokerStars Home Game Hand #225902261034: {Club #4781089}  Hold'em No Limit (50/100) - 2021/04/16 23:31:51 EET [2021/04/16 16:31:51 ET]
Table 'NLHE Session 2' 2-max (Play Money) Seat #2 is the button
Seat 1: FDIBA2009 (10188 in chips) 
Seat 2: s70n3fac3 (16068 in chips) 
s70n3fac3: posts small blind 50
FDIBA2009: posts big blind 100
*** HOLE CARDS ***
s70n3fac3: raises 150 to 250
FDIBA2009: calls 150
*** FLOP *** [4d 7d Kc]
FDIBA2009: checks 
s70n3fac3: bets 250
FDIBA2009: calls 250
*** TURN *** [4d 7d Kc] [6d]
FDIBA2009: checks 
s70n3fac3: bets 500
FDIBA2009: folds 
Uncalled bet (500) returned to s70n3fac3
s70n3fac3 collected 945 from pot
s70n3fac3: doesn't show hand 
*** SUMMARY ***
Total pot 1000 | Rake 55 
Board [4d 7d Kc 6d]
Seat 1: FDIBA2009 (big blind) folded on the Turn
Seat 2: s70n3fac3 (button) (small blind) collected (945)



PokerStars Home Game Hand #225902275641: {Club #4781089}  Hold'em No Limit (50/100) - 2021/04/16 23:32:13 EET [2021/04/16 16:32:13 ET]
Table 'NLHE Session 2' 2-max (Play Money) Seat #1 is the button
Seat 1: FDIBA2009 (9688 in chips) 
Seat 2: s70n3fac3 (16513 in chips) 
FDIBA2009: posts small blind 50
s70n3fac3: posts big blind 100
*** HOLE CARDS ***
FDIBA2009: raises 100 to 200
s70n3fac3: folds 
Uncalled bet (100) returned to FDIBA2009
FDIBA2009 collected 200 from pot
*** SUMMARY ***
Total pot 200 | Rake 0 
Seat 1: FDIBA2009 (button) (small blind) collected (200)
Seat 2: s70n3fac3 (big blind) folded before Flop



PokerStars Home Game Hand #225902279612: {Club #4781089}  Hold'em No Limit (50/100) - 2021/04/16 23:32:19 EET [2021/04/16 16:32:19 ET]
Table 'NLHE Session 2' 2-max (Play Money) Seat #2 is the button
Seat 1: FDIBA2009 (9788 in chips) 
Seat 2: s70n3fac3 (16413 in chips) 
s70n3fac3: posts small blind 50
FDIBA2009: posts big blind 100
*** HOLE CARDS ***
s70n3fac3: folds 
Uncalled bet (50) returned to FDIBA2009
FDIBA2009 collected 100 from pot
*** SUMMARY ***
Total pot 100 | Rake 0 
Seat 1: FDIBA2009 (big blind) collected (100)
Seat 2: s70n3fac3 (button) (small blind) folded before Flop



PokerStars Home Game Hand #225902282486: {Club #4781089}  Hold'em No Limit (50/100) - 2021/04/16 23:32:23 EET [2021/04/16 16:32:23 ET]
Table 'NLHE Session 2' 2-max (Play Money) Seat #1 is the button
Seat 1: FDIBA2009 (9838 in chips) 
Seat 2: s70n3fac3 (16363 in chips) 
FDIBA2009: posts small blind 50
s70n3fac3: posts big blind 100
*** HOLE CARDS ***
FDIBA2009: raises 100 to 200
s70n3fac3: calls 100
*** FLOP *** [Kd 8c 9d]
s70n3fac3: checks 
FDIBA2009: bets 189
s70n3fac3: calls 189
*** TURN *** [Kd 8c 9d] [Th]
s70n3fac3: checks 
FDIBA2009: bets 500
s70n3fac3: calls 500
*** RIVER *** [Kd 8c 9d Th] [3s]
s70n3fac3: checks 
FDIBA2009: bets 900
s70n3fac3: folds 
Uncalled bet (900) returned to FDIBA2009
FDIBA2009 collected 1680 from pot
*** SUMMARY ***
Total pot 1778 | Rake 98 
Board [Kd 8c 9d Th 3s]
Seat 1: FDIBA2009 (button) (small blind) collected (1680)
Seat 2: s70n3fac3 (big blind) folded on the River



PokerStars Home Game Hand #225902316421: {Club #4781089}  Hold'em No Limit (50/100) - 2021/04/16 23:33:13 EET [2021/04/16 16:33:13 ET]
Table 'NLHE Session 2' 2-max (Play Money) Seat #2 is the button
Seat 1: FDIBA2009 (10629 in chips) 
Seat 2: s70n3fac3 (15474 in chips) 
s70n3fac3: posts small blind 50
FDIBA2009: posts big blind 100
*** HOLE CARDS ***
s70n3fac3: raises 150 to 250
FDIBA2009: calls 150
*** FLOP *** [Tc Ks 5d]
FDIBA2009: checks 
s70n3fac3: bets 245
FDIBA2009: calls 245
*** TURN *** [Tc Ks 5d] [3h]
FDIBA2009: checks 
s70n3fac3: checks 
*** RIVER *** [Tc Ks 5d 3h] [3c]
FDIBA2009: checks 
s70n3fac3: checks 
*** SHOW DOWN ***
FDIBA2009: shows [9c 8c] (a pair of Threes)
s70n3fac3: shows [2c Ac] (a pair of Threes - Ace kicker)
s70n3fac3 collected 936 from pot
*** SUMMARY ***
Total pot 990 | Rake 54 
Board [Tc Ks 5d 3h 3c]
Seat 1: FDIBA2009 (big blind) showed [9c 8c] and lost with a pair of Threes
Seat 2: s70n3fac3 (button) (small blind) showed [2c Ac] and won (936) with a pair of Threes



PokerStars Home Game Hand #225902333893: {Club #4781089}  Hold'em No Limit (50/100) - 2021/04/16 23:33:38 EET [2021/04/16 16:33:38 ET]
Table 'NLHE Session 2' 2-max (Play Money) Seat #1 is the button
Seat 1: FDIBA2009 (10134 in chips) 
Seat 2: s70n3fac3 (15915 in chips) 
FDIBA2009: posts small blind 50
s70n3fac3: posts big blind 100
*** HOLE CARDS ***
FDIBA2009: raises 100 to 200
s70n3fac3: raises 300 to 500
FDIBA2009: raises 1000 to 1500
s70n3fac3: folds 
Uncalled bet (1000) returned to FDIBA2009
FDIBA2009 collected 1000 from pot
*** SUMMARY ***
Total pot 1000 | Rake 0 
Seat 1: FDIBA2009 (button) (small blind) collected (1000)
Seat 2: s70n3fac3 (big blind) folded before Flop



PokerStars Home Game Hand #225902353772: {Club #4781089}  Hold'em No Limit (50/100) - 2021/04/16 23:34:07 EET [2021/04/16 16:34:07 ET]
Table 'NLHE Session 2' 2-max (Play Money) Seat #2 is the button
Seat 1: FDIBA2009 (10634 in chips) 
Seat 2: s70n3fac3 (15415 in chips) 
s70n3fac3: posts small blind 50
FDIBA2009: posts big blind 100
*** HOLE CARDS ***
s70n3fac3: raises 100 to 200
FDIBA2009: calls 100
*** FLOP *** [Ad Ah Qh]
FDIBA2009: checks 
s70n3fac3: bets 200
FDIBA2009: calls 200
*** TURN *** [Ad Ah Qh] [Qd]
FDIBA2009: checks 
s70n3fac3: bets 300
FDIBA2009: calls 300
*** RIVER *** [Ad Ah Qh Qd] [5d]
FDIBA2009: checks 
s70n3fac3: bets 1567
FDIBA2009: calls 1567
*** SHOW DOWN ***
s70n3fac3: shows [8h 6c] (two pair, Aces and Queens)
FDIBA2009: shows [7h Kc] (two pair, Aces and Queens - King kicker)
FDIBA2009 collected 4285 from pot
*** SUMMARY ***
Total pot 4534 | Rake 249 
Board [Ad Ah Qh Qd 5d]
Seat 1: FDIBA2009 (big blind) showed [7h Kc] and won (4285) with two pair, Aces and Queens
Seat 2: s70n3fac3 (button) (small blind) showed [8h 6c] and lost with two pair, Aces and Queens



PokerStars Home Game Hand #225902382962: {Club #4781089}  Hold'em No Limit (50/100) - 2021/04/16 23:34:50 EET [2021/04/16 16:34:50 ET]
Table 'NLHE Session 2' 2-max (Play Money) Seat #1 is the button
Seat 1: FDIBA2009 (12652 in chips) 
Seat 2: s70n3fac3 (13148 in chips) 
FDIBA2009: posts small blind 50
s70n3fac3: posts big blind 100
*** HOLE CARDS ***
FDIBA2009: raises 100 to 200
s70n3fac3: calls 100
*** FLOP *** [Qd Js Th]
s70n3fac3: checks 
FDIBA2009: bets 189
s70n3fac3: calls 189
*** TURN *** [Qd Js Th] [Kh]
s70n3fac3: checks 
FDIBA2009: checks 
*** RIVER *** [Qd Js Th Kh] [8d]
s70n3fac3: bets 500
FDIBA2009: calls 500
*** SHOW DOWN ***
s70n3fac3: shows [8h Jh] (two pair, Jacks and Eights)
FDIBA2009: mucks hand 
s70n3fac3 collected 1680 from pot
*** SUMMARY ***
Total pot 1778 | Rake 98 
Board [Qd Js Th Kh 8d]
Seat 1: FDIBA2009 (button) (small blind) mucked [Kd 5s]
Seat 2: s70n3fac3 (big blind) showed [8h Jh] and won (1680) with two pair, Jacks and Eights



PokerStars Home Game Hand #225902417895: {Club #4781089}  Hold'em No Limit (50/100) - 2021/04/16 23:35:28 EET [2021/04/16 16:35:28 ET]
Table 'NLHE Session 2' 2-max (Play Money) Seat #2 is the button
Seat 1: FDIBA2009 (11763 in chips) 
Seat 2: s70n3fac3 (13939 in chips) 
s70n3fac3: posts small blind 50
FDIBA2009: posts big blind 100
*** HOLE CARDS ***
s70n3fac3: folds 
Uncalled bet (50) returned to FDIBA2009
FDIBA2009 collected 100 from pot
*** SUMMARY ***
Total pot 100 | Rake 0 
Seat 1: FDIBA2009 (big blind) collected (100)
Seat 2: s70n3fac3 (button) (small blind) folded before Flop



PokerStars Home Game Hand #225902420915: {Club #4781089}  Hold'em No Limit (50/100) - 2021/04/16 23:35:32 EET [2021/04/16 16:35:32 ET]
Table 'NLHE Session 2' 2-max (Play Money) Seat #1 is the button
Seat 1: FDIBA2009 (11813 in chips) 
Seat 2: s70n3fac3 (13889 in chips) 
FDIBA2009: posts small blind 50
s70n3fac3: posts big blind 100
*** HOLE CARDS ***
FDIBA2009: folds 
Uncalled bet (50) returned to s70n3fac3
s70n3fac3 collected 100 from pot
s70n3fac3: doesn't show hand 
*** SUMMARY ***
Total pot 100 | Rake 0 
Seat 1: FDIBA2009 (button) (small blind) folded before Flop
Seat 2: s70n3fac3 (big blind) collected (100)



PokerStars Home Game Hand #225902425111: {Club #4781089}  Hold'em No Limit (50/100) - 2021/04/16 23:35:38 EET [2021/04/16 16:35:38 ET]
Table 'NLHE Session 2' 2-max (Play Money) Seat #2 is the button
Seat 1: FDIBA2009 (11763 in chips) 
Seat 2: s70n3fac3 (13939 in chips) 
s70n3fac3: posts small blind 50
FDIBA2009: posts big blind 100
*** HOLE CARDS ***
s70n3fac3: raises 150 to 250
FDIBA2009: calls 150
*** FLOP *** [9h 3s Qh]
FDIBA2009: checks 
s70n3fac3: checks 
*** TURN *** [9h 3s Qh] [2c]
FDIBA2009: bets 236
s70n3fac3: folds 
Uncalled bet (236) returned to FDIBA2009
FDIBA2009 collected 472 from pot
*** SUMMARY ***
Total pot 500 | Rake 28 
Board [9h 3s Qh 2c]
Seat 1: FDIBA2009 (big blind) collected (472)
Seat 2: s70n3fac3 (button) (small blind) folded on the Turn



PokerStars Home Game Hand #225902438271: {Club #4781089}  Hold'em No Limit (50/100) - 2021/04/16 23:35:58 EET [2021/04/16 16:35:58 ET]
Table 'NLHE Session 2' 2-max (Play Money) Seat #1 is the button
Seat 1: FDIBA2009 (11985 in chips) 
Seat 2: s70n3fac3 (13689 in chips) 
FDIBA2009: posts small blind 50
s70n3fac3: posts big blind 100
*** HOLE CARDS ***
FDIBA2009: raises 100 to 200
s70n3fac3: folds 
Uncalled bet (100) returned to FDIBA2009
FDIBA2009 collected 200 from pot
*** SUMMARY ***
Total pot 200 | Rake 0 
Seat 1: FDIBA2009 (button) (small blind) collected (200)
Seat 2: s70n3fac3 (big blind) folded before Flop



PokerStars Home Game Hand #225902442103: {Club #4781089}  Hold'em No Limit (50/100) - 2021/04/16 23:36:03 EET [2021/04/16 16:36:03 ET]
Table 'NLHE Session 2' 2-max (Play Money) Seat #2 is the button
Seat 1: FDIBA2009 (12085 in chips) 
Seat 2: s70n3fac3 (13589 in chips) 
s70n3fac3: posts small blind 50
FDIBA2009: posts big blind 100
*** HOLE CARDS ***
s70n3fac3: folds 
Uncalled bet (50) returned to FDIBA2009
FDIBA2009 collected 100 from pot
*** SUMMARY ***
Total pot 100 | Rake 0 
Seat 1: FDIBA2009 (big blind) collected (100)
Seat 2: s70n3fac3 (button) (small blind) folded before Flop



PokerStars Home Game Hand #225902444754: {Club #4781089}  Hold'em No Limit (50/100) - 2021/04/16 23:36:07 EET [2021/04/16 16:36:07 ET]
Table 'NLHE Session 2' 2-max (Play Money) Seat #1 is the button
Seat 1: FDIBA2009 (12135 in chips) 
Seat 2: s70n3fac3 (13539 in chips) 
FDIBA2009: posts small blind 50
s70n3fac3: posts big blind 100
*** HOLE CARDS ***
FDIBA2009: raises 100 to 200
s70n3fac3: calls 100
*** FLOP *** [Ts 4s 5s]
s70n3fac3: checks 
FDIBA2009: checks 
*** TURN *** [Ts 4s 5s] [9d]
s70n3fac3: checks 
FDIBA2009: bets 300
s70n3fac3: folds 
Uncalled bet (300) returned to FDIBA2009
FDIBA2009 collected 378 from pot
*** SUMMARY ***
Total pot 400 | Rake 22 
Board [Ts 4s 5s 9d]
Seat 1: FDIBA2009 (button) (small blind) collected (378)
Seat 2: s70n3fac3 (big blind) folded on the Turn



PokerStars Home Game Hand #225902458060: {Club #4781089}  Hold'em No Limit (50/100) - 2021/04/16 23:36:26 EET [2021/04/16 16:36:26 ET]
Table 'NLHE Session 2' 2-max (Play Money) Seat #2 is the button
Seat 1: FDIBA2009 (12313 in chips) 
Seat 2: s70n3fac3 (13339 in chips) 
s70n3fac3: posts small blind 50
FDIBA2009: posts big blind 100
*** HOLE CARDS ***
s70n3fac3: raises 150 to 250
FDIBA2009: calls 150
*** FLOP *** [Jh 4h Js]
FDIBA2009: checks 
s70n3fac3: bets 260
FDIBA2009: folds 
Uncalled bet (260) returned to s70n3fac3
s70n3fac3 collected 472 from pot
s70n3fac3: doesn't show hand 
*** SUMMARY ***
Total pot 500 | Rake 28 
Board [Jh 4h Js]
Seat 1: FDIBA2009 (big blind) folded on the Flop
Seat 2: s70n3fac3 (button) (small blind) collected (472)



PokerStars Home Game Hand #225902474465: {Club #4781089}  Hold'em No Limit (50/100) - 2021/04/16 23:36:51 EET [2021/04/16 16:36:51 ET]
Table 'NLHE Session 2' 2-max (Play Money) Seat #1 is the button
Seat 1: FDIBA2009 (12063 in chips) 
Seat 2: s70n3fac3 (13561 in chips) 
FDIBA2009: posts small blind 50
s70n3fac3: posts big blind 100
*** HOLE CARDS ***
FDIBA2009: raises 100 to 200
s70n3fac3: raises 350 to 550
FDIBA2009: folds 
Uncalled bet (350) returned to s70n3fac3
s70n3fac3 collected 400 from pot
s70n3fac3: doesn't show hand 
*** SUMMARY ***
Total pot 400 | Rake 0 
Seat 1: FDIBA2009 (button) (small blind) folded before Flop
Seat 2: s70n3fac3 (big blind) collected (400)



PokerStars Home Game Hand #225902482219: {Club #4781089}  Hold'em No Limit (50/100) - 2021/04/16 23:37:02 EET [2021/04/16 16:37:02 ET]
Table 'NLHE Session 2' 2-max (Play Money) Seat #2 is the button
Seat 1: FDIBA2009 (11863 in chips) 
Seat 2: s70n3fac3 (13761 in chips) 
s70n3fac3: posts small blind 50
FDIBA2009: posts big blind 100
*** HOLE CARDS ***
s70n3fac3: raises 150 to 250
FDIBA2009: raises 500 to 750
s70n3fac3: calls 500
*** FLOP *** [9d 8h Jh]
FDIBA2009: checks 
s70n3fac3: bets 500
FDIBA2009: folds 
Uncalled bet (500) returned to s70n3fac3
s70n3fac3 collected 1417 from pot
s70n3fac3: doesn't show hand 
*** SUMMARY ***
Total pot 1500 | Rake 83 
Board [9d 8h Jh]
Seat 1: FDIBA2009 (big blind) folded on the Flop
Seat 2: s70n3fac3 (button) (small blind) collected (1417)



PokerStars Home Game Hand #225902500338: {Club #4781089}  Hold'em No Limit (50/100) - 2021/04/16 23:37:29 EET [2021/04/16 16:37:29 ET]
Table 'NLHE Session 2' 2-max (Play Money) Seat #1 is the button
Seat 1: FDIBA2009 (11113 in chips) 
Seat 2: s70n3fac3 (14428 in chips) 
FDIBA2009: posts small blind 50
s70n3fac3: posts big blind 100
*** HOLE CARDS ***
FDIBA2009: raises 200 to 300
s70n3fac3: folds 
Uncalled bet (200) returned to FDIBA2009
FDIBA2009 collected 200 from pot
*** SUMMARY ***
Total pot 200 | Rake 0 
Seat 1: FDIBA2009 (button) (small blind) collected (200)
Seat 2: s70n3fac3 (big blind) folded before Flop



PokerStars Home Game Hand #225902505341: {Club #4781089}  Hold'em No Limit (50/100) - 2021/04/16 23:37:36 EET [2021/04/16 16:37:36 ET]
Table 'NLHE Session 2' 2-max (Play Money) Seat #2 is the button
Seat 1: FDIBA2009 (11213 in chips) 
Seat 2: s70n3fac3 (14328 in chips) 
s70n3fac3: posts small blind 50
FDIBA2009: posts big blind 100
*** HOLE CARDS ***
s70n3fac3: raises 150 to 250
FDIBA2009: raises 500 to 750
s70n3fac3: calls 500
*** FLOP *** [3s 8s Qd]
FDIBA2009: checks 
s70n3fac3: checks 
*** TURN *** [3s 8s Qd] [As]
FDIBA2009: bets 900
s70n3fac3: calls 900
*** RIVER *** [3s 8s Qd As] [6c]
FDIBA2009: checks 
s70n3fac3: bets 785
FDIBA2009: calls 785
*** SHOW DOWN ***
s70n3fac3: shows [9c Ac] (a pair of Aces)
FDIBA2009: mucks hand 
s70n3fac3 collected 4602 from pot
*** SUMMARY ***
Total pot 4870 | Rake 268 
Board [3s 8s Qd As 6c]
Seat 1: FDIBA2009 (big blind) mucked [Th Qh]
Seat 2: s70n3fac3 (button) (small blind) showed [9c Ac] and won (4602) with a pair of Aces



PokerStars Home Game Hand #225902536507: {Club #4781089}  Hold'em No Limit (50/100) - 2021/04/16 23:38:22 EET [2021/04/16 16:38:22 ET]
Table 'NLHE Session 2' 2-max (Play Money) Seat #1 is the button
Seat 1: FDIBA2009 (8778 in chips) 
Seat 2: s70n3fac3 (16495 in chips) 
FDIBA2009: posts small blind 50
s70n3fac3: posts big blind 100
*** HOLE CARDS ***
FDIBA2009: raises 200 to 300
s70n3fac3: folds 
Uncalled bet (200) returned to FDIBA2009
FDIBA2009 collected 200 from pot
*** SUMMARY ***
Total pot 200 | Rake 0 
Seat 1: FDIBA2009 (button) (small blind) collected (200)
Seat 2: s70n3fac3 (big blind) folded before Flop



PokerStars Home Game Hand #225902541891: {Club #4781089}  Hold'em No Limit (50/100) - 2021/04/16 23:38:30 EET [2021/04/16 16:38:30 ET]
Table 'NLHE Session 2' 2-max (Play Money) Seat #2 is the button
Seat 1: FDIBA2009 (8878 in chips) 
Seat 2: s70n3fac3 (16395 in chips) 
s70n3fac3: posts small blind 50
FDIBA2009: posts big blind 100
*** HOLE CARDS ***
s70n3fac3: folds 
Uncalled bet (50) returned to FDIBA2009
FDIBA2009 collected 100 from pot
*** SUMMARY ***
Total pot 100 | Rake 0 
Seat 1: FDIBA2009 (big blind) collected (100)
Seat 2: s70n3fac3 (button) (small blind) folded before Flop



PokerStars Home Game Hand #225902544614: {Club #4781089}  Hold'em No Limit (50/100) - 2021/04/16 23:38:34 EET [2021/04/16 16:38:34 ET]
Table 'NLHE Session 2' 2-max (Play Money) Seat #1 is the button
Seat 1: FDIBA2009 (8928 in chips) 
Seat 2: s70n3fac3 (16345 in chips) 
FDIBA2009: posts small blind 50
s70n3fac3: posts big blind 100
*** HOLE CARDS ***
FDIBA2009: raises 100 to 200
s70n3fac3: calls 100
*** FLOP *** [Jd Ah 6d]
s70n3fac3: checks 
FDIBA2009: checks 
*** TURN *** [Jd Ah 6d] [2d]
s70n3fac3: checks 
FDIBA2009: checks 
*** RIVER *** [Jd Ah 6d 2d] [Tc]
s70n3fac3: bets 200
FDIBA2009: folds 
Uncalled bet (200) returned to s70n3fac3
s70n3fac3 collected 378 from pot
s70n3fac3: doesn't show hand 
*** SUMMARY ***
Total pot 400 | Rake 22 
Board [Jd Ah 6d 2d Tc]
Seat 1: FDIBA2009 (button) (small blind) folded on the River
Seat 2: s70n3fac3 (big blind) collected (378)



PokerStars Home Game Hand #225902556935: {Club #4781089}  Hold'em No Limit (50/100) - 2021/04/16 23:38:52 EET [2021/04/16 16:38:52 ET]
Table 'NLHE Session 2' 2-max (Play Money) Seat #2 is the button
Seat 1: FDIBA2009 (8728 in chips) 
Seat 2: s70n3fac3 (16523 in chips) 
s70n3fac3: posts small blind 50
FDIBA2009: posts big blind 100
*** HOLE CARDS ***
s70n3fac3: raises 150 to 250
FDIBA2009: raises 650 to 900
s70n3fac3: raises 5350 to 6250
FDIBA2009: raises 2478 to 8728 and is all-in
s70n3fac3: calls 2478
*** FLOP *** [8d 4s Kc]
*** TURN *** [8d 4s Kc] [Qc]
*** RIVER *** [8d 4s Kc Qc] [Js]
*** SHOW DOWN ***
FDIBA2009: shows [Ad Jd] (a pair of Jacks)
s70n3fac3: shows [Ah Kd] (a pair of Kings)
s70n3fac3 collected 16496 from pot
*** SUMMARY ***
Total pot 17456 | Rake 960 
Board [8d 4s Kc Qc Js]
Seat 1: FDIBA2009 (big blind) showed [Ad Jd] and lost with a pair of Jacks
Seat 2: s70n3fac3 (button) (small blind) showed [Ah Kd] and won (16496) with a pair of Kings



PokerStars Home Game Hand #225902588642: {Club #4781089}  Hold'em No Limit (50/100) - 2021/04/16 23:39:39 EET [2021/04/16 16:39:39 ET]
Table 'NLHE Session 2' 2-max (Play Money) Seat #1 is the button
Seat 1: FDIBA2009 (10000 in chips) 
Seat 2: s70n3fac3 (24291 in chips) 
FDIBA2009: posts small blind 50
s70n3fac3: posts big blind 100
*** HOLE CARDS ***
FDIBA2009: raises 200 to 300
s70n3fac3: folds 
Uncalled bet (200) returned to FDIBA2009
FDIBA2009 collected 200 from pot
*** SUMMARY ***
Total pot 200 | Rake 0 
Seat 1: FDIBA2009 (button) (small blind) collected (200)
Seat 2: s70n3fac3 (big blind) folded before Flop



PokerStars Home Game Hand #225902594203: {Club #4781089}  Hold'em No Limit (50/100) - 2021/04/16 23:39:47 EET [2021/04/16 16:39:47 ET]
Table 'NLHE Session 2' 2-max (Play Money) Seat #2 is the button
Seat 1: FDIBA2009 (10100 in chips) 
Seat 2: s70n3fac3 (24191 in chips) 
s70n3fac3: posts small blind 50
FDIBA2009: posts big blind 100
*** HOLE CARDS ***
s70n3fac3: raises 150 to 250
FDIBA2009: raises 500 to 750
s70n3fac3: folds 
Uncalled bet (500) returned to FDIBA2009
FDIBA2009 collected 500 from pot
*** SUMMARY ***
Total pot 500 | Rake 0 
Seat 1: FDIBA2009 (big blind) collected (500)
Seat 2: s70n3fac3 (button) (small blind) folded before Flop



PokerStars Home Game Hand #225902601058: {Club #4781089}  Hold'em No Limit (50/100) - 2021/04/16 23:39:57 EET [2021/04/16 16:39:57 ET]
Table 'NLHE Session 2' 2-max (Play Money) Seat #1 is the button
Seat 1: FDIBA2009 (10350 in chips) 
Seat 2: s70n3fac3 (23941 in chips) 
FDIBA2009: posts small blind 50
s70n3fac3: posts big blind 100
*** HOLE CARDS ***
FDIBA2009: raises 200 to 300
s70n3fac3: calls 200
*** FLOP *** [Ts Td 5h]
s70n3fac3: checks 
FDIBA2009: bets 567
s70n3fac3: folds 
Uncalled bet (567) returned to FDIBA2009
FDIBA2009 collected 567 from pot
*** SUMMARY ***
Total pot 600 | Rake 33 
Board [Ts Td 5h]
Seat 1: FDIBA2009 (button) (small blind) collected (567)
Seat 2: s70n3fac3 (big blind) folded on the Flop



PokerStars Home Game Hand #225902621002: {Club #4781089}  Hold'em No Limit (50/100) - 2021/04/16 23:40:14 EET [2021/04/16 16:40:14 ET]
Table 'NLHE Session 2' 2-max (Play Money) Seat #2 is the button
Seat 1: FDIBA2009 (10617 in chips) 
Seat 2: s70n3fac3 (23641 in chips) 
s70n3fac3: posts small blind 50
FDIBA2009: posts big blind 100
*** HOLE CARDS ***
s70n3fac3: raises 130 to 230
FDIBA2009: calls 130
*** FLOP *** [8s Tc Qc]
FDIBA2009: checks 
s70n3fac3: bets 200
FDIBA2009: folds 
Uncalled bet (200) returned to s70n3fac3
s70n3fac3 collected 435 from pot
s70n3fac3: doesn't show hand 
*** SUMMARY ***
Total pot 460 | Rake 25 
Board [8s Tc Qc]
Seat 1: FDIBA2009 (big blind) folded on the Flop
Seat 2: s70n3fac3 (button) (small blind) collected (435)



PokerStars Home Game Hand #225902629715: {Club #4781089}  Hold'em No Limit (50/100) - 2021/04/16 23:40:27 EET [2021/04/16 16:40:27 ET]
Table 'NLHE Session 2' 2-max (Play Money) Seat #1 is the button
Seat 1: FDIBA2009 (10387 in chips) 
Seat 2: s70n3fac3 (23846 in chips) 
FDIBA2009: posts small blind 50
s70n3fac3: posts big blind 100
*** HOLE CARDS ***
FDIBA2009: raises 100 to 200
s70n3fac3: folds 
Uncalled bet (100) returned to FDIBA2009
FDIBA2009 collected 200 from pot
*** SUMMARY ***
Total pot 200 | Rake 0 
Seat 1: FDIBA2009 (button) (small blind) collected (200)
Seat 2: s70n3fac3 (big blind) folded before Flop



PokerStars Home Game Hand #225902633798: {Club #4781089}  Hold'em No Limit (50/100) - 2021/04/16 23:40:33 EET [2021/04/16 16:40:33 ET]
Table 'NLHE Session 2' 2-max (Play Money) Seat #2 is the button
Seat 1: FDIBA2009 (10487 in chips) 
Seat 2: s70n3fac3 (23746 in chips) 
s70n3fac3: posts small blind 50
FDIBA2009: posts big blind 100
*** HOLE CARDS ***
s70n3fac3: folds 
Uncalled bet (50) returned to FDIBA2009
FDIBA2009 collected 100 from pot
*** SUMMARY ***
Total pot 100 | Rake 0 
Seat 1: FDIBA2009 (big blind) collected (100)
Seat 2: s70n3fac3 (button) (small blind) folded before Flop



PokerStars Home Game Hand #225902636611: {Club #4781089}  Hold'em No Limit (50/100) - 2021/04/16 23:40:37 EET [2021/04/16 16:40:37 ET]
Table 'NLHE Session 2' 2-max (Play Money) Seat #1 is the button
Seat 1: FDIBA2009 (10537 in chips) 
Seat 2: s70n3fac3 (23696 in chips) 
FDIBA2009: posts small blind 50
s70n3fac3: posts big blind 100
*** HOLE CARDS ***
FDIBA2009: raises 100 to 200
s70n3fac3: calls 100
*** FLOP *** [Qs 5s 4d]
s70n3fac3: checks 
FDIBA2009: bets 378
s70n3fac3: folds 
Uncalled bet (378) returned to FDIBA2009
FDIBA2009 collected 378 from pot
*** SUMMARY ***
Total pot 400 | Rake 22 
Board [Qs 5s 4d]
Seat 1: FDIBA2009 (button) (small blind) collected (378)
Seat 2: s70n3fac3 (big blind) folded on the Flop



PokerStars Home Game Hand #225902645383: {Club #4781089}  Hold'em No Limit (50/100) - 2021/04/16 23:40:51 EET [2021/04/16 16:40:51 ET]
Table 'NLHE Session 2' 2-max (Play Money) Seat #2 is the button
Seat 1: FDIBA2009 (10715 in chips) 
Seat 2: s70n3fac3 (23496 in chips) 
s70n3fac3: posts small blind 50
FDIBA2009: posts big blind 100
*** HOLE CARDS ***
s70n3fac3: raises 150 to 250
FDIBA2009: calls 150
*** FLOP *** [8s Td 2d]
FDIBA2009: checks 
s70n3fac3: bets 200
FDIBA2009: calls 200
*** TURN *** [8s Td 2d] [5h]
FDIBA2009: checks 
s70n3fac3: bets 300
FDIBA2009: calls 300
*** RIVER *** [8s Td 2d 5h] [8d]
FDIBA2009: bets 1100
s70n3fac3: folds 
Uncalled bet (1100) returned to FDIBA2009
FDIBA2009 collected 1417 from pot
*** SUMMARY ***
Total pot 1500 | Rake 83 
Board [8s Td 2d 5h 8d]
Seat 1: FDIBA2009 (big blind) collected (1417)
Seat 2: s70n3fac3 (button) (small blind) folded on the River



PokerStars Home Game Hand #225902673418: {Club #4781089}  Hold'em No Limit (50/100) - 2021/04/16 23:41:32 EET [2021/04/16 16:41:32 ET]
Table 'NLHE Session 2' 2-max (Play Money) Seat #1 is the button
Seat 1: FDIBA2009 (11382 in chips) 
Seat 2: s70n3fac3 (22746 in chips) 
FDIBA2009: posts small blind 50
s70n3fac3: posts big blind 100
*** HOLE CARDS ***
FDIBA2009: raises 100 to 200
s70n3fac3: raises 400 to 600
FDIBA2009: calls 400
*** FLOP *** [9c Js 2c]
s70n3fac3: checks 
FDIBA2009: bets 900
s70n3fac3: calls 900
*** TURN *** [9c Js 2c] [Qc]
s70n3fac3: checks 
FDIBA2009: bets 1800
s70n3fac3: folds 
Uncalled bet (1800) returned to FDIBA2009
FDIBA2009 collected 2835 from pot
*** SUMMARY ***
Total pot 3000 | Rake 165 
Board [9c Js 2c Qc]
Seat 1: FDIBA2009 (button) (small blind) collected (2835)
Seat 2: s70n3fac3 (big blind) folded on the Turn



PokerStars Home Game Hand #225902703779: {Club #4781089}  Hold'em No Limit (50/100) - 2021/04/16 23:42:18 EET [2021/04/16 16:42:18 ET]
Table 'NLHE Session 2' 2-max (Play Money) Seat #2 is the button
Seat 1: FDIBA2009 (12717 in chips) 
Seat 2: s70n3fac3 (21246 in chips) 
s70n3fac3: posts small blind 50
FDIBA2009: posts big blind 100
*** HOLE CARDS ***
s70n3fac3: raises 200 to 300
FDIBA2009: raises 700 to 1000
s70n3fac3: folds 
Uncalled bet (700) returned to FDIBA2009
FDIBA2009 collected 600 from pot
*** SUMMARY ***
Total pot 600 | Rake 0 
Seat 1: FDIBA2009 (big blind) collected (600)
Seat 2: s70n3fac3 (button) (small blind) folded before Flop



PokerStars Home Game Hand #225902712166: {Club #4781089}  Hold'em No Limit (50/100) - 2021/04/16 23:42:30 EET [2021/04/16 16:42:30 ET]
Table 'NLHE Session 2' 2-max (Play Money) Seat #1 is the button
Seat 1: FDIBA2009 (13017 in chips) 
Seat 2: s70n3fac3 (20946 in chips) 
FDIBA2009: posts small blind 50
s70n3fac3: posts big blind 100
*** HOLE CARDS ***
FDIBA2009: raises 100 to 200
s70n3fac3: folds 
Uncalled bet (100) returned to FDIBA2009
FDIBA2009 collected 200 from pot
*** SUMMARY ***
Total pot 200 | Rake 0 
Seat 1: FDIBA2009 (button) (small blind) collected (200)
Seat 2: s70n3fac3 (big blind) folded before Flop



PokerStars Home Game Hand #225902716600: {Club #4781089}  Hold'em No Limit (50/100) - 2021/04/16 23:42:37 EET [2021/04/16 16:42:37 ET]
Table 'NLHE Session 2' 2-max (Play Money) Seat #2 is the button
Seat 1: FDIBA2009 (13117 in chips) 
Seat 2: s70n3fac3 (20846 in chips) 
s70n3fac3: posts small blind 50
FDIBA2009: posts big blind 100
*** HOLE CARDS ***
s70n3fac3: raises 150 to 250
FDIBA2009: folds 
Uncalled bet (150) returned to s70n3fac3
s70n3fac3 collected 200 from pot
s70n3fac3: doesn't show hand 
*** SUMMARY ***
Total pot 200 | Rake 0 
Seat 1: FDIBA2009 (big blind) folded before Flop
Seat 2: s70n3fac3 (button) (small blind) collected (200)



PokerStars Home Game Hand #225902721499: {Club #4781089}  Hold'em No Limit (50/100) - 2021/04/16 23:42:44 EET [2021/04/16 16:42:44 ET]
Table 'NLHE Session 2' 2-max (Play Money) Seat #1 is the button
Seat 1: FDIBA2009 (13017 in chips) 
Seat 2: s70n3fac3 (20946 in chips) 
FDIBA2009: posts small blind 50
s70n3fac3: posts big blind 100
*** HOLE CARDS ***
FDIBA2009: raises 200 to 300
s70n3fac3: calls 200
*** FLOP *** [4h Jd 8d]
s70n3fac3: checks 
FDIBA2009: bets 400
s70n3fac3: calls 400
*** TURN *** [4h Jd 8d] [9d]
s70n3fac3: checks 
FDIBA2009: bets 900
s70n3fac3: calls 900
*** RIVER *** [4h Jd 8d 9d] [Jh]
s70n3fac3: checks 
FDIBA2009: bets 2100
s70n3fac3: calls 2100
*** SHOW DOWN ***
FDIBA2009: shows [8s 8h] (a full house, Eights full of Jacks)
s70n3fac3: mucks hand 
FDIBA2009 collected 6993 from pot
*** SUMMARY ***
Total pot 7400 | Rake 407 
Board [4h Jd 8d 9d Jh]
Seat 1: FDIBA2009 (button) (small blind) showed [8s 8h] and won (6993) with a full house, Eights full of Jacks
Seat 2: s70n3fac3 (big blind) mucked [Tc Qh]



PokerStars Home Game Hand #225902764570: {Club #4781089}  Hold'em No Limit (50/100) - 2021/04/16 23:43:49 EET [2021/04/16 16:43:49 ET]
Table 'NLHE Session 2' 2-max (Play Money) Seat #2 is the button
Seat 1: FDIBA2009 (16310 in chips) 
Seat 2: s70n3fac3 (17246 in chips) 
s70n3fac3: posts small blind 50
FDIBA2009: posts big blind 100
*** HOLE CARDS ***
s70n3fac3: calls 50
FDIBA2009: checks 
*** FLOP *** [Qd 4c 5d]
FDIBA2009: checks 
s70n3fac3: checks 
*** TURN *** [Qd 4c 5d] [As]
FDIBA2009: checks 
s70n3fac3: checks 
*** RIVER *** [Qd 4c 5d As] [7h]
FDIBA2009: checks 
s70n3fac3: bets 200
FDIBA2009: calls 200
*** SHOW DOWN ***
s70n3fac3: shows [7c 3c] (a pair of Sevens)
FDIBA2009: mucks hand 
s70n3fac3 collected 567 from pot
*** SUMMARY ***
Total pot 600 | Rake 33 
Board [Qd 4c 5d As 7h]
Seat 1: FDIBA2009 (big blind) mucked [6s Kd]
Seat 2: s70n3fac3 (button) (small blind) showed [7c 3c] and won (567) with a pair of Sevens



PokerStars Home Game Hand #225902787251: {Club #4781089}  Hold'em No Limit (50/100) - 2021/04/16 23:44:24 EET [2021/04/16 16:44:24 ET]
Table 'NLHE Session 2' 2-max (Play Money) Seat #1 is the button
Seat 1: FDIBA2009 (16010 in chips) 
Seat 2: s70n3fac3 (17513 in chips) 
FDIBA2009: posts small blind 50
s70n3fac3: posts big blind 100
*** HOLE CARDS ***
FDIBA2009: raises 100 to 200
s70n3fac3: raises 300 to 500
FDIBA2009: folds 
Uncalled bet (300) returned to s70n3fac3
s70n3fac3 collected 400 from pot
s70n3fac3: doesn't show hand 
*** SUMMARY ***
Total pot 400 | Rake 0 
Seat 1: FDIBA2009 (button) (small blind) folded before Flop
Seat 2: s70n3fac3 (big blind) collected (400)



PokerStars Home Game Hand #225902794401: {Club #4781089}  Hold'em No Limit (50/100) - 2021/04/16 23:44:35 EET [2021/04/16 16:44:35 ET]
Table 'NLHE Session 2' 2-max (Play Money) Seat #2 is the button
Seat 1: FDIBA2009 (15810 in chips) 
Seat 2: s70n3fac3 (17713 in chips) 
s70n3fac3: posts small blind 50
FDIBA2009: posts big blind 100
*** HOLE CARDS ***
s70n3fac3: calls 50
FDIBA2009: checks 
*** FLOP *** [Ad 5d Td]
FDIBA2009: checks 
s70n3fac3: bets 200
FDIBA2009: folds 
Uncalled bet (200) returned to s70n3fac3
s70n3fac3 collected 189 from pot
s70n3fac3: doesn't show hand 
*** SUMMARY ***
Total pot 200 | Rake 11 
Board [Ad 5d Td]
Seat 1: FDIBA2009 (big blind) folded on the Flop
Seat 2: s70n3fac3 (button) (small blind) collected (189)



PokerStars Home Game Hand #225902803364: {Club #4781089}  Hold'em No Limit (50/100) - 2021/04/16 23:44:48 EET [2021/04/16 16:44:48 ET]
Table 'NLHE Session 2' 2-max (Play Money) Seat #1 is the button
Seat 1: FDIBA2009 (15710 in chips) 
Seat 2: s70n3fac3 (17802 in chips) 
FDIBA2009: posts small blind 50
s70n3fac3: posts big blind 100
*** HOLE CARDS ***
FDIBA2009: raises 200 to 300
s70n3fac3: folds 
Uncalled bet (200) returned to FDIBA2009
FDIBA2009 collected 200 from pot
*** SUMMARY ***
Total pot 200 | Rake 0 
Seat 1: FDIBA2009 (button) (small blind) collected (200)
Seat 2: s70n3fac3 (big blind) folded before Flop



PokerStars Home Game Hand #225902817221: {Club #4781089}  Hold'em No Limit (50/100) - 2021/04/16 23:45:09 EET [2021/04/16 16:45:09 ET]
Table 'NLHE Session 2' 2-max (Play Money) Seat #2 is the button
Seat 1: FDIBA2009 (15810 in chips) 
Seat 2: s70n3fac3 (17702 in chips) 
s70n3fac3: posts small blind 50
FDIBA2009: posts big blind 100
*** HOLE CARDS ***
s70n3fac3: folds 
Uncalled bet (50) returned to FDIBA2009
FDIBA2009 collected 100 from pot
*** SUMMARY ***
Total pot 100 | Rake 0 
Seat 1: FDIBA2009 (big blind) collected (100)
Seat 2: s70n3fac3 (button) (small blind) folded before Flop



PokerStars Home Game Hand #225902820836: {Club #4781089}  Hold'em No Limit (50/100) - 2021/04/16 23:45:14 EET [2021/04/16 16:45:14 ET]
Table 'NLHE Session 2' 2-max (Play Money) Seat #1 is the button
Seat 1: FDIBA2009 (15860 in chips) 
Seat 2: s70n3fac3 (17652 in chips) 
FDIBA2009: posts small blind 50
s70n3fac3: posts big blind 100
*** HOLE CARDS ***
FDIBA2009: raises 200 to 300
s70n3fac3: folds 
Uncalled bet (200) returned to FDIBA2009
FDIBA2009 collected 200 from pot
*** SUMMARY ***
Total pot 200 | Rake 0 
Seat 1: FDIBA2009 (button) (small blind) collected (200)
Seat 2: s70n3fac3 (big blind) folded before Flop



PokerStars Home Game Hand #225902826870: {Club #4781089}  Hold'em No Limit (50/100) - 2021/04/16 23:45:23 EET [2021/04/16 16:45:23 ET]
Table 'NLHE Session 2' 2-max (Play Money) Seat #2 is the button
Seat 1: FDIBA2009 (15960 in chips) 
Seat 2: s70n3fac3 (17552 in chips) 
s70n3fac3: posts small blind 50
FDIBA2009: posts big blind 100
*** HOLE CARDS ***
s70n3fac3: folds 
Uncalled bet (50) returned to FDIBA2009
FDIBA2009 collected 100 from pot
*** SUMMARY ***
Total pot 100 | Rake 0 
Seat 1: FDIBA2009 (big blind) collected (100)
Seat 2: s70n3fac3 (button) (small blind) folded before Flop



PokerStars Home Game Hand #225902829728: {Club #4781089}  Hold'em No Limit (50/100) - 2021/04/16 23:45:27 EET [2021/04/16 16:45:27 ET]
Table 'NLHE Session 2' 2-max (Play Money) Seat #1 is the button
Seat 1: FDIBA2009 (16010 in chips) 
Seat 2: s70n3fac3 (17502 in chips) 
FDIBA2009: posts small blind 50
s70n3fac3: posts big blind 100
*** HOLE CARDS ***
FDIBA2009: raises 200 to 300
s70n3fac3: folds 
Uncalled bet (200) returned to FDIBA2009
FDIBA2009 collected 200 from pot
*** SUMMARY ***
Total pot 200 | Rake 0 
Seat 1: FDIBA2009 (button) (small blind) collected (200)
Seat 2: s70n3fac3 (big blind) folded before Flop



PokerStars Home Game Hand #225902834333: {Club #4781089}  Hold'em No Limit (50/100) - 2021/04/16 23:45:34 EET [2021/04/16 16:45:34 ET]
Table 'NLHE Session 2' 2-max (Play Money) Seat #2 is the button
Seat 1: FDIBA2009 (16110 in chips) 
Seat 2: s70n3fac3 (17402 in chips) 
s70n3fac3: posts small blind 50
FDIBA2009: posts big blind 100
*** HOLE CARDS ***
s70n3fac3: folds 
Uncalled bet (50) returned to FDIBA2009
FDIBA2009 collected 100 from pot
*** SUMMARY ***
Total pot 100 | Rake 0 
Seat 1: FDIBA2009 (big blind) collected (100)
Seat 2: s70n3fac3 (button) (small blind) folded before Flop



PokerStars Home Game Hand #225902836994: {Club #4781089}  Hold'em No Limit (50/100) - 2021/04/16 23:45:38 EET [2021/04/16 16:45:38 ET]
Table 'NLHE Session 2' 2-max (Play Money) Seat #1 is the button
Seat 1: FDIBA2009 (16160 in chips) 
Seat 2: s70n3fac3 (17352 in chips) 
FDIBA2009: posts small blind 50
s70n3fac3: posts big blind 100
*** HOLE CARDS ***
FDIBA2009: raises 200 to 300
s70n3fac3: folds 
Uncalled bet (200) returned to FDIBA2009
FDIBA2009 collected 200 from pot
*** SUMMARY ***
Total pot 200 | Rake 0 
Seat 1: FDIBA2009 (button) (small blind) collected (200)
Seat 2: s70n3fac3 (big blind) folded before Flop



PokerStars Home Game Hand #225902841998: {Club #4781089}  Hold'em No Limit (50/100) - 2021/04/16 23:45:46 EET [2021/04/16 16:45:46 ET]
Table 'NLHE Session 2' 2-max (Play Money) Seat #2 is the button
Seat 1: FDIBA2009 (16260 in chips) 
Seat 2: s70n3fac3 (17252 in chips) 
s70n3fac3: posts small blind 50
FDIBA2009: posts big blind 100
*** HOLE CARDS ***
s70n3fac3: raises 150 to 250
FDIBA2009: calls 150
*** FLOP *** [3h Th Ks]
FDIBA2009: checks 
s70n3fac3: bets 245
FDIBA2009: calls 245
*** TURN *** [3h Th Ks] [Qd]
FDIBA2009: checks 
s70n3fac3: checks 
*** RIVER *** [3h Th Ks Qd] [9h]
FDIBA2009: bets 500
s70n3fac3: raises 950 to 1450
FDIBA2009: folds 
Uncalled bet (950) returned to s70n3fac3
s70n3fac3 collected 1881 from pot
s70n3fac3: doesn't show hand 
*** SUMMARY ***
Total pot 1990 | Rake 109 
Board [3h Th Ks Qd 9h]
Seat 1: FDIBA2009 (big blind) folded on the River
Seat 2: s70n3fac3 (button) (small blind) collected (1881)



PokerStars Home Game Hand #225902872538: {Club #4781089}  Hold'em No Limit (50/100) - 2021/04/16 23:46:31 EET [2021/04/16 16:46:31 ET]
Table 'NLHE Session 2' 2-max (Play Money) Seat #1 is the button
Seat 1: FDIBA2009 (15265 in chips) 
Seat 2: s70n3fac3 (18138 in chips) 
FDIBA2009: posts small blind 50
s70n3fac3: posts big blind 100
*** HOLE CARDS ***
FDIBA2009: raises 100 to 200
s70n3fac3: raises 200 to 400
FDIBA2009: calls 200
*** FLOP *** [3h 2s Ts]
s70n3fac3: bets 300
FDIBA2009: raises 900 to 1200
s70n3fac3: folds 
Uncalled bet (900) returned to FDIBA2009
FDIBA2009 collected 1323 from pot
*** SUMMARY ***
Total pot 1400 | Rake 77 
Board [3h 2s Ts]
Seat 1: FDIBA2009 (button) (small blind) collected (1323)
Seat 2: s70n3fac3 (big blind) folded on the Flop



PokerStars Home Game Hand #225902890890: {Club #4781089}  Hold'em No Limit (50/100) - 2021/04/16 23:46:58 EET [2021/04/16 16:46:58 ET]
Table 'NLHE Session 2' 2-max (Play Money) Seat #2 is the button
Seat 1: FDIBA2009 (15888 in chips) 
Seat 2: s70n3fac3 (17438 in chips) 
s70n3fac3: posts small blind 50
FDIBA2009: posts big blind 100
*** HOLE CARDS ***
s70n3fac3: raises 100 to 200
FDIBA2009: calls 100
*** FLOP *** [5c Jh 7h]
FDIBA2009: checks 
s70n3fac3: bets 200
FDIBA2009: folds 
Uncalled bet (200) returned to s70n3fac3
s70n3fac3 collected 378 from pot
s70n3fac3: doesn't show hand 
*** SUMMARY ***
Total pot 400 | Rake 22 
Board [5c Jh 7h]
Seat 1: FDIBA2009 (big blind) folded on the Flop
Seat 2: s70n3fac3 (button) (small blind) collected (378)



PokerStars Home Game Hand #225902900115: {Club #4781089}  Hold'em No Limit (50/100) - 2021/04/16 23:47:12 EET [2021/04/16 16:47:12 ET]
Table 'NLHE Session 2' 2-max (Play Money) Seat #1 is the button
Seat 1: FDIBA2009 (15688 in chips) 
Seat 2: s70n3fac3 (17616 in chips) 
FDIBA2009: posts small blind 50
s70n3fac3: posts big blind 100
*** HOLE CARDS ***
FDIBA2009: raises 100 to 200
s70n3fac3: calls 100
*** FLOP *** [Jd 7c Jc]
s70n3fac3: bets 200
FDIBA2009: folds 
Uncalled bet (200) returned to s70n3fac3
s70n3fac3 collected 378 from pot
s70n3fac3: doesn't show hand 
*** SUMMARY ***
Total pot 400 | Rake 22 
Board [Jd 7c Jc]
Seat 1: FDIBA2009 (button) (small blind) folded on the Flop
Seat 2: s70n3fac3 (big blind) collected (378)



PokerStars Home Game Hand #225902908552: {Club #4781089}  Hold'em No Limit (50/100) - 2021/04/16 23:47:24 EET [2021/04/16 16:47:24 ET]
Table 'NLHE Session 2' 2-max (Play Money) Seat #2 is the button
Seat 1: FDIBA2009 (15488 in chips) 
Seat 2: s70n3fac3 (17794 in chips) 
s70n3fac3: posts small blind 50
FDIBA2009: posts big blind 100
*** HOLE CARDS ***
s70n3fac3: folds 
Uncalled bet (50) returned to FDIBA2009
FDIBA2009 collected 100 from pot
*** SUMMARY ***
Total pot 100 | Rake 0 
Seat 1: FDIBA2009 (big blind) collected (100)
Seat 2: s70n3fac3 (button) (small blind) folded before Flop



PokerStars Home Game Hand #225902911287: {Club #4781089}  Hold'em No Limit (50/100) - 2021/04/16 23:47:28 EET [2021/04/16 16:47:28 ET]
Table 'NLHE Session 2' 2-max (Play Money) Seat #1 is the button
Seat 1: FDIBA2009 (15538 in chips) 
Seat 2: s70n3fac3 (17744 in chips) 
FDIBA2009: posts small blind 50
s70n3fac3: posts big blind 100
*** HOLE CARDS ***
FDIBA2009: raises 200 to 300
s70n3fac3: calls 200
*** FLOP *** [Kd 5d 9h]
s70n3fac3: checks 
FDIBA2009: bets 300
s70n3fac3: folds 
Uncalled bet (300) returned to FDIBA2009
FDIBA2009 collected 567 from pot
*** SUMMARY ***
Total pot 600 | Rake 33 
Board [Kd 5d 9h]
Seat 1: FDIBA2009 (button) (small blind) collected (567)
Seat 2: s70n3fac3 (big blind) folded on the Flop



PokerStars Home Game Hand #225902924536: {Club #4781089}  Hold'em No Limit (50/100) - 2021/04/16 23:47:48 EET [2021/04/16 16:47:48 ET]
Table 'NLHE Session 2' 2-max (Play Money) Seat #2 is the button
Seat 1: FDIBA2009 (15805 in chips) 
Seat 2: s70n3fac3 (17444 in chips) 
s70n3fac3: posts small blind 50
FDIBA2009: posts big blind 100
*** HOLE CARDS ***
s70n3fac3: folds 
Uncalled bet (50) returned to FDIBA2009
FDIBA2009 collected 100 from pot
*** SUMMARY ***
Total pot 100 | Rake 0 
Seat 1: FDIBA2009 (big blind) collected (100)
Seat 2: s70n3fac3 (button) (small blind) folded before Flop



PokerStars Home Game Hand #225902927251: {Club #4781089}  Hold'em No Limit (50/100) - 2021/04/16 23:47:52 EET [2021/04/16 16:47:52 ET]
Table 'NLHE Session 2' 2-max (Play Money) Seat #1 is the button
Seat 1: FDIBA2009 (15855 in chips) 
Seat 2: s70n3fac3 (17394 in chips) 
FDIBA2009: posts small blind 50
s70n3fac3: posts big blind 100
*** HOLE CARDS ***
FDIBA2009: raises 100 to 200
s70n3fac3: calls 100
*** FLOP *** [Ac 7h 6c]
s70n3fac3: checks 
FDIBA2009: bets 189
s70n3fac3: folds 
Uncalled bet (189) returned to FDIBA2009
FDIBA2009 collected 378 from pot
*** SUMMARY ***
Total pot 400 | Rake 22 
Board [Ac 7h 6c]
Seat 1: FDIBA2009 (button) (small blind) collected (378)
Seat 2: s70n3fac3 (big blind) folded on the Flop



PokerStars Home Game Hand #225902937070: {Club #4781089}  Hold'em No Limit (50/100) - 2021/04/16 23:48:07 EET [2021/04/16 16:48:07 ET]
Table 'NLHE Session 2' 2-max (Play Money) Seat #2 is the button
Seat 1: FDIBA2009 (16033 in chips) 
Seat 2: s70n3fac3 (17194 in chips) 
s70n3fac3: posts small blind 50
FDIBA2009: posts big blind 100
*** HOLE CARDS ***
s70n3fac3: raises 100 to 200
FDIBA2009: calls 100
*** FLOP *** [2h 2s 4d]
FDIBA2009: checks 
s70n3fac3: bets 200
FDIBA2009: folds 
Uncalled bet (200) returned to s70n3fac3
s70n3fac3 collected 378 from pot
s70n3fac3: doesn't show hand 
*** SUMMARY ***
Total pot 400 | Rake 22 
Board [2h 2s 4d]
Seat 1: FDIBA2009 (big blind) folded on the Flop
Seat 2: s70n3fac3 (button) (small blind) collected (378)



PokerStars Home Game Hand #225902945278: {Club #4781089}  Hold'em No Limit (50/100) - 2021/04/16 23:48:19 EET [2021/04/16 16:48:19 ET]
Table 'NLHE Session 2' 2-max (Play Money) Seat #1 is the button
Seat 1: FDIBA2009 (15833 in chips) 
Seat 2: s70n3fac3 (17372 in chips) 
FDIBA2009: posts small blind 50
s70n3fac3: posts big blind 100
*** HOLE CARDS ***
FDIBA2009: raises 100 to 200
s70n3fac3: calls 100
*** FLOP *** [5c 7d 4c]
s70n3fac3: bets 200
FDIBA2009: folds 
Uncalled bet (200) returned to s70n3fac3
s70n3fac3 collected 378 from pot
s70n3fac3: doesn't show hand 
*** SUMMARY ***
Total pot 400 | Rake 22 
Board [5c 7d 4c]
Seat 1: FDIBA2009 (button) (small blind) folded on the Flop
Seat 2: s70n3fac3 (big blind) collected (378)



PokerStars Home Game Hand #225902953183: {Club #4781089}  Hold'em No Limit (50/100) - 2021/04/16 23:48:30 EET [2021/04/16 16:48:30 ET]
Table 'NLHE Session 2' 2-max (Play Money) Seat #2 is the button
Seat 1: FDIBA2009 (15633 in chips) 
Seat 2: s70n3fac3 (17550 in chips) 
s70n3fac3: posts small blind 50
FDIBA2009: posts big blind 100
*** HOLE CARDS ***
s70n3fac3: raises 150 to 250
FDIBA2009: calls 150
*** FLOP *** [4s 4d As]
FDIBA2009: checks 
s70n3fac3: bets 300
FDIBA2009: folds 
Uncalled bet (300) returned to s70n3fac3
s70n3fac3 collected 472 from pot
s70n3fac3: doesn't show hand 
*** SUMMARY ***
Total pot 500 | Rake 28 
Board [4s 4d As]
Seat 1: FDIBA2009 (big blind) folded on the Flop
Seat 2: s70n3fac3 (button) (small blind) collected (472)



PokerStars Home Game Hand #225902961756: {Club #4781089}  Hold'em No Limit (50/100) - 2021/04/16 23:48:43 EET [2021/04/16 16:48:43 ET]
Table 'NLHE Session 2' 2-max (Play Money) Seat #1 is the button
Seat 1: FDIBA2009 (15383 in chips) 
Seat 2: s70n3fac3 (17772 in chips) 
FDIBA2009: posts small blind 50
s70n3fac3: posts big blind 100
*** HOLE CARDS ***
FDIBA2009: raises 100 to 200
s70n3fac3: calls 100
*** FLOP *** [5s Jh Ac]
s70n3fac3: bets 200
FDIBA2009: calls 200
*** TURN *** [5s Jh Ac] [5d]
s70n3fac3: checks 
FDIBA2009: bets 500
s70n3fac3: folds 
Uncalled bet (500) returned to FDIBA2009
FDIBA2009 collected 756 from pot
*** SUMMARY ***
Total pot 800 | Rake 44 
Board [5s Jh Ac 5d]
Seat 1: FDIBA2009 (button) (small blind) collected (756)
Seat 2: s70n3fac3 (big blind) folded on the Turn



PokerStars Home Game Hand #225902976388: {Club #4781089}  Hold'em No Limit (50/100) - 2021/04/16 23:49:05 EET [2021/04/16 16:49:05 ET]
Table 'NLHE Session 2' 2-max (Play Money) Seat #2 is the button
Seat 1: FDIBA2009 (15739 in chips) 
Seat 2: s70n3fac3 (17372 in chips) 
s70n3fac3: posts small blind 50
FDIBA2009: posts big blind 100
*** HOLE CARDS ***
s70n3fac3: raises 150 to 250
FDIBA2009: folds 
Uncalled bet (150) returned to s70n3fac3
s70n3fac3 collected 200 from pot
s70n3fac3: doesn't show hand 
*** SUMMARY ***
Total pot 200 | Rake 0 
Seat 1: FDIBA2009 (big blind) folded before Flop
Seat 2: s70n3fac3 (button) (small blind) collected (200)



PokerStars Home Game Hand #225902981377: {Club #4781089}  Hold'em No Limit (50/100) - 2021/04/16 23:49:12 EET [2021/04/16 16:49:12 ET]
Table 'NLHE Session 2' 2-max (Play Money) Seat #1 is the button
Seat 1: FDIBA2009 (15639 in chips) 
Seat 2: s70n3fac3 (17472 in chips) 
FDIBA2009: posts small blind 50
s70n3fac3: posts big blind 100
*** HOLE CARDS ***
FDIBA2009: raises 200 to 300
s70n3fac3: folds 
Uncalled bet (200) returned to FDIBA2009
FDIBA2009 collected 200 from pot
*** SUMMARY ***
Total pot 200 | Rake 0 
Seat 1: FDIBA2009 (button) (small blind) collected (200)
Seat 2: s70n3fac3 (big blind) folded before Flop



PokerStars Home Game Hand #225902986093: {Club #4781089}  Hold'em No Limit (50/100) - 2021/04/16 23:49:19 EET [2021/04/16 16:49:19 ET]
Table 'NLHE Session 2' 2-max (Play Money) Seat #2 is the button
Seat 1: FDIBA2009 (15739 in chips) 
Seat 2: s70n3fac3 (17372 in chips) 
s70n3fac3: posts small blind 50
FDIBA2009: posts big blind 100
*** HOLE CARDS ***
s70n3fac3: raises 150 to 250
FDIBA2009: raises 550 to 800
s70n3fac3: calls 550
*** FLOP *** [Ts As Kc]
FDIBA2009: bets 800
s70n3fac3: raises 1150 to 1950
FDIBA2009: raises 5412 to 7362
s70n3fac3: folds 
Uncalled bet (5412) returned to FDIBA2009
FDIBA2009 collected 5197 from pot
*** SUMMARY ***
Total pot 5500 | Rake 303 
Board [Ts As Kc]
Seat 1: FDIBA2009 (big blind) collected (5197)
Seat 2: s70n3fac3 (button) (small blind) folded on the Flop



PokerStars Home Game Hand #225903023487: {Club #4781089}  Hold'em No Limit (50/100) - 2021/04/16 23:50:15 EET [2021/04/16 16:50:15 ET]
Table 'NLHE Session 2' 2-max (Play Money) Seat #1 is the button
Seat 1: FDIBA2009 (18186 in chips) 
Seat 2: s70n3fac3 (14622 in chips) 
FDIBA2009: posts small blind 50
s70n3fac3: posts big blind 100
*** HOLE CARDS ***
FDIBA2009: calls 50
s70n3fac3: checks 
*** FLOP *** [2h Kd 7h]
s70n3fac3: bets 200
FDIBA2009: calls 200
*** TURN *** [2h Kd 7h] [8d]
s70n3fac3: checks 
FDIBA2009: checks 
*** RIVER *** [2h Kd 7h 8d] [As]
s70n3fac3: bets 325
FDIBA2009: calls 325
*** SHOW DOWN ***
s70n3fac3: shows [Ah 4d] (a pair of Aces)
FDIBA2009: mucks hand 
s70n3fac3 collected 1181 from pot
*** SUMMARY ***
Total pot 1250 | Rake 69 
Board [2h Kd 7h 8d As]
Seat 1: FDIBA2009 (button) (small blind) mucked [Kc 3d]
Seat 2: s70n3fac3 (big blind) showed [Ah 4d] and won (1181) with a pair of Aces



PokerStars Home Game Hand #225903043716: {Club #4781089}  Hold'em No Limit (50/100) - 2021/04/16 23:50:45 EET [2021/04/16 16:50:45 ET]
Table 'NLHE Session 2' 2-max (Play Money) Seat #2 is the button
Seat 1: FDIBA2009 (17561 in chips) 
Seat 2: s70n3fac3 (15178 in chips) 
s70n3fac3: posts small blind 50
FDIBA2009: posts big blind 100
*** HOLE CARDS ***
s70n3fac3: raises 100 to 200
FDIBA2009: folds 
Uncalled bet (100) returned to s70n3fac3
s70n3fac3 collected 200 from pot
s70n3fac3: doesn't show hand 
*** SUMMARY ***
Total pot 200 | Rake 0 
Seat 1: FDIBA2009 (big blind) folded before Flop
Seat 2: s70n3fac3 (button) (small blind) collected (200)



PokerStars Home Game Hand #225903047889: {Club #4781089}  Hold'em No Limit (50/100) - 2021/04/16 23:50:51 EET [2021/04/16 16:50:51 ET]
Table 'NLHE Session 2' 2-max (Play Money) Seat #1 is the button
Seat 1: FDIBA2009 (17461 in chips) 
Seat 2: s70n3fac3 (15278 in chips) 
FDIBA2009: posts small blind 50
s70n3fac3: posts big blind 100
*** HOLE CARDS ***
FDIBA2009: folds 
Uncalled bet (50) returned to s70n3fac3
s70n3fac3 collected 100 from pot
s70n3fac3: doesn't show hand 
*** SUMMARY ***
Total pot 100 | Rake 0 
Seat 1: FDIBA2009 (button) (small blind) folded before Flop
Seat 2: s70n3fac3 (big blind) collected (100)



PokerStars Home Game Hand #225903050946: {Club #4781089}  Hold'em No Limit (50/100) - 2021/04/16 23:50:56 EET [2021/04/16 16:50:56 ET]
Table 'NLHE Session 2' 2-max (Play Money) Seat #2 is the button
Seat 1: FDIBA2009 (17411 in chips) 
Seat 2: s70n3fac3 (15328 in chips) 
s70n3fac3: posts small blind 50
FDIBA2009: posts big blind 100
*** HOLE CARDS ***
s70n3fac3: folds 
Uncalled bet (50) returned to FDIBA2009
FDIBA2009 collected 100 from pot
*** SUMMARY ***
Total pot 100 | Rake 0 
Seat 1: FDIBA2009 (big blind) collected (100)
Seat 2: s70n3fac3 (button) (small blind) folded before Flop



PokerStars Home Game Hand #225903053808: {Club #4781089}  Hold'em No Limit (50/100) - 2021/04/16 23:51:00 EET [2021/04/16 16:51:00 ET]
Table 'NLHE Session 2' 2-max (Play Money) Seat #1 is the button
Seat 1: FDIBA2009 (17461 in chips) 
Seat 2: s70n3fac3 (15278 in chips) 
FDIBA2009: posts small blind 50
s70n3fac3: posts big blind 100
*** HOLE CARDS ***
FDIBA2009: raises 100 to 200
s70n3fac3: folds 
Uncalled bet (100) returned to FDIBA2009
FDIBA2009 collected 200 from pot
*** SUMMARY ***
Total pot 200 | Rake 0 
Seat 1: FDIBA2009 (button) (small blind) collected (200)
Seat 2: s70n3fac3 (big blind) folded before Flop



PokerStars Home Game Hand #225903058039: {Club #4781089}  Hold'em No Limit (50/100) - 2021/04/16 23:51:06 EET [2021/04/16 16:51:06 ET]
Table 'NLHE Session 2' 2-max (Play Money) Seat #2 is the button
Seat 1: FDIBA2009 (17561 in chips) 
Seat 2: s70n3fac3 (15178 in chips) 
s70n3fac3: posts small blind 50
FDIBA2009: posts big blind 100
*** HOLE CARDS ***
s70n3fac3: raises 150 to 250
FDIBA2009: folds 
Uncalled bet (150) returned to s70n3fac3
s70n3fac3 collected 200 from pot
s70n3fac3: doesn't show hand 
*** SUMMARY ***
Total pot 200 | Rake 0 
Seat 1: FDIBA2009 (big blind) folded before Flop
Seat 2: s70n3fac3 (button) (small blind) collected (200)



PokerStars Home Game Hand #225903062370: {Club #4781089}  Hold'em No Limit (50/100) - 2021/04/16 23:51:13 EET [2021/04/16 16:51:13 ET]
Table 'NLHE Session 2' 2-max (Play Money) Seat #1 is the button
Seat 1: FDIBA2009 (17461 in chips) 
Seat 2: s70n3fac3 (15278 in chips) 
FDIBA2009: posts small blind 50
s70n3fac3: posts big blind 100
*** HOLE CARDS ***
FDIBA2009: raises 100 to 200
s70n3fac3: folds 
Uncalled bet (100) returned to FDIBA2009
FDIBA2009 collected 200 from pot
*** SUMMARY ***
Total pot 200 | Rake 0 
Seat 1: FDIBA2009 (button) (small blind) collected (200)
Seat 2: s70n3fac3 (big blind) folded before Flop



PokerStars Home Game Hand #225903067577: {Club #4781089}  Hold'em No Limit (50/100) - 2021/04/16 23:51:20 EET [2021/04/16 16:51:20 ET]
Table 'NLHE Session 2' 2-max (Play Money) Seat #2 is the button
Seat 1: FDIBA2009 (17561 in chips) 
Seat 2: s70n3fac3 (15178 in chips) 
s70n3fac3: posts small blind 50
FDIBA2009: posts big blind 100
*** HOLE CARDS ***
s70n3fac3: folds 
Uncalled bet (50) returned to FDIBA2009
FDIBA2009 collected 100 from pot
*** SUMMARY ***
Total pot 100 | Rake 0 
Seat 1: FDIBA2009 (big blind) collected (100)
Seat 2: s70n3fac3 (button) (small blind) folded before Flop



PokerStars Home Game Hand #225903070283: {Club #4781089}  Hold'em No Limit (50/100) - 2021/04/16 23:51:25 EET [2021/04/16 16:51:25 ET]
Table 'NLHE Session 2' 2-max (Play Money) Seat #1 is the button
Seat 1: FDIBA2009 (17611 in chips) 
Seat 2: s70n3fac3 (15128 in chips) 
FDIBA2009: posts small blind 50
s70n3fac3: posts big blind 100
*** HOLE CARDS ***
FDIBA2009: raises 100 to 200
s70n3fac3: calls 100
*** FLOP *** [9c Kd Td]
s70n3fac3: checks 
FDIBA2009: bets 200
s70n3fac3: calls 200
*** TURN *** [9c Kd Td] [2s]
s70n3fac3: checks 
FDIBA2009: bets 500
s70n3fac3: calls 500
*** RIVER *** [9c Kd Td 2s] [4h]
s70n3fac3: checks 
FDIBA2009: checks 
*** SHOW DOWN ***
s70n3fac3: shows [Qh Jd] (a straight, Nine to King)
FDIBA2009: mucks hand 
s70n3fac3 collected 1701 from pot
*** SUMMARY ***
Total pot 1800 | Rake 99 
Board [9c Kd Td 2s 4h]
Seat 1: FDIBA2009 (button) (small blind) mucked [9d 5c]
Seat 2: s70n3fac3 (big blind) showed [Qh Jd] and won (1701) with a straight, Nine to King



PokerStars Home Game Hand #225903095582: {Club #4781089}  Hold'em No Limit (50/100) - 2021/04/16 23:52:02 EET [2021/04/16 16:52:02 ET]
Table 'NLHE Session 2' 2-max (Play Money) Seat #2 is the button
Seat 1: FDIBA2009 (16711 in chips) 
Seat 2: s70n3fac3 (15929 in chips) 
s70n3fac3: posts small blind 50
FDIBA2009: posts big blind 100
*** HOLE CARDS ***
s70n3fac3: raises 150 to 250
FDIBA2009: calls 150
*** FLOP *** [Td 3c 7h]
FDIBA2009: checks 
s70n3fac3: bets 200
FDIBA2009: folds 
Uncalled bet (200) returned to s70n3fac3
s70n3fac3 collected 472 from pot
s70n3fac3: doesn't show hand 
*** SUMMARY ***
Total pot 500 | Rake 28 
Board [Td 3c 7h]
Seat 1: FDIBA2009 (big blind) folded on the Flop
Seat 2: s70n3fac3 (button) (small blind) collected (472)



PokerStars Home Game Hand #225903104136: {Club #4781089}  Hold'em No Limit (50/100) - 2021/04/16 23:52:15 EET [2021/04/16 16:52:15 ET]
Table 'NLHE Session 2' 2-max (Play Money) Seat #1 is the button
Seat 1: FDIBA2009 (16461 in chips) 
Seat 2: s70n3fac3 (16151 in chips) 
FDIBA2009: posts small blind 50
s70n3fac3: posts big blind 100
*** HOLE CARDS ***
FDIBA2009: raises 100 to 200
s70n3fac3: calls 100
*** FLOP *** [9h 4c 4s]
s70n3fac3: bets 200
FDIBA2009: folds 
Uncalled bet (200) returned to s70n3fac3
s70n3fac3 collected 378 from pot
s70n3fac3: doesn't show hand 
*** SUMMARY ***
Total pot 400 | Rake 22 
Board [9h 4c 4s]
Seat 1: FDIBA2009 (button) (small blind) folded on the Flop
Seat 2: s70n3fac3 (big blind) collected (378)



PokerStars Home Game Hand #225903115770: {Club #4781089}  Hold'em No Limit (50/100) - 2021/04/16 23:52:32 EET [2021/04/16 16:52:32 ET]
Table 'NLHE Session 2' 2-max (Play Money) Seat #2 is the button
Seat 1: FDIBA2009 (16261 in chips) 
Seat 2: s70n3fac3 (16329 in chips) 
s70n3fac3: posts small blind 50
FDIBA2009: posts big blind 100
*** HOLE CARDS ***
s70n3fac3: raises 150 to 250
FDIBA2009: raises 500 to 750
s70n3fac3: calls 500
*** FLOP *** [6d 4s 5c]
FDIBA2009: bets 1417
s70n3fac3: calls 1417
*** TURN *** [6d 4s 5c] [Kd]
FDIBA2009: checks 
s70n3fac3: bets 2750
FDIBA2009: calls 2750
*** RIVER *** [6d 4s 5c Kd] [Ks]
FDIBA2009: checks 
s70n3fac3: bets 11412 and is all-in
FDIBA2009: calls 11344 and is all-in
Uncalled bet (68) returned to s70n3fac3
*** SHOW DOWN ***
s70n3fac3: shows [8d Ad] (a pair of Kings)
FDIBA2009: shows [Ts 6c] (two pair, Kings and Sixes)
FDIBA2009 collected 30733 from pot
*** SUMMARY ***
Total pot 32522 | Rake 1789 
Board [6d 4s 5c Kd Ks]
Seat 1: FDIBA2009 (big blind) showed [Ts 6c] and won (30733) with two pair, Kings and Sixes
Seat 2: s70n3fac3 (button) (small blind) showed [8d Ad] and lost with a pair of Kings



PokerStars Home Game Hand #225903184008: {Club #4781089}  Hold'em No Limit (50/100) - 2021/04/16 23:54:14 EET [2021/04/16 16:54:14 ET]
Table 'NLHE Session 2' 2-max (Play Money) Seat #1 is the button
Seat 1: FDIBA2009 (30733 in chips) 
Seat 2: s70n3fac3 (9068 in chips) 
FDIBA2009: posts small blind 50
s70n3fac3: posts big blind 100
*** HOLE CARDS ***
FDIBA2009: raises 100 to 200
s70n3fac3: calls 100
*** FLOP *** [2d Jd 3h]
s70n3fac3: checks 
FDIBA2009: checks 
*** TURN *** [2d Jd 3h] [3d]
s70n3fac3: checks 
FDIBA2009: bets 189
s70n3fac3: folds 
Uncalled bet (189) returned to FDIBA2009
FDIBA2009 collected 378 from pot
*** SUMMARY ***
Total pot 400 | Rake 22 
Board [2d Jd 3h 3d]
Seat 1: FDIBA2009 (button) (small blind) collected (378)
Seat 2: s70n3fac3 (big blind) folded on the Turn



PokerStars Home Game Hand #225903211393: {Club #4781089}  Hold'em No Limit (50/100) - 2021/04/16 23:54:55 EET [2021/04/16 16:54:55 ET]
Table 'NLHE Session 2' 2-max (Play Money) Seat #2 is the button
Seat 1: FDIBA2009 (30911 in chips) 
Seat 2: s70n3fac3 (9868 in chips) 
s70n3fac3: posts small blind 50
s70n3fac3 said, "dobavih 10"
FDIBA2009: posts big blind 100
*** HOLE CARDS ***
s70n3fac3: calls 50
FDIBA2009 said, "Ok"
FDIBA2009: checks 
*** FLOP *** [7d 6c Js]
FDIBA2009: checks 
s70n3fac3: checks 
*** TURN *** [7d 6c Js] [4s]
FDIBA2009: checks 
s70n3fac3: checks 
*** RIVER *** [7d 6c Js 4s] [Ad]
FDIBA2009: bets 189
s70n3fac3: folds 
Uncalled bet (189) returned to FDIBA2009
FDIBA2009 collected 189 from pot
*** SUMMARY ***
Total pot 200 | Rake 11 
Board [7d 6c Js 4s Ad]
Seat 1: FDIBA2009 (big blind) collected (189)
Seat 2: s70n3fac3 (button) (small blind) folded on the River



PokerStars Home Game Hand #225903231147: {Club #4781089}  Hold'em No Limit (50/100) - 2021/04/16 23:55:34 EET [2021/04/16 16:55:34 ET]
Table 'NLHE Session 2' 2-max (Play Money) Seat #1 is the button
Seat 1: FDIBA2009 (31000 in chips) 
Seat 2: s70n3fac3 (9768 in chips) 
FDIBA2009: posts small blind 50
s70n3fac3: posts big blind 100
*** HOLE CARDS ***
FDIBA2009: raises 100 to 200
s70n3fac3: calls 100
*** FLOP *** [3h Ah 6s]
s70n3fac3: checks 
FDIBA2009: bets 189
s70n3fac3: folds 
Uncalled bet (189) returned to FDIBA2009
FDIBA2009 collected 378 from pot
*** SUMMARY ***
Total pot 400 | Rake 22 
Board [3h Ah 6s]
Seat 1: FDIBA2009 (button) (small blind) collected (378)
Seat 2: s70n3fac3 (big blind) folded on the Flop



PokerStars Home Game Hand #225903244950: {Club #4781089}  Hold'em No Limit (50/100) - 2021/04/16 23:56:04 EET [2021/04/16 16:56:04 ET]
Table 'NLHE Session 2' 2-max (Play Money) Seat #2 is the button
Seat 1: FDIBA2009 (31178 in chips) 
Seat 2: s70n3fac3 (9568 in chips) 
s70n3fac3: posts small blind 50
FDIBA2009: posts big blind 100
*** HOLE CARDS ***
s70n3fac3: folds 
Uncalled bet (50) returned to FDIBA2009
FDIBA2009 collected 100 from pot
*** SUMMARY ***
Total pot 100 | Rake 0 
Seat 1: FDIBA2009 (big blind) collected (100)
Seat 2: s70n3fac3 (button) (small blind) folded before Flop



PokerStars Home Game Hand #225903246839: {Club #4781089}  Hold'em No Limit (50/100) - 2021/04/16 23:56:08 EET [2021/04/16 16:56:08 ET]
Table 'NLHE Session 2' 2-max (Play Money) Seat #1 is the button
Seat 1: FDIBA2009 (31228 in chips) 
Seat 2: s70n3fac3 (9518 in chips) 
FDIBA2009: posts small blind 50
s70n3fac3: posts big blind 100
*** HOLE CARDS ***
FDIBA2009: raises 100 to 200
s70n3fac3: calls 100
*** FLOP *** [4d 2s 3h]
s70n3fac3: checks 
FDIBA2009: bets 378
s70n3fac3: calls 378
*** TURN *** [4d 2s 3h] [Qd]
s70n3fac3: checks 
FDIBA2009: checks 
*** RIVER *** [4d 2s 3h Qd] [5c]
s70n3fac3: checks 
FDIBA2009: bets 1092
s70n3fac3: folds 
Uncalled bet (1092) returned to FDIBA2009
FDIBA2009 collected 1092 from pot
*** SUMMARY ***
Total pot 1156 | Rake 64 
Board [4d 2s 3h Qd 5c]
Seat 1: FDIBA2009 (button) (small blind) collected (1092)
Seat 2: s70n3fac3 (big blind) folded on the River



PokerStars Home Game Hand #225903260573: {Club #4781089}  Hold'em No Limit (50/100) - 2021/04/16 23:56:37 EET [2021/04/16 16:56:37 ET]
Table 'NLHE Session 2' 2-max (Play Money) Seat #2 is the button
Seat 1: FDIBA2009 (31742 in chips) 
Seat 2: s70n3fac3 (8940 in chips) 
s70n3fac3: posts small blind 50
FDIBA2009: posts big blind 100
*** HOLE CARDS ***
s70n3fac3: calls 50
FDIBA2009: checks 
*** FLOP *** [4d 5c 7c]
FDIBA2009: bets 189
s70n3fac3: calls 189
*** TURN *** [4d 5c 7c] [Jh]
FDIBA2009: bets 546
s70n3fac3: folds 
Uncalled bet (546) returned to FDIBA2009
FDIBA2009 collected 546 from pot
*** SUMMARY ***
Total pot 578 | Rake 32 
Board [4d 5c 7c Jh]
Seat 1: FDIBA2009 (big blind) collected (546)
Seat 2: s70n3fac3 (button) (small blind) folded on the Turn



PokerStars Home Game Hand #225903270292: {Club #4781089}  Hold'em No Limit (50/100) - 2021/04/16 23:56:57 EET [2021/04/16 16:56:57 ET]
Table 'NLHE Session 2' 2-max (Play Money) Seat #1 is the button
Seat 1: FDIBA2009 (31999 in chips) 
Seat 2: s70n3fac3 (8651 in chips) 
FDIBA2009: posts small blind 50
s70n3fac3: posts big blind 100
*** HOLE CARDS ***
FDIBA2009: raises 100 to 200
s70n3fac3: folds 
Uncalled bet (100) returned to FDIBA2009
FDIBA2009 collected 200 from pot
*** SUMMARY ***
Total pot 200 | Rake 0 
Seat 1: FDIBA2009 (button) (small blind) collected (200)
Seat 2: s70n3fac3 (big blind) folded before Flop



PokerStars Home Game Hand #225903272981: {Club #4781089}  Hold'em No Limit (50/100) - 2021/04/16 23:57:03 EET [2021/04/16 16:57:03 ET]
Table 'NLHE Session 2' 2-max (Play Money) Seat #2 is the button
Seat 1: FDIBA2009 (32099 in chips) 
Seat 2: s70n3fac3 (8551 in chips) 
s70n3fac3: posts small blind 50
FDIBA2009: posts big blind 100
*** HOLE CARDS ***
s70n3fac3: raises 150 to 250
FDIBA2009: calls 150
*** FLOP *** [Jd 5c 5d]
FDIBA2009: checks 
s70n3fac3: bets 240
FDIBA2009: folds 
Uncalled bet (240) returned to s70n3fac3
s70n3fac3 collected 472 from pot
s70n3fac3: doesn't show hand 
*** SUMMARY ***
Total pot 500 | Rake 28 
Board [Jd 5c 5d]
Seat 1: FDIBA2009 (big blind) folded on the Flop
Seat 2: s70n3fac3 (button) (small blind) collected (472)



PokerStars Home Game Hand #225903279219: {Club #4781089}  Hold'em No Limit (50/100) - 2021/04/16 23:57:16 EET [2021/04/16 16:57:16 ET]
Table 'NLHE Session 2' 2-max (Play Money) Seat #1 is the button
Seat 1: FDIBA2009 (31849 in chips) 
Seat 2: s70n3fac3 (8773 in chips) 
FDIBA2009: posts small blind 50
s70n3fac3: posts big blind 100
*** HOLE CARDS ***
FDIBA2009: raises 100 to 200
s70n3fac3: calls 100
*** FLOP *** [Jh 8d 5h]
s70n3fac3: checks 
FDIBA2009: bets 189
s70n3fac3: folds 
Uncalled bet (189) returned to FDIBA2009
FDIBA2009 collected 378 from pot
*** SUMMARY ***
Total pot 400 | Rake 22 
Board [Jh 8d 5h]
Seat 1: FDIBA2009 (button) (small blind) collected (378)
Seat 2: s70n3fac3 (big blind) folded on the Flop



PokerStars Home Game Hand #225903284487: {Club #4781089}  Hold'em No Limit (50/100) - 2021/04/16 23:57:27 EET [2021/04/16 16:57:27 ET]
Table 'NLHE Session 2' 2-max (Play Money) Seat #2 is the button
Seat 1: FDIBA2009 (32027 in chips) 
Seat 2: s70n3fac3 (8573 in chips) 
s70n3fac3: posts small blind 50
FDIBA2009: posts big blind 100
*** HOLE CARDS ***
s70n3fac3: raises 150 to 250
FDIBA2009: raises 500 to 750
s70n3fac3: calls 500
*** FLOP *** [8d Js 2h]
FDIBA2009: bets 900
s70n3fac3: raises 6923 to 7823 and is all-in
FDIBA2009: folds 
Uncalled bet (6923) returned to s70n3fac3
s70n3fac3 collected 3118 from pot
s70n3fac3: doesn't show hand 
*** SUMMARY ***
Total pot 3300 | Rake 182 
Board [8d Js 2h]
Seat 1: FDIBA2009 (big blind) folded on the Flop
Seat 2: s70n3fac3 (button) (small blind) collected (3118)



PokerStars Home Game Hand #225903294097: {Club #4781089}  Hold'em No Limit (50/100) - 2021/04/16 23:57:48 EET [2021/04/16 16:57:48 ET]
Table 'NLHE Session 2' 2-max (Play Money) Seat #1 is the button
Seat 1: FDIBA2009 (30377 in chips) 
Seat 2: s70n3fac3 (10041 in chips) 
FDIBA2009: posts small blind 50
s70n3fac3: posts big blind 100
*** HOLE CARDS ***
FDIBA2009: raises 100 to 200
s70n3fac3: raises 400 to 600
FDIBA2009: folds 
Uncalled bet (400) returned to s70n3fac3
s70n3fac3 collected 400 from pot
s70n3fac3: doesn't show hand 
*** SUMMARY ***
Total pot 400 | Rake 0 
Seat 1: FDIBA2009 (button) (small blind) folded before Flop
Seat 2: s70n3fac3 (big blind) collected (400)



PokerStars Home Game Hand #225903298463: {Club #4781089}  Hold'em No Limit (50/100) - 2021/04/16 23:57:57 EET [2021/04/16 16:57:57 ET]
Table 'NLHE Session 2' 2-max (Play Money) Seat #2 is the button
Seat 1: FDIBA2009 (30177 in chips) 
Seat 2: s70n3fac3 (10241 in chips) 
s70n3fac3: posts small blind 50
FDIBA2009: posts big blind 100
*** HOLE CARDS ***
s70n3fac3: raises 150 to 250
FDIBA2009: calls 150
*** FLOP *** [Tc 9s 5s]
FDIBA2009: checks 
s70n3fac3: bets 300
FDIBA2009: folds 
Uncalled bet (300) returned to s70n3fac3
s70n3fac3 collected 472 from pot
s70n3fac3: doesn't show hand 
*** SUMMARY ***
Total pot 500 | Rake 28 
Board [Tc 9s 5s]
Seat 1: FDIBA2009 (big blind) folded on the Flop
Seat 2: s70n3fac3 (button) (small blind) collected (472)



PokerStars Home Game Hand #225903304184: {Club #4781089}  Hold'em No Limit (50/100) - 2021/04/16 23:58:09 EET [2021/04/16 16:58:09 ET]
Table 'NLHE Session 2' 2-max (Play Money) Seat #1 is the button
Seat 1: FDIBA2009 (29927 in chips) 
Seat 2: s70n3fac3 (10463 in chips) 
FDIBA2009: posts small blind 50
s70n3fac3: posts big blind 100
*** HOLE CARDS ***
FDIBA2009: raises 100 to 200
s70n3fac3: calls 100
*** FLOP *** [Tc Ts 3d]
s70n3fac3: checks 
FDIBA2009: checks 
*** TURN *** [Tc Ts 3d] [5c]
s70n3fac3: checks 
FDIBA2009: bets 378
s70n3fac3: calls 378
*** RIVER *** [Tc Ts 3d 5c] [9h]
s70n3fac3: checks 
FDIBA2009: bets 700
s70n3fac3: folds 
Uncalled bet (700) returned to FDIBA2009
FDIBA2009 collected 1092 from pot
*** SUMMARY ***
Total pot 1156 | Rake 64 
Board [Tc Ts 3d 5c 9h]
Seat 1: FDIBA2009 (button) (small blind) collected (1092)
Seat 2: s70n3fac3 (big blind) folded on the River



PokerStars Home Game Hand #225903315239: {Club #4781089}  Hold'em No Limit (50/100) - 2021/04/16 23:58:33 EET [2021/04/16 16:58:33 ET]
Table 'NLHE Session 2' 2-max (Play Money) Seat #2 is the button
Seat 1: FDIBA2009 (30441 in chips) 
Seat 2: s70n3fac3 (9885 in chips) 
s70n3fac3: posts small blind 50
FDIBA2009: posts big blind 100
*** HOLE CARDS ***
s70n3fac3: raises 150 to 250
FDIBA2009: folds 
Uncalled bet (150) returned to s70n3fac3
s70n3fac3 collected 200 from pot
s70n3fac3: doesn't show hand 
*** SUMMARY ***
Total pot 200 | Rake 0 
Seat 1: FDIBA2009 (big blind) folded before Flop
Seat 2: s70n3fac3 (button) (small blind) collected (200)



PokerStars Home Game Hand #225903319522: {Club #4781089}  Hold'em No Limit (50/100) - 2021/04/16 23:58:42 EET [2021/04/16 16:58:42 ET]
Table 'NLHE Session 2' 2-max (Play Money) Seat #1 is the button
Seat 1: FDIBA2009 (30341 in chips) 
Seat 2: s70n3fac3 (9985 in chips) 
FDIBA2009: posts small blind 50
s70n3fac3: posts big blind 100
*** HOLE CARDS ***
FDIBA2009: raises 100 to 200
s70n3fac3: folds 
Uncalled bet (100) returned to FDIBA2009
FDIBA2009 collected 200 from pot
*** SUMMARY ***
Total pot 200 | Rake 0 
Seat 1: FDIBA2009 (button) (small blind) collected (200)
Seat 2: s70n3fac3 (big blind) folded before Flop



PokerStars Home Game Hand #225903323940: {Club #4781089}  Hold'em No Limit (50/100) - 2021/04/16 23:58:51 EET [2021/04/16 16:58:51 ET]
Table 'NLHE Session 2' 2-max (Play Money) Seat #2 is the button
Seat 1: FDIBA2009 (30441 in chips) 
Seat 2: s70n3fac3 (9885 in chips) 
s70n3fac3: posts small blind 50
FDIBA2009: posts big blind 100
*** HOLE CARDS ***
s70n3fac3: raises 100 to 200
FDIBA2009: raises 400 to 600
s70n3fac3: calls 400
*** FLOP *** [3d 8s Ac]
FDIBA2009: checks 
s70n3fac3: checks 
*** TURN *** [3d 8s Ac] [2s]
FDIBA2009: checks 
s70n3fac3: checks 
*** RIVER *** [3d 8s Ac 2s] [9s]
FDIBA2009: bets 800
s70n3fac3: raises 1300 to 2100
FDIBA2009: folds 
Uncalled bet (1300) returned to s70n3fac3
s70n3fac3 collected 2646 from pot
s70n3fac3: doesn't show hand 
*** SUMMARY ***
Total pot 2800 | Rake 154 
Board [3d 8s Ac 2s 9s]
Seat 1: FDIBA2009 (big blind) folded on the River
Seat 2: s70n3fac3 (button) (small blind) collected (2646)



PokerStars Home Game Hand #225903343531: {Club #4781089}  Hold'em No Limit (50/100) - 2021/04/16 23:59:33 EET [2021/04/16 16:59:33 ET]
Table 'NLHE Session 2' 2-max (Play Money) Seat #1 is the button
Seat 1: FDIBA2009 (29041 in chips) 
Seat 2: s70n3fac3 (11131 in chips) 
FDIBA2009: posts small blind 50
s70n3fac3: posts big blind 100
*** HOLE CARDS ***
FDIBA2009: raises 100 to 200
s70n3fac3: folds 
Uncalled bet (100) returned to FDIBA2009
FDIBA2009 collected 200 from pot
*** SUMMARY ***
Total pot 200 | Rake 0 
Seat 1: FDIBA2009 (button) (small blind) collected (200)
Seat 2: s70n3fac3 (big blind) folded before Flop



PokerStars Home Game Hand #225903347238: {Club #4781089}  Hold'em No Limit (50/100) - 2021/04/16 23:59:40 EET [2021/04/16 16:59:40 ET]
Table 'NLHE Session 2' 2-max (Play Money) Seat #2 is the button
Seat 1: FDIBA2009 (29141 in chips) 
Seat 2: s70n3fac3 (11031 in chips) 
s70n3fac3: posts small blind 50
FDIBA2009: posts big blind 100
*** HOLE CARDS ***
s70n3fac3: raises 100 to 200
FDIBA2009: calls 100
*** FLOP *** [Kc 6h Kh]
FDIBA2009: checks 
s70n3fac3: bets 200
FDIBA2009: calls 200
*** TURN *** [Kc 6h Kh] [4d]
FDIBA2009: checks 
s70n3fac3: bets 400
FDIBA2009: folds 
Uncalled bet (400) returned to s70n3fac3
s70n3fac3 collected 756 from pot
s70n3fac3: doesn't show hand 
*** SUMMARY ***
Total pot 800 | Rake 44 
Board [Kc 6h Kh 4d]
Seat 1: FDIBA2009 (big blind) folded on the Turn
Seat 2: s70n3fac3 (button) (small blind) collected (756)



PokerStars Home Game Hand #225903360146: {Club #4781089}  Hold'em No Limit (50/100) - 2021/04/17 0:00:07 EET [2021/04/16 17:00:07 ET]
Table 'NLHE Session 2' 2-max (Play Money) Seat #1 is the button
Seat 1: FDIBA2009 (28741 in chips) 
Seat 2: s70n3fac3 (11387 in chips) 
FDIBA2009: posts small blind 50
s70n3fac3: posts big blind 100
*** HOLE CARDS ***
FDIBA2009: raises 200 to 300
s70n3fac3: calls 200
*** FLOP *** [6d 7d 4h]
s70n3fac3: checks 
FDIBA2009: bets 567
s70n3fac3: raises 567 to 1134
FDIBA2009: raises 2835 to 3969
s70n3fac3: calls 2835
*** TURN *** [6d 7d 4h] [Qd]
s70n3fac3: bets 7118 and is all-in
FDIBA2009 has timed out
FDIBA2009: folds 
Uncalled bet (7118) returned to s70n3fac3
s70n3fac3 collected 8068 from pot
s70n3fac3: doesn't show hand 
*** SUMMARY ***
Total pot 8538 | Rake 470 
Board [6d 7d 4h Qd]
Seat 1: FDIBA2009 (button) (small blind) folded on the Turn
Seat 2: s70n3fac3 (big blind) collected (8068)



PokerStars Home Game Hand #225903389258: {Club #4781089}  Hold'em No Limit (50/100) - 2021/04/17 0:01:02 EET [2021/04/16 17:01:02 ET]
Table 'NLHE Session 2' 2-max (Play Money) Seat #2 is the button
Seat 1: FDIBA2009 (24472 in chips) 
Seat 2: s70n3fac3 (15186 in chips) 
s70n3fac3: posts small blind 50
FDIBA2009: posts big blind 100
*** HOLE CARDS ***
s70n3fac3: calls 50
FDIBA2009: checks 
*** FLOP *** [Qs Td 6h]
FDIBA2009: checks 
s70n3fac3: bets 200
FDIBA2009: calls 200
*** TURN *** [Qs Td 6h] [2c]
FDIBA2009: checks 
s70n3fac3: bets 300
FDIBA2009: calls 300
*** RIVER *** [Qs Td 6h 2c] [8d]
FDIBA2009: checks 
s70n3fac3: bets 600
FDIBA2009: folds 
Uncalled bet (600) returned to s70n3fac3
s70n3fac3 collected 1134 from pot
s70n3fac3: doesn't show hand 
*** SUMMARY ***
Total pot 1200 | Rake 66 
Board [Qs Td 6h 2c 8d]
Seat 1: FDIBA2009 (big blind) folded on the River
Seat 2: s70n3fac3 (button) (small blind) collected (1134)



PokerStars Home Game Hand #225903411549: {Club #4781089}  Hold'em No Limit (50/100) - 2021/04/17 0:01:38 EET [2021/04/16 17:01:38 ET]
Table 'NLHE Session 2' 2-max (Play Money) Seat #1 is the button
Seat 1: FDIBA2009 (23872 in chips) 
Seat 2: s70n3fac3 (15720 in chips) 
FDIBA2009: posts small blind 50
s70n3fac3: posts big blind 100
*** HOLE CARDS ***
FDIBA2009: raises 200 to 300
s70n3fac3: folds 
Uncalled bet (200) returned to FDIBA2009
FDIBA2009 collected 200 from pot
*** SUMMARY ***
Total pot 200 | Rake 0 
Seat 1: FDIBA2009 (button) (small blind) collected (200)
Seat 2: s70n3fac3 (big blind) folded before Flop



PokerStars Home Game Hand #225903416263: {Club #4781089}  Hold'em No Limit (50/100) - 2021/04/17 0:01:46 EET [2021/04/16 17:01:46 ET]
Table 'NLHE Session 2' 2-max (Play Money) Seat #2 is the button
Seat 1: FDIBA2009 (23972 in chips) 
Seat 2: s70n3fac3 (15620 in chips) 
s70n3fac3: posts small blind 50
FDIBA2009: posts big blind 100
*** HOLE CARDS ***
s70n3fac3: folds 
Uncalled bet (50) returned to FDIBA2009
FDIBA2009 collected 100 from pot
*** SUMMARY ***
Total pot 100 | Rake 0 
Seat 1: FDIBA2009 (big blind) collected (100)
Seat 2: s70n3fac3 (button) (small blind) folded before Flop



PokerStars Home Game Hand #225903418810: {Club #4781089}  Hold'em No Limit (50/100) - 2021/04/17 0:01:50 EET [2021/04/16 17:01:50 ET]
Table 'NLHE Session 2' 2-max (Play Money) Seat #1 is the button
Seat 1: FDIBA2009 (24022 in chips) 
Seat 2: s70n3fac3 (15570 in chips) 
FDIBA2009: posts small blind 50
s70n3fac3: posts big blind 100
*** HOLE CARDS ***
FDIBA2009: raises 100 to 200
s70n3fac3: folds 
Uncalled bet (100) returned to FDIBA2009
FDIBA2009 collected 200 from pot
*** SUMMARY ***
Total pot 200 | Rake 0 
Seat 1: FDIBA2009 (button) (small blind) collected (200)
Seat 2: s70n3fac3 (big blind) folded before Flop



PokerStars Home Game Hand #225903422810: {Club #4781089}  Hold'em No Limit (50/100) - 2021/04/17 0:01:56 EET [2021/04/16 17:01:56 ET]
Table 'NLHE Session 2' 2-max (Play Money) Seat #2 is the button
Seat 1: FDIBA2009 (24122 in chips) 
Seat 2: s70n3fac3 (15470 in chips) 
s70n3fac3: posts small blind 50
FDIBA2009: posts big blind 100
*** HOLE CARDS ***
s70n3fac3: folds 
Uncalled bet (50) returned to FDIBA2009
FDIBA2009 collected 100 from pot
*** SUMMARY ***
Total pot 100 | Rake 0 
Seat 1: FDIBA2009 (big blind) collected (100)
Seat 2: s70n3fac3 (button) (small blind) folded before Flop



PokerStars Home Game Hand #225903425519: {Club #4781089}  Hold'em No Limit (50/100) - 2021/04/17 0:02:00 EET [2021/04/16 17:02:00 ET]
Table 'NLHE Session 2' 2-max (Play Money) Seat #1 is the button
Seat 1: FDIBA2009 (24172 in chips) 
Seat 2: s70n3fac3 (15420 in chips) 
FDIBA2009: posts small blind 50
s70n3fac3: posts big blind 100
*** HOLE CARDS ***
FDIBA2009: raises 100 to 200
s70n3fac3: calls 100
*** FLOP *** [Ad 8s Qs]
s70n3fac3: checks 
FDIBA2009: checks 
*** TURN *** [Ad 8s Qs] [6c]
s70n3fac3: checks 
FDIBA2009: checks 
*** RIVER *** [Ad 8s Qs 6c] [2d]
s70n3fac3: checks 
FDIBA2009: bets 189
s70n3fac3: folds 
Uncalled bet (189) returned to FDIBA2009
FDIBA2009 collected 378 from pot
*** SUMMARY ***
Total pot 400 | Rake 22 
Board [Ad 8s Qs 6c 2d]
Seat 1: FDIBA2009 (button) (small blind) collected (378)
Seat 2: s70n3fac3 (big blind) folded on the River



PokerStars Home Game Hand #225903439068: {Club #4781089}  Hold'em No Limit (50/100) - 2021/04/17 0:02:20 EET [2021/04/16 17:02:20 ET]
Table 'NLHE Session 2' 2-max (Play Money) Seat #2 is the button
Seat 1: FDIBA2009 (24350 in chips) 
Seat 2: s70n3fac3 (15220 in chips) 
s70n3fac3: posts small blind 50
FDIBA2009: posts big blind 100
*** HOLE CARDS ***
s70n3fac3: folds 
Uncalled bet (50) returned to FDIBA2009
FDIBA2009 collected 100 from pot
*** SUMMARY ***
Total pot 100 | Rake 0 
Seat 1: FDIBA2009 (big blind) collected (100)
Seat 2: s70n3fac3 (button) (small blind) folded before Flop



PokerStars Home Game Hand #225903441739: {Club #4781089}  Hold'em No Limit (50/100) - 2021/04/17 0:02:24 EET [2021/04/16 17:02:24 ET]
Table 'NLHE Session 2' 2-max (Play Money) Seat #1 is the button
Seat 1: FDIBA2009 (24400 in chips) 
Seat 2: s70n3fac3 (15170 in chips) 
FDIBA2009: posts small blind 50
s70n3fac3: posts big blind 100
*** HOLE CARDS ***
FDIBA2009: raises 100 to 200
s70n3fac3: folds 
Uncalled bet (100) returned to FDIBA2009
FDIBA2009 collected 200 from pot
*** SUMMARY ***
Total pot 200 | Rake 0 
Seat 1: FDIBA2009 (button) (small blind) collected (200)
Seat 2: s70n3fac3 (big blind) folded before Flop



PokerStars Home Game Hand #225903446108: {Club #4781089}  Hold'em No Limit (50/100) - 2021/04/17 0:02:31 EET [2021/04/16 17:02:31 ET]
Table 'NLHE Session 2' 2-max (Play Money) Seat #2 is the button
Seat 1: FDIBA2009 (24500 in chips) 
Seat 2: s70n3fac3 (15070 in chips) 
s70n3fac3: posts small blind 50
FDIBA2009: posts big blind 100
*** HOLE CARDS ***
s70n3fac3: raises 100 to 200
FDIBA2009: calls 100
*** FLOP *** [5s 7s 4c]
FDIBA2009: checks 
s70n3fac3: bets 200
FDIBA2009: calls 200
*** TURN *** [5s 7s 4c] [Jc]
FDIBA2009: checks 
s70n3fac3: bets 400
FDIBA2009: calls 400
*** RIVER *** [5s 7s 4c Jc] [Qd]
FDIBA2009: checks 
s70n3fac3: checks 
*** SHOW DOWN ***
FDIBA2009: shows [Js 8c] (a pair of Jacks)
s70n3fac3: mucks hand 
FDIBA2009 collected 1512 from pot
*** SUMMARY ***
Total pot 1600 | Rake 88 
Board [5s 7s 4c Jc Qd]
Seat 1: FDIBA2009 (big blind) showed [Js 8c] and won (1512) with a pair of Jacks
Seat 2: s70n3fac3 (button) (small blind) mucked [7h 6c]



PokerStars Home Game Hand #225903463978: {Club #4781089}  Hold'em No Limit (50/100) - 2021/04/17 0:02:58 EET [2021/04/16 17:02:58 ET]
Table 'NLHE Session 2' 2-max (Play Money) Seat #1 is the button
Seat 1: FDIBA2009 (25212 in chips) 
Seat 2: s70n3fac3 (14270 in chips) 
FDIBA2009: posts small blind 50
s70n3fac3: posts big blind 100
*** HOLE CARDS ***
FDIBA2009: raises 100 to 200
s70n3fac3: folds 
Uncalled bet (100) returned to FDIBA2009
FDIBA2009 collected 200 from pot
*** SUMMARY ***
Total pot 200 | Rake 0 
Seat 1: FDIBA2009 (button) (small blind) collected (200)
Seat 2: s70n3fac3 (big blind) folded before Flop



PokerStars Home Game Hand #225903472135: {Club #4781089}  Hold'em No Limit (50/100) - 2021/04/17 0:03:11 EET [2021/04/16 17:03:11 ET]
Table 'NLHE Session 2' 2-max (Play Money) Seat #2 is the button
Seat 1: FDIBA2009 (25312 in chips) 
Seat 2: s70n3fac3 (14170 in chips) 
s70n3fac3: posts small blind 50
FDIBA2009: posts big blind 100
*** HOLE CARDS ***
s70n3fac3: raises 150 to 250
FDIBA2009: calls 150
*** FLOP *** [Td 6c 3d]
FDIBA2009: checks 
s70n3fac3: bets 260
FDIBA2009: folds 
Uncalled bet (260) returned to s70n3fac3
s70n3fac3 collected 472 from pot
s70n3fac3: doesn't show hand 
*** SUMMARY ***
Total pot 500 | Rake 28 
Board [Td 6c 3d]
Seat 1: FDIBA2009 (big blind) folded on the Flop
Seat 2: s70n3fac3 (button) (small blind) collected (472)



PokerStars Home Game Hand #225903481774: {Club #4781089}  Hold'em No Limit (50/100) - 2021/04/17 0:03:25 EET [2021/04/16 17:03:25 ET]
Table 'NLHE Session 2' 2-max (Play Money) Seat #1 is the button
Seat 1: FDIBA2009 (25062 in chips) 
Seat 2: s70n3fac3 (14392 in chips) 
FDIBA2009: posts small blind 50
s70n3fac3: posts big blind 100
*** HOLE CARDS ***
FDIBA2009: raises 100 to 200
s70n3fac3: calls 100
*** FLOP *** [5h Qd 3d]
s70n3fac3: checks 
FDIBA2009: bets 378
s70n3fac3: folds 
Uncalled bet (378) returned to FDIBA2009
FDIBA2009 collected 378 from pot
*** SUMMARY ***
Total pot 400 | Rake 22 
Board [5h Qd 3d]
Seat 1: FDIBA2009 (button) (small blind) collected (378)
Seat 2: s70n3fac3 (big blind) folded on the Flop



PokerStars Home Game Hand #225903490467: {Club #4781089}  Hold'em No Limit (50/100) - 2021/04/17 0:03:38 EET [2021/04/16 17:03:38 ET]
Table 'NLHE Session 2' 2-max (Play Money) Seat #2 is the button
Seat 1: FDIBA2009 (25240 in chips) 
Seat 2: s70n3fac3 (14192 in chips) 
s70n3fac3: posts small blind 50
FDIBA2009: posts big blind 100
*** HOLE CARDS ***
s70n3fac3: raises 100 to 200
FDIBA2009: calls 100
*** FLOP *** [3s Ts 5c]
FDIBA2009: checks 
s70n3fac3: checks 
*** TURN *** [3s Ts 5c] [3d]
FDIBA2009: checks 
s70n3fac3: checks 
*** RIVER *** [3s Ts 5c 3d] [6c]
FDIBA2009: bets 378
s70n3fac3: folds 
Uncalled bet (378) returned to FDIBA2009
FDIBA2009 collected 378 from pot
*** SUMMARY ***
Total pot 400 | Rake 22 
Board [3s Ts 5c 3d 6c]
Seat 1: FDIBA2009 (big blind) collected (378)
Seat 2: s70n3fac3 (button) (small blind) folded on the River



PokerStars Home Game Hand #225903503587: {Club #4781089}  Hold'em No Limit (50/100) - 2021/04/17 0:03:58 EET [2021/04/16 17:03:58 ET]
Table 'NLHE Session 2' 2-max (Play Money) Seat #1 is the button
Seat 1: FDIBA2009 (25418 in chips) 
Seat 2: s70n3fac3 (13992 in chips) 
FDIBA2009: posts small blind 50
s70n3fac3: posts big blind 100
*** HOLE CARDS ***
FDIBA2009: raises 100 to 200
s70n3fac3: calls 100
*** FLOP *** [Ac 2c 4h]
s70n3fac3: checks 
FDIBA2009: bets 378
s70n3fac3: folds 
Uncalled bet (378) returned to FDIBA2009
FDIBA2009 collected 378 from pot
*** SUMMARY ***
Total pot 400 | Rake 22 
Board [Ac 2c 4h]
Seat 1: FDIBA2009 (button) (small blind) collected (378)
Seat 2: s70n3fac3 (big blind) folded on the Flop



PokerStars Home Game Hand #225903511319: {Club #4781089}  Hold'em No Limit (50/100) - 2021/04/17 0:04:10 EET [2021/04/16 17:04:10 ET]
Table 'NLHE Session 2' 2-max (Play Money) Seat #2 is the button
Seat 1: FDIBA2009 (25596 in chips) 
Seat 2: s70n3fac3 (13792 in chips) 
s70n3fac3: posts small blind 50
FDIBA2009: posts big blind 100
*** HOLE CARDS ***
s70n3fac3: raises 100 to 200
FDIBA2009: raises 400 to 600
s70n3fac3: calls 400
*** FLOP *** [Ac 7h 4s]
FDIBA2009: bets 567
s70n3fac3: calls 567
*** TURN *** [Ac 7h 4s] [3c]
FDIBA2009: bets 1103
s70n3fac3: folds 
Uncalled bet (1103) returned to FDIBA2009
FDIBA2009 collected 2206 from pot
*** SUMMARY ***
Total pot 2334 | Rake 128 
Board [Ac 7h 4s 3c]
Seat 1: FDIBA2009 (big blind) collected (2206)
Seat 2: s70n3fac3 (button) (small blind) folded on the Turn



PokerStars Home Game Hand #225903536576: {Club #4781089}  Hold'em No Limit (50/100) - 2021/04/17 0:04:47 EET [2021/04/16 17:04:47 ET]
Table 'NLHE Session 2' 2-max (Play Money) Seat #1 is the button
Seat 1: FDIBA2009 (26635 in chips) 
Seat 2: s70n3fac3 (12625 in chips) 
FDIBA2009: posts small blind 50
s70n3fac3: posts big blind 100
*** HOLE CARDS ***
FDIBA2009: raises 200 to 300
s70n3fac3: folds 
Uncalled bet (200) returned to FDIBA2009
FDIBA2009 collected 200 from pot
*** SUMMARY ***
Total pot 200 | Rake 0 
Seat 1: FDIBA2009 (button) (small blind) collected (200)
Seat 2: s70n3fac3 (big blind) folded before Flop



PokerStars Home Game Hand #225903541632: {Club #4781089}  Hold'em No Limit (50/100) - 2021/04/17 0:04:55 EET [2021/04/16 17:04:55 ET]
Table 'NLHE Session 2' 2-max (Play Money) Seat #2 is the button
Seat 1: FDIBA2009 (26735 in chips) 
Seat 2: s70n3fac3 (12525 in chips) 
s70n3fac3: posts small blind 50
FDIBA2009: posts big blind 100
*** HOLE CARDS ***
s70n3fac3: raises 150 to 250
FDIBA2009: folds 
Uncalled bet (150) returned to s70n3fac3
s70n3fac3 collected 200 from pot
s70n3fac3: doesn't show hand 
*** SUMMARY ***
Total pot 200 | Rake 0 
Seat 1: FDIBA2009 (big blind) folded before Flop
Seat 2: s70n3fac3 (button) (small blind) collected (200)



PokerStars Home Game Hand #225903549241: {Club #4781089}  Hold'em No Limit (50/100) - 2021/04/17 0:05:03 EET [2021/04/16 17:05:03 ET]
Table 'NLHE Session 2' 2-max (Play Money) Seat #1 is the button
Seat 1: FDIBA2009 (26635 in chips) 
Seat 2: s70n3fac3 (12625 in chips) 
FDIBA2009: posts small blind 50
s70n3fac3: posts big blind 100
*** HOLE CARDS ***
FDIBA2009: raises 200 to 300
s70n3fac3: calls 200
*** FLOP *** [4d 4s 2s]
s70n3fac3: checks 
FDIBA2009: checks 
*** TURN *** [4d 4s 2s] [7c]
s70n3fac3: bets 300
FDIBA2009: calls 300
*** RIVER *** [4d 4s 2s 7c] [3c]
s70n3fac3: bets 900
FDIBA2009: folds 
Uncalled bet (900) returned to s70n3fac3
s70n3fac3 collected 1134 from pot
s70n3fac3: doesn't show hand 
*** SUMMARY ***
Total pot 1200 | Rake 66 
Board [4d 4s 2s 7c 3c]
Seat 1: FDIBA2009 (button) (small blind) folded on the River
Seat 2: s70n3fac3 (big blind) collected (1134)



PokerStars Home Game Hand #225903576493: {Club #4781089}  Hold'em No Limit (50/100) - 2021/04/17 0:05:38 EET [2021/04/16 17:05:38 ET]
Table 'NLHE Session 2' 2-max (Play Money) Seat #2 is the button
Seat 1: FDIBA2009 (26035 in chips) 
Seat 2: s70n3fac3 (13159 in chips) 
s70n3fac3: posts small blind 50
FDIBA2009: posts big blind 100
*** HOLE CARDS ***
s70n3fac3: folds 
Uncalled bet (50) returned to FDIBA2009
FDIBA2009 collected 100 from pot
*** SUMMARY ***
Total pot 100 | Rake 0 
Seat 1: FDIBA2009 (big blind) collected (100)
Seat 2: s70n3fac3 (button) (small blind) folded before Flop



PokerStars Home Game Hand #225903579766: {Club #4781089}  Hold'em No Limit (50/100) - 2021/04/17 0:05:42 EET [2021/04/16 17:05:42 ET]
Table 'NLHE Session 2' 2-max (Play Money) Seat #1 is the button
Seat 1: FDIBA2009 (26085 in chips) 
Seat 2: s70n3fac3 (13109 in chips) 
FDIBA2009: posts small blind 50
s70n3fac3: posts big blind 100
*** HOLE CARDS ***
FDIBA2009: raises 100 to 200
s70n3fac3: folds 
Uncalled bet (100) returned to FDIBA2009
FDIBA2009 collected 200 from pot
*** SUMMARY ***
Total pot 200 | Rake 0 
Seat 1: FDIBA2009 (button) (small blind) collected (200)
Seat 2: s70n3fac3 (big blind) folded before Flop



PokerStars Home Game Hand #225903584690: {Club #4781089}  Hold'em No Limit (50/100) - 2021/04/17 0:05:48 EET [2021/04/16 17:05:48 ET]
Table 'NLHE Session 2' 2-max (Play Money) Seat #2 is the button
Seat 1: FDIBA2009 (26185 in chips) 
Seat 2: s70n3fac3 (13009 in chips) 
s70n3fac3: posts small blind 50
FDIBA2009: posts big blind 100
*** HOLE CARDS ***
s70n3fac3: raises 150 to 250
FDIBA2009: folds 
Uncalled bet (150) returned to s70n3fac3
s70n3fac3 collected 200 from pot
s70n3fac3: doesn't show hand 
*** SUMMARY ***
Total pot 200 | Rake 0 
Seat 1: FDIBA2009 (big blind) folded before Flop
Seat 2: s70n3fac3 (button) (small blind) collected (200)



PokerStars Home Game Hand #225903589549: {Club #4781089}  Hold'em No Limit (50/100) - 2021/04/17 0:05:55 EET [2021/04/16 17:05:55 ET]
Table 'NLHE Session 2' 2-max (Play Money) Seat #1 is the button
Seat 1: FDIBA2009 (26085 in chips) 
Seat 2: s70n3fac3 (13109 in chips) 
FDIBA2009: posts small blind 50
s70n3fac3: posts big blind 100
*** HOLE CARDS ***
FDIBA2009: raises 200 to 300
s70n3fac3: raises 400 to 700
FDIBA2009: calls 400
*** FLOP *** [Ts 7d 4c]
s70n3fac3: bets 700
FDIBA2009: calls 700
*** TURN *** [Ts 7d 4c] [9s]
s70n3fac3: bets 1500
FDIBA2009: calls 1500
*** RIVER *** [Ts 7d 4c 9s] [7c]
s70n3fac3: bets 6250
FDIBA2009: calls 6250
*** SHOW DOWN ***
s70n3fac3: shows [Kc Kh] (two pair, Kings and Sevens)
FDIBA2009: mucks hand 
s70n3fac3 collected 17293 from pot
*** SUMMARY ***
Total pot 18300 | Rake 1007 
Board [Ts 7d 4c 9s 7c]
Seat 1: FDIBA2009 (button) (small blind) mucked [Tc 8h]
Seat 2: s70n3fac3 (big blind) showed [Kc Kh] and won (17293) with two pair, Kings and Sevens



PokerStars Home Game Hand #225903633877: {Club #4781089}  Hold'em No Limit (50/100) - 2021/04/17 0:06:50 EET [2021/04/16 17:06:50 ET]
Table 'NLHE Session 2' 2-max (Play Money) Seat #2 is the button
Seat 1: FDIBA2009 (16935 in chips) 
Seat 2: s70n3fac3 (21252 in chips) 
s70n3fac3: posts small blind 50
FDIBA2009: posts big blind 100
*** HOLE CARDS ***
s70n3fac3: folds 
Uncalled bet (50) returned to FDIBA2009
FDIBA2009 collected 100 from pot
*** SUMMARY ***
Total pot 100 | Rake 0 
Seat 1: FDIBA2009 (big blind) collected (100)
Seat 2: s70n3fac3 (button) (small blind) folded before Flop



PokerStars Home Game Hand #225903637219: {Club #4781089}  Hold'em No Limit (50/100) - 2021/04/17 0:06:54 EET [2021/04/16 17:06:54 ET]
Table 'NLHE Session 2' 2-max (Play Money) Seat #1 is the button
Seat 1: FDIBA2009 (16985 in chips) 
Seat 2: s70n3fac3 (21202 in chips) 
FDIBA2009: posts small blind 50
s70n3fac3: posts big blind 100
*** HOLE CARDS ***
FDIBA2009: raises 100 to 200
s70n3fac3: calls 100
*** FLOP *** [7c Qd 6s]
s70n3fac3: bets 200
FDIBA2009: raises 778 to 978
s70n3fac3: calls 778
*** TURN *** [7c Qd 6s] [Jc]
s70n3fac3: checks 
FDIBA2009: bets 1300
s70n3fac3: folds 
Uncalled bet (1300) returned to FDIBA2009
FDIBA2009 collected 2226 from pot
*** SUMMARY ***
Total pot 2356 | Rake 130 
Board [7c Qd 6s Jc]
Seat 1: FDIBA2009 (button) (small blind) collected (2226)
Seat 2: s70n3fac3 (big blind) folded on the Turn



PokerStars Home Game Hand #225903660655: {Club #4781089}  Hold'em No Limit (50/100) - 2021/04/17 0:07:23 EET [2021/04/16 17:07:23 ET]
Table 'NLHE Session 2' 2-max (Play Money) Seat #2 is the button
Seat 1: FDIBA2009 (18033 in chips) 
Seat 2: s70n3fac3 (20024 in chips) 
s70n3fac3: posts small blind 50
FDIBA2009: posts big blind 100
*** HOLE CARDS ***
s70n3fac3: folds 
Uncalled bet (50) returned to FDIBA2009
FDIBA2009 collected 100 from pot
*** SUMMARY ***
Total pot 100 | Rake 0 
Seat 1: FDIBA2009 (big blind) collected (100)
Seat 2: s70n3fac3 (button) (small blind) folded before Flop



PokerStars Home Game Hand #225903663796: {Club #4781089}  Hold'em No Limit (50/100) - 2021/04/17 0:07:27 EET [2021/04/16 17:07:27 ET]
Table 'NLHE Session 2' 2-max (Play Money) Seat #1 is the button
Seat 1: FDIBA2009 (18083 in chips) 
Seat 2: s70n3fac3 (19974 in chips) 
FDIBA2009: posts small blind 50
s70n3fac3: posts big blind 100
*** HOLE CARDS ***
FDIBA2009: raises 100 to 200
s70n3fac3: calls 100
*** FLOP *** [9c Qh 4h]
s70n3fac3: checks 
FDIBA2009: checks 
*** TURN *** [9c Qh 4h] [6c]
s70n3fac3: bets 200
FDIBA2009: calls 200
*** RIVER *** [9c Qh 4h 6c] [Kc]
s70n3fac3: bets 300
FDIBA2009: folds 
Uncalled bet (300) returned to s70n3fac3
s70n3fac3 collected 756 from pot
s70n3fac3: doesn't show hand 
*** SUMMARY ***
Total pot 800 | Rake 44 
Board [9c Qh 4h 6c Kc]
Seat 1: FDIBA2009 (button) (small blind) folded on the River
Seat 2: s70n3fac3 (big blind) collected (756)



PokerStars Home Game Hand #225903681018: {Club #4781089}  Hold'em No Limit (50/100) - 2021/04/17 0:07:49 EET [2021/04/16 17:07:49 ET]
Table 'NLHE Session 2' 2-max (Play Money) Seat #2 is the button
Seat 1: FDIBA2009 (17683 in chips) 
Seat 2: s70n3fac3 (20330 in chips) 
s70n3fac3: posts small blind 50
FDIBA2009: posts big blind 100
*** HOLE CARDS ***
s70n3fac3: raises 150 to 250
FDIBA2009: folds 
Uncalled bet (150) returned to s70n3fac3
s70n3fac3 collected 200 from pot
s70n3fac3: doesn't show hand 
*** SUMMARY ***
Total pot 200 | Rake 0 
Seat 1: FDIBA2009 (big blind) folded before Flop
Seat 2: s70n3fac3 (button) (small blind) collected (200)



PokerStars Home Game Hand #225903685832: {Club #4781089}  Hold'em No Limit (50/100) - 2021/04/17 0:07:55 EET [2021/04/16 17:07:55 ET]
Table 'NLHE Session 2' 2-max (Play Money) Seat #1 is the button
Seat 1: FDIBA2009 (17583 in chips) 
Seat 2: s70n3fac3 (20430 in chips) 
FDIBA2009: posts small blind 50
s70n3fac3: posts big blind 100
*** HOLE CARDS ***
FDIBA2009: folds 
Uncalled bet (50) returned to s70n3fac3
s70n3fac3 collected 100 from pot
s70n3fac3: doesn't show hand 
*** SUMMARY ***
Total pot 100 | Rake 0 
Seat 1: FDIBA2009 (button) (small blind) folded before Flop
Seat 2: s70n3fac3 (big blind) collected (100)



PokerStars Home Game Hand #225903689778: {Club #4781089}  Hold'em No Limit (50/100) - 2021/04/17 0:08:00 EET [2021/04/16 17:08:00 ET]
Table 'NLHE Session 2' 2-max (Play Money) Seat #2 is the button
Seat 1: FDIBA2009 (17533 in chips) 
Seat 2: s70n3fac3 (20480 in chips) 
s70n3fac3: posts small blind 50
FDIBA2009: posts big blind 100
*** HOLE CARDS ***
s70n3fac3: raises 150 to 250
FDIBA2009: folds 
Uncalled bet (150) returned to s70n3fac3
s70n3fac3 collected 200 from pot
s70n3fac3: doesn't show hand 
*** SUMMARY ***
Total pot 200 | Rake 0 
Seat 1: FDIBA2009 (big blind) folded before Flop
Seat 2: s70n3fac3 (button) (small blind) collected (200)



PokerStars Home Game Hand #225903694508: {Club #4781089}  Hold'em No Limit (50/100) - 2021/04/17 0:08:05 EET [2021/04/16 17:08:05 ET]
Table 'NLHE Session 2' 2-max (Play Money) Seat #1 is the button
Seat 1: FDIBA2009 (17433 in chips) 
Seat 2: s70n3fac3 (20580 in chips) 
FDIBA2009: posts small blind 50
s70n3fac3: posts big blind 100
*** HOLE CARDS ***
FDIBA2009: raises 100 to 200
s70n3fac3: calls 100
*** FLOP *** [3h Qh Qd]
s70n3fac3: checks 
FDIBA2009: bets 300
s70n3fac3: calls 300
*** TURN *** [3h Qh Qd] [5s]
s70n3fac3: checks 
FDIBA2009: bets 800
s70n3fac3: calls 800
*** RIVER *** [3h Qh Qd 5s] [2d]
s70n3fac3: bets 1800
FDIBA2009: folds 
Uncalled bet (1800) returned to s70n3fac3
s70n3fac3 collected 2457 from pot
s70n3fac3: doesn't show hand 
*** SUMMARY ***
Total pot 2600 | Rake 143 
Board [3h Qh Qd 5s 2d]
Seat 1: FDIBA2009 (button) (small blind) folded on the River
Seat 2: s70n3fac3 (big blind) collected (2457)



PokerStars Home Game Hand #225903725880: {Club #4781089}  Hold'em No Limit (50/100) - 2021/04/17 0:08:45 EET [2021/04/16 17:08:45 ET]
Table 'NLHE Session 2' 2-max (Play Money) Seat #2 is the button
Seat 1: FDIBA2009 (16133 in chips) 
Seat 2: s70n3fac3 (21737 in chips) 
s70n3fac3: posts small blind 50
FDIBA2009: posts big blind 100
*** HOLE CARDS ***
s70n3fac3: folds 
Uncalled bet (50) returned to FDIBA2009
FDIBA2009 collected 100 from pot
*** SUMMARY ***
Total pot 100 | Rake 0 
Seat 1: FDIBA2009 (big blind) collected (100)
Seat 2: s70n3fac3 (button) (small blind) folded before Flop



PokerStars Home Game Hand #225903729017: {Club #4781089}  Hold'em No Limit (50/100) - 2021/04/17 0:08:49 EET [2021/04/16 17:08:49 ET]
Table 'NLHE Session 2' 2-max (Play Money) Seat #1 is the button
Seat 1: FDIBA2009 (16183 in chips) 
Seat 2: s70n3fac3 (21687 in chips) 
FDIBA2009: posts small blind 50
s70n3fac3: posts big blind 100
*** HOLE CARDS ***
FDIBA2009: raises 200 to 300
s70n3fac3: folds 
Uncalled bet (200) returned to FDIBA2009
FDIBA2009 collected 200 from pot
*** SUMMARY ***
Total pot 200 | Rake 0 
Seat 1: FDIBA2009 (button) (small blind) collected (200)
Seat 2: s70n3fac3 (big blind) folded before Flop



PokerStars Home Game Hand #225903735426: {Club #4781089}  Hold'em No Limit (50/100) - 2021/04/17 0:08:57 EET [2021/04/16 17:08:57 ET]
Table 'NLHE Session 2' 2-max (Play Money) Seat #2 is the button
Seat 1: FDIBA2009 (16283 in chips) 
Seat 2: s70n3fac3 (21587 in chips) 
s70n3fac3: posts small blind 50
FDIBA2009: posts big blind 100
*** HOLE CARDS ***
s70n3fac3: raises 150 to 250
FDIBA2009: calls 150
*** FLOP *** [6h Ad 3c]
FDIBA2009: checks 
s70n3fac3: bets 250
FDIBA2009: calls 250
*** TURN *** [6h Ad 3c] [2h]
FDIBA2009: checks 
s70n3fac3: bets 425
FDIBA2009: raises 975 to 1400
s70n3fac3: calls 975
*** RIVER *** [6h Ad 3c 2h] [Td]
FDIBA2009: checks 
s70n3fac3: bets 1565
FDIBA2009: folds 
Uncalled bet (1565) returned to s70n3fac3
s70n3fac3 collected 3591 from pot
s70n3fac3: doesn't show hand 
*** SUMMARY ***
Total pot 3800 | Rake 209 
Board [6h Ad 3c 2h Td]
Seat 1: FDIBA2009 (big blind) folded on the River
Seat 2: s70n3fac3 (button) (small blind) collected (3591)



PokerStars Home Game Hand #225903789479: {Club #4781089}  Hold'em No Limit (50/100) - 2021/04/17 0:10:06 EET [2021/04/16 17:10:06 ET]
Table 'NLHE Session 2' 2-max (Play Money) Seat #1 is the button
Seat 1: FDIBA2009 (14383 in chips) 
Seat 2: s70n3fac3 (23278 in chips) 
FDIBA2009: posts small blind 50
s70n3fac3: posts big blind 100
*** HOLE CARDS ***
FDIBA2009: raises 100 to 200
s70n3fac3: calls 100
*** FLOP *** [Jh 2s 3c]
s70n3fac3: checks 
FDIBA2009: checks 
*** TURN *** [Jh 2s 3c] [2d]
s70n3fac3: checks 
FDIBA2009: checks 
*** RIVER *** [Jh 2s 3c 2d] [Qs]
s70n3fac3: checks 
FDIBA2009: bets 378
s70n3fac3: folds 
Uncalled bet (378) returned to FDIBA2009
FDIBA2009 collected 378 from pot
*** SUMMARY ***
Total pot 400 | Rake 22 
Board [Jh 2s 3c 2d Qs]
Seat 1: FDIBA2009 (button) (small blind) collected (378)
Seat 2: s70n3fac3 (big blind) folded on the River



PokerStars Home Game Hand #225903804624: {Club #4781089}  Hold'em No Limit (50/100) - 2021/04/17 0:10:25 EET [2021/04/16 17:10:25 ET]
Table 'NLHE Session 2' 2-max (Play Money) Seat #2 is the button
Seat 1: FDIBA2009 (14561 in chips) 
Seat 2: s70n3fac3 (23078 in chips) 
s70n3fac3: posts small blind 50
FDIBA2009: posts big blind 100
*** HOLE CARDS ***
s70n3fac3: raises 100 to 200
FDIBA2009: folds 
Uncalled bet (100) returned to s70n3fac3
s70n3fac3 collected 200 from pot
s70n3fac3: doesn't show hand 
*** SUMMARY ***
Total pot 200 | Rake 0 
Seat 1: FDIBA2009 (big blind) folded before Flop
Seat 2: s70n3fac3 (button) (small blind) collected (200)



PokerStars Home Game Hand #225903808813: {Club #4781089}  Hold'em No Limit (50/100) - 2021/04/17 0:10:31 EET [2021/04/16 17:10:31 ET]
Table 'NLHE Session 2' 2-max (Play Money) Seat #1 is the button
Seat 1: FDIBA2009 (14461 in chips) 
Seat 2: s70n3fac3 (23178 in chips) 
FDIBA2009: posts small blind 50
s70n3fac3: posts big blind 100
*** HOLE CARDS ***
FDIBA2009: raises 100 to 200
s70n3fac3: folds 
Uncalled bet (100) returned to FDIBA2009
FDIBA2009 collected 200 from pot
*** SUMMARY ***
Total pot 200 | Rake 0 
Seat 1: FDIBA2009 (button) (small blind) collected (200)
Seat 2: s70n3fac3 (big blind) folded before Flop



PokerStars Home Game Hand #225903822809: {Club #4781089}  Hold'em No Limit (50/100) - 2021/04/17 0:10:37 EET [2021/04/16 17:10:37 ET]
Table 'NLHE Session 2' 2-max (Play Money) Seat #2 is the button
Seat 1: FDIBA2009 (14561 in chips) 
Seat 2: s70n3fac3 (23078 in chips) 
s70n3fac3: posts small blind 50
FDIBA2009: posts big blind 100
*** HOLE CARDS ***
s70n3fac3: raises 100 to 200
FDIBA2009: folds 
Uncalled bet (100) returned to s70n3fac3
s70n3fac3 collected 200 from pot
s70n3fac3: doesn't show hand 
*** SUMMARY ***
Total pot 200 | Rake 0 
Seat 1: FDIBA2009 (big blind) folded before Flop
Seat 2: s70n3fac3 (button) (small blind) collected (200)



PokerStars Home Game Hand #225903827073: {Club #4781089}  Hold'em No Limit (50/100) - 2021/04/17 0:10:42 EET [2021/04/16 17:10:42 ET]
Table 'NLHE Session 2' 2-max (Play Money) Seat #1 is the button
Seat 1: FDIBA2009 (14461 in chips) 
Seat 2: s70n3fac3 (23178 in chips) 
FDIBA2009: posts small blind 50
s70n3fac3: posts big blind 100
*** HOLE CARDS ***
FDIBA2009: raises 100 to 200
s70n3fac3: calls 100
*** FLOP *** [7d Ks Kd]
s70n3fac3: checks 
FDIBA2009: checks 
*** TURN *** [7d Ks Kd] [Ah]
s70n3fac3: checks 
FDIBA2009: bets 378
s70n3fac3: folds 
Uncalled bet (378) returned to FDIBA2009
FDIBA2009 collected 378 from pot
*** SUMMARY ***
Total pot 400 | Rake 22 
Board [7d Ks Kd Ah]
Seat 1: FDIBA2009 (button) (small blind) collected (378)
Seat 2: s70n3fac3 (big blind) folded on the Turn



PokerStars Home Game Hand #225903840725: {Club #4781089}  Hold'em No Limit (50/100) - 2021/04/17 0:11:00 EET [2021/04/16 17:11:00 ET]
Table 'NLHE Session 2' 2-max (Play Money) Seat #2 is the button
Seat 1: FDIBA2009 (14639 in chips) 
Seat 2: s70n3fac3 (22978 in chips) 
s70n3fac3: posts small blind 50
FDIBA2009: posts big blind 100
*** HOLE CARDS ***
s70n3fac3: folds 
Uncalled bet (50) returned to FDIBA2009
FDIBA2009 collected 100 from pot
*** SUMMARY ***
Total pot 100 | Rake 0 
Seat 1: FDIBA2009 (big blind) collected (100)
Seat 2: s70n3fac3 (button) (small blind) folded before Flop



PokerStars Home Game Hand #225903843925: {Club #4781089}  Hold'em No Limit (50/100) - 2021/04/17 0:11:04 EET [2021/04/16 17:11:04 ET]
Table 'NLHE Session 2' 2-max (Play Money) Seat #1 is the button
Seat 1: FDIBA2009 (14689 in chips) 
Seat 2: s70n3fac3 (22928 in chips) 
FDIBA2009: posts small blind 50
s70n3fac3: posts big blind 100
*** HOLE CARDS ***
FDIBA2009: raises 100 to 200
s70n3fac3: raises 300 to 500
FDIBA2009: folds 
Uncalled bet (300) returned to s70n3fac3
s70n3fac3 collected 400 from pot
s70n3fac3: doesn't show hand 
*** SUMMARY ***
Total pot 400 | Rake 0 
Seat 1: FDIBA2009 (button) (small blind) folded before Flop
Seat 2: s70n3fac3 (big blind) collected (400)



PokerStars Home Game Hand #225903852477: {Club #4781089}  Hold'em No Limit (50/100) - 2021/04/17 0:11:15 EET [2021/04/16 17:11:15 ET]
Table 'NLHE Session 2' 2-max (Play Money) Seat #2 is the button
Seat 1: FDIBA2009 (14489 in chips) 
Seat 2: s70n3fac3 (23128 in chips) 
s70n3fac3: posts small blind 50
FDIBA2009: posts big blind 100
*** HOLE CARDS ***
s70n3fac3: folds 
Uncalled bet (50) returned to FDIBA2009
FDIBA2009 collected 100 from pot
*** SUMMARY ***
Total pot 100 | Rake 0 
Seat 1: FDIBA2009 (big blind) collected (100)
Seat 2: s70n3fac3 (button) (small blind) folded before Flop



PokerStars Home Game Hand #225903855534: {Club #4781089}  Hold'em No Limit (50/100) - 2021/04/17 0:11:19 EET [2021/04/16 17:11:19 ET]
Table 'NLHE Session 2' 2-max (Play Money) Seat #1 is the button
Seat 1: FDIBA2009 (14539 in chips) 
Seat 2: s70n3fac3 (23078 in chips) 
FDIBA2009: posts small blind 50
s70n3fac3: posts big blind 100
*** HOLE CARDS ***
FDIBA2009: raises 100 to 200
s70n3fac3: raises 300 to 500
FDIBA2009: calls 300
*** FLOP *** [4c 6s 2s]
s70n3fac3: checks 
FDIBA2009: bets 500
s70n3fac3: calls 500
*** TURN *** [4c 6s 2s] [Qh]
s70n3fac3: checks 
FDIBA2009: bets 1100
s70n3fac3: folds 
Uncalled bet (1100) returned to FDIBA2009
FDIBA2009 collected 1890 from pot
*** SUMMARY ***
Total pot 2000 | Rake 110 
Board [4c 6s 2s Qh]
Seat 1: FDIBA2009 (button) (small blind) collected (1890)
Seat 2: s70n3fac3 (big blind) folded on the Turn



PokerStars Home Game Hand #225903878878: {Club #4781089}  Hold'em No Limit (50/100) - 2021/04/17 0:11:50 EET [2021/04/16 17:11:50 ET]
Table 'NLHE Session 2' 2-max (Play Money) Seat #2 is the button
Seat 1: FDIBA2009 (15429 in chips) 
Seat 2: s70n3fac3 (22078 in chips) 
s70n3fac3: posts small blind 50
FDIBA2009: posts big blind 100
*** HOLE CARDS ***
s70n3fac3: raises 100 to 200
FDIBA2009: raises 300 to 500
s70n3fac3: calls 300
*** FLOP *** [Qd 5h Ts]
FDIBA2009: checks 
s70n3fac3: checks 
*** TURN *** [Qd 5h Ts] [Tc]
FDIBA2009: bets 500
s70n3fac3: raises 700 to 1200
FDIBA2009: folds 
Uncalled bet (700) returned to s70n3fac3
s70n3fac3 collected 1890 from pot
s70n3fac3: doesn't show hand 
*** SUMMARY ***
Total pot 2000 | Rake 110 
Board [Qd 5h Ts Tc]
Seat 1: FDIBA2009 (big blind) folded on the Turn
Seat 2: s70n3fac3 (button) (small blind) collected (1890)



PokerStars Home Game Hand #225903900123: {Club #4781089}  Hold'em No Limit (50/100) - 2021/04/17 0:12:18 EET [2021/04/16 17:12:18 ET]
Table 'NLHE Session 2' 2-max (Play Money) Seat #1 is the button
Seat 1: FDIBA2009 (14429 in chips) 
Seat 2: s70n3fac3 (22968 in chips) 
FDIBA2009: posts small blind 50
s70n3fac3: posts big blind 100
*** HOLE CARDS ***
FDIBA2009: raises 100 to 200
s70n3fac3: raises 200 to 400
FDIBA2009: calls 200
*** FLOP *** [4s 9c 3d]
s70n3fac3: checks 
FDIBA2009: bets 100
s70n3fac3: calls 100
*** TURN *** [4s 9c 3d] [Qd]
s70n3fac3: checks 
FDIBA2009: bets 200
s70n3fac3: calls 200
*** RIVER *** [4s 9c 3d Qd] [9d]
s70n3fac3: checks 
FDIBA2009: checks 
*** SHOW DOWN ***
s70n3fac3: shows [Tc Kc] (a pair of Nines)
FDIBA2009: shows [3h 2h] (two pair, Nines and Threes)
FDIBA2009 collected 1323 from pot
*** SUMMARY ***
Total pot 1400 | Rake 77 
Board [4s 9c 3d Qd 9d]
Seat 1: FDIBA2009 (button) (small blind) showed [3h 2h] and won (1323) with two pair, Nines and Threes
Seat 2: s70n3fac3 (big blind) showed [Tc Kc] and lost with a pair of Nines



PokerStars Home Game Hand #225903919128: {Club #4781089}  Hold'em No Limit (50/100) - 2021/04/17 0:12:43 EET [2021/04/16 17:12:43 ET]
Table 'NLHE Session 2' 2-max (Play Money) Seat #2 is the button
Seat 1: FDIBA2009 (15052 in chips) 
Seat 2: s70n3fac3 (22268 in chips) 
s70n3fac3: posts small blind 50
FDIBA2009: posts big blind 100
*** HOLE CARDS ***
s70n3fac3: folds 
Uncalled bet (50) returned to FDIBA2009
FDIBA2009 collected 100 from pot
*** SUMMARY ***
Total pot 100 | Rake 0 
Seat 1: FDIBA2009 (big blind) collected (100)
Seat 2: s70n3fac3 (button) (small blind) folded before Flop



PokerStars Home Game Hand #225903921987: {Club #4781089}  Hold'em No Limit (50/100) - 2021/04/17 0:12:47 EET [2021/04/16 17:12:47 ET]
Table 'NLHE Session 2' 2-max (Play Money) Seat #1 is the button
Seat 1: FDIBA2009 (15102 in chips) 
Seat 2: s70n3fac3 (22218 in chips) 
FDIBA2009: posts small blind 50
s70n3fac3: posts big blind 100
*** HOLE CARDS ***
FDIBA2009: raises 100 to 200
s70n3fac3: calls 100
*** FLOP *** [Ac 8c 3c]
s70n3fac3: checks 
FDIBA2009: bets 200
s70n3fac3: folds 
Uncalled bet (200) returned to FDIBA2009
FDIBA2009 collected 378 from pot
*** SUMMARY ***
Total pot 400 | Rake 22 
Board [Ac 8c 3c]
Seat 1: FDIBA2009 (button) (small blind) collected (378)
Seat 2: s70n3fac3 (big blind) folded on the Flop



PokerStars Home Game Hand #225903934168: {Club #4781089}  Hold'em No Limit (50/100) - 2021/04/17 0:13:03 EET [2021/04/16 17:13:03 ET]
Table 'NLHE Session 2' 2-max (Play Money) Seat #2 is the button
Seat 1: FDIBA2009 (15280 in chips) 
Seat 2: s70n3fac3 (22018 in chips) 
s70n3fac3: posts small blind 50
FDIBA2009: posts big blind 100
*** HOLE CARDS ***
s70n3fac3: folds 
Uncalled bet (50) returned to FDIBA2009
FDIBA2009 collected 100 from pot
*** SUMMARY ***
Total pot 100 | Rake 0 
Seat 1: FDIBA2009 (big blind) collected (100)
Seat 2: s70n3fac3 (button) (small blind) folded before Flop



PokerStars Home Game Hand #225903936798: {Club #4781089}  Hold'em No Limit (50/100) - 2021/04/17 0:13:07 EET [2021/04/16 17:13:07 ET]
Table 'NLHE Session 2' 2-max (Play Money) Seat #1 is the button
Seat 1: FDIBA2009 (15330 in chips) 
Seat 2: s70n3fac3 (21968 in chips) 
FDIBA2009: posts small blind 50
s70n3fac3: posts big blind 100
*** HOLE CARDS ***
FDIBA2009: raises 100 to 200
s70n3fac3: calls 100
*** FLOP *** [Th Kd 9c]
s70n3fac3: checks 
FDIBA2009: checks 
*** TURN *** [Th Kd 9c] [5h]
s70n3fac3: bets 200
FDIBA2009: calls 200
*** RIVER *** [Th Kd 9c 5h] [2h]
s70n3fac3: bets 400
FDIBA2009: calls 400
*** SHOW DOWN ***
s70n3fac3: shows [Ah 7h] (a flush, Ace high)
FDIBA2009: mucks hand 
s70n3fac3 collected 1512 from pot
*** SUMMARY ***
Total pot 1600 | Rake 88 
Board [Th Kd 9c 5h 2h]
Seat 1: FDIBA2009 (button) (small blind) mucked [4c Ts]
Seat 2: s70n3fac3 (big blind) showed [Ah 7h] and won (1512) with a flush, Ace high



PokerStars Home Game Hand #225903951979: {Club #4781089}  Hold'em No Limit (50/100) - 2021/04/17 0:13:28 EET [2021/04/16 17:13:28 ET]
Table 'NLHE Session 2' 2-max (Play Money) Seat #2 is the button
Seat 1: FDIBA2009 (14530 in chips) 
Seat 2: s70n3fac3 (22680 in chips) 
s70n3fac3: posts small blind 50
FDIBA2009: posts big blind 100
*** HOLE CARDS ***
s70n3fac3: raises 150 to 250
FDIBA2009: raises 500 to 750
s70n3fac3: calls 500
*** FLOP *** [4h 2s Jd]
FDIBA2009: bets 1200
s70n3fac3: folds 
Uncalled bet (1200) returned to FDIBA2009
FDIBA2009 collected 1417 from pot
*** SUMMARY ***
Total pot 1500 | Rake 83 
Board [4h 2s Jd]
Seat 1: FDIBA2009 (big blind) collected (1417)
Seat 2: s70n3fac3 (button) (small blind) folded on the Flop



PokerStars Home Game Hand #225903976835: {Club #4781089}  Hold'em No Limit (50/100) - 2021/04/17 0:13:49 EET [2021/04/16 17:13:49 ET]
Table 'NLHE Session 2' 2-max (Play Money) Seat #1 is the button
Seat 1: FDIBA2009 (15197 in chips) 
Seat 2: s70n3fac3 (21930 in chips) 
FDIBA2009: posts small blind 50
s70n3fac3: posts big blind 100
*** HOLE CARDS ***
FDIBA2009: raises 100 to 200
s70n3fac3: calls 100
*** FLOP *** [4h Js 2d]
s70n3fac3: checks 
FDIBA2009: checks 
*** TURN *** [4h Js 2d] [7s]
s70n3fac3: bets 200
FDIBA2009: folds 
Uncalled bet (200) returned to s70n3fac3
s70n3fac3 collected 378 from pot
s70n3fac3: doesn't show hand 
*** SUMMARY ***
Total pot 400 | Rake 22 
Board [4h Js 2d 7s]
Seat 1: FDIBA2009 (button) (small blind) folded on the Turn
Seat 2: s70n3fac3 (big blind) collected (378)



PokerStars Home Game Hand #225903989094: {Club #4781089}  Hold'em No Limit (50/100) - 2021/04/17 0:14:06 EET [2021/04/16 17:14:06 ET]
Table 'NLHE Session 2' 2-max (Play Money) Seat #2 is the button
Seat 1: FDIBA2009 (14997 in chips) 
Seat 2: s70n3fac3 (22108 in chips) 
s70n3fac3: posts small blind 50
FDIBA2009: posts big blind 100
*** HOLE CARDS ***
s70n3fac3: raises 100 to 200
FDIBA2009: raises 400 to 600
s70n3fac3: calls 400
*** FLOP *** [Kd 5s 3d]
FDIBA2009: bets 600
s70n3fac3: calls 600
*** TURN *** [Kd 5s 3d] [Jc]
FDIBA2009: bets 1800
s70n3fac3: folds 
Uncalled bet (1800) returned to FDIBA2009
FDIBA2009 collected 2268 from pot
*** SUMMARY ***
Total pot 2400 | Rake 132 
Board [Kd 5s 3d Jc]
Seat 1: FDIBA2009 (big blind) collected (2268)
Seat 2: s70n3fac3 (button) (small blind) folded on the Turn



PokerStars Home Game Hand #225904018941: {Club #4781089}  Hold'em No Limit (50/100) - 2021/04/17 0:14:46 EET [2021/04/16 17:14:46 ET]
Table 'NLHE Session 2' 2-max (Play Money) Seat #1 is the button
Seat 1: FDIBA2009 (16065 in chips) 
Seat 2: s70n3fac3 (20908 in chips) 
FDIBA2009: posts small blind 50
s70n3fac3: posts big blind 100
*** HOLE CARDS ***
FDIBA2009: raises 100 to 200
s70n3fac3: raises 300 to 500
FDIBA2009: folds 
Uncalled bet (300) returned to s70n3fac3
s70n3fac3 collected 400 from pot
s70n3fac3: doesn't show hand 
*** SUMMARY ***
Total pot 400 | Rake 0 
Seat 1: FDIBA2009 (button) (small blind) folded before Flop
Seat 2: s70n3fac3 (big blind) collected (400)



PokerStars Home Game Hand #225904025332: {Club #4781089}  Hold'em No Limit (50/100) - 2021/04/17 0:14:54 EET [2021/04/16 17:14:54 ET]
Table 'NLHE Session 2' 2-max (Play Money) Seat #2 is the button
Seat 1: FDIBA2009 (15865 in chips) 
Seat 2: s70n3fac3 (21108 in chips) 
s70n3fac3: posts small blind 50
FDIBA2009: posts big blind 100
*** HOLE CARDS ***
s70n3fac3: folds 
Uncalled bet (50) returned to FDIBA2009
FDIBA2009 collected 100 from pot
*** SUMMARY ***
Total pot 100 | Rake 0 
Seat 1: FDIBA2009 (big blind) collected (100)
Seat 2: s70n3fac3 (button) (small blind) folded before Flop



PokerStars Home Game Hand #225904028301: {Club #4781089}  Hold'em No Limit (50/100) - 2021/04/17 0:14:59 EET [2021/04/16 17:14:59 ET]
Table 'NLHE Session 2' 2-max (Play Money) Seat #1 is the button
Seat 1: FDIBA2009 (15915 in chips) 
Seat 2: s70n3fac3 (21058 in chips) 
FDIBA2009: posts small blind 50
s70n3fac3: posts big blind 100
*** HOLE CARDS ***
FDIBA2009: raises 100 to 200
s70n3fac3: folds 
Uncalled bet (100) returned to FDIBA2009
FDIBA2009 collected 200 from pot
*** SUMMARY ***
Total pot 200 | Rake 0 
Seat 1: FDIBA2009 (button) (small blind) collected (200)
Seat 2: s70n3fac3 (big blind) folded before Flop



PokerStars Home Game Hand #225904032879: {Club #4781089}  Hold'em No Limit (50/100) - 2021/04/17 0:15:05 EET [2021/04/16 17:15:05 ET]
Table 'NLHE Session 2' 2-max (Play Money) Seat #2 is the button
Seat 1: FDIBA2009 (16015 in chips) 
Seat 2: s70n3fac3 (20958 in chips) 
s70n3fac3: posts small blind 50
FDIBA2009: posts big blind 100
*** HOLE CARDS ***
s70n3fac3: folds 
Uncalled bet (50) returned to FDIBA2009
FDIBA2009 collected 100 from pot
*** SUMMARY ***
Total pot 100 | Rake 0 
Seat 1: FDIBA2009 (big blind) collected (100)
Seat 2: s70n3fac3 (button) (small blind) folded before Flop



PokerStars Home Game Hand #225904035748: {Club #4781089}  Hold'em No Limit (50/100) - 2021/04/17 0:15:08 EET [2021/04/16 17:15:08 ET]
Table 'NLHE Session 2' 2-max (Play Money) Seat #1 is the button
Seat 1: FDIBA2009 (16065 in chips) 
Seat 2: s70n3fac3 (20908 in chips) 
FDIBA2009: posts small blind 50
s70n3fac3: posts big blind 100
*** HOLE CARDS ***
FDIBA2009: raises 100 to 200
s70n3fac3: folds 
Uncalled bet (100) returned to FDIBA2009
FDIBA2009 collected 200 from pot
*** SUMMARY ***
Total pot 200 | Rake 0 
Seat 1: FDIBA2009 (button) (small blind) collected (200)
Seat 2: s70n3fac3 (big blind) folded before Flop



PokerStars Home Game Hand #225904040898: {Club #4781089}  Hold'em No Limit (50/100) - 2021/04/17 0:15:15 EET [2021/04/16 17:15:15 ET]
Table 'NLHE Session 2' 2-max (Play Money) Seat #2 is the button
Seat 1: FDIBA2009 (16165 in chips) 
Seat 2: s70n3fac3 (20808 in chips) 
s70n3fac3: posts small blind 50
FDIBA2009: posts big blind 100
*** HOLE CARDS ***
s70n3fac3: raises 100 to 200
FDIBA2009: folds 
Uncalled bet (100) returned to s70n3fac3
s70n3fac3 collected 200 from pot
s70n3fac3: doesn't show hand 
*** SUMMARY ***
Total pot 200 | Rake 0 
Seat 1: FDIBA2009 (big blind) folded before Flop
Seat 2: s70n3fac3 (button) (small blind) collected (200)



PokerStars Home Game Hand #225904045428: {Club #4781089}  Hold'em No Limit (50/100) - 2021/04/17 0:15:22 EET [2021/04/16 17:15:22 ET]
Table 'NLHE Session 2' 2-max (Play Money) Seat #1 is the button
Seat 1: FDIBA2009 (16065 in chips) 
Seat 2: s70n3fac3 (20908 in chips) 
FDIBA2009: posts small blind 50
s70n3fac3: posts big blind 100
*** HOLE CARDS ***
FDIBA2009: raises 100 to 200
s70n3fac3: folds 
Uncalled bet (100) returned to FDIBA2009
FDIBA2009 collected 200 from pot
*** SUMMARY ***
Total pot 200 | Rake 0 
Seat 1: FDIBA2009 (button) (small blind) collected (200)
Seat 2: s70n3fac3 (big blind) folded before Flop



PokerStars Home Game Hand #225904052940: {Club #4781089}  Hold'em No Limit (50/100) - 2021/04/17 0:15:32 EET [2021/04/16 17:15:32 ET]
Table 'NLHE Session 2' 2-max (Play Money) Seat #2 is the button
Seat 1: FDIBA2009 (16165 in chips) 
Seat 2: s70n3fac3 (20808 in chips) 
s70n3fac3: posts small blind 50
FDIBA2009: posts big blind 100
*** HOLE CARDS ***
s70n3fac3: raises 150 to 250
FDIBA2009: folds 
Uncalled bet (150) returned to s70n3fac3
s70n3fac3 collected 200 from pot
s70n3fac3: doesn't show hand 
*** SUMMARY ***
Total pot 200 | Rake 0 
Seat 1: FDIBA2009 (big blind) folded before Flop
Seat 2: s70n3fac3 (button) (small blind) collected (200)



PokerStars Home Game Hand #225904057496: {Club #4781089}  Hold'em No Limit (50/100) - 2021/04/17 0:15:38 EET [2021/04/16 17:15:38 ET]
Table 'NLHE Session 2' 2-max (Play Money) Seat #1 is the button
Seat 1: FDIBA2009 (16065 in chips) 
Seat 2: s70n3fac3 (20908 in chips) 
FDIBA2009: posts small blind 50
s70n3fac3: posts big blind 100
*** HOLE CARDS ***
FDIBA2009: raises 100 to 200
s70n3fac3: calls 100
*** FLOP *** [5s Kc Ah]
s70n3fac3: checks 
FDIBA2009: bets 378
s70n3fac3: folds 
Uncalled bet (378) returned to FDIBA2009
FDIBA2009 collected 378 from pot
*** SUMMARY ***
Total pot 400 | Rake 22 
Board [5s Kc Ah]
Seat 1: FDIBA2009 (button) (small blind) collected (378)
Seat 2: s70n3fac3 (big blind) folded on the Flop



PokerStars Home Game Hand #225904066780: {Club #4781089}  Hold'em No Limit (50/100) - 2021/04/17 0:15:51 EET [2021/04/16 17:15:51 ET]
Table 'NLHE Session 2' 2-max (Play Money) Seat #2 is the button
Seat 1: FDIBA2009 (16243 in chips) 
Seat 2: s70n3fac3 (20708 in chips) 
s70n3fac3: posts small blind 50
FDIBA2009: posts big blind 100
*** HOLE CARDS ***
s70n3fac3: raises 100 to 200
FDIBA2009: calls 100
*** FLOP *** [9s 8d 5d]
FDIBA2009: checks 
s70n3fac3: bets 200
FDIBA2009: calls 200
*** TURN *** [9s 8d 5d] [Qc]
FDIBA2009: checks 
s70n3fac3: bets 400
FDIBA2009: calls 400
*** RIVER *** [9s 8d 5d Qc] [Jh]
FDIBA2009: bets 1800
s70n3fac3: folds 
Uncalled bet (1800) returned to FDIBA2009
FDIBA2009 collected 1512 from pot
*** SUMMARY ***
Total pot 1600 | Rake 88 
Board [9s 8d 5d Qc Jh]
Seat 1: FDIBA2009 (big blind) collected (1512)
Seat 2: s70n3fac3 (button) (small blind) folded on the River



PokerStars Home Game Hand #225904101468: {Club #4781089}  Hold'em No Limit (50/100) - 2021/04/17 0:16:38 EET [2021/04/16 17:16:38 ET]
Table 'NLHE Session 2' 2-max (Play Money) Seat #1 is the button
Seat 1: FDIBA2009 (16955 in chips) 
Seat 2: s70n3fac3 (19908 in chips) 
FDIBA2009: posts small blind 50
s70n3fac3: posts big blind 100
*** HOLE CARDS ***
FDIBA2009: raises 100 to 200
s70n3fac3: calls 100
*** FLOP *** [4s 3h 8c]
s70n3fac3: checks 
FDIBA2009: bets 378
s70n3fac3: calls 378
*** TURN *** [4s 3h 8c] [Td]
s70n3fac3: checks 
FDIBA2009: bets 1092
s70n3fac3: calls 1092
*** RIVER *** [4s 3h 8c Td] [Ah]
s70n3fac3: checks 
FDIBA2009: bets 3156
s70n3fac3: folds 
Uncalled bet (3156) returned to FDIBA2009
FDIBA2009 collected 3156 from pot
*** SUMMARY ***
Total pot 3340 | Rake 184 
Board [4s 3h 8c Td Ah]
Seat 1: FDIBA2009 (button) (small blind) collected (3156)
Seat 2: s70n3fac3 (big blind) folded on the River



PokerStars Home Game Hand #225904138802: {Club #4781089}  Hold'em No Limit (50/100) - 2021/04/17 0:17:29 EET [2021/04/16 17:17:29 ET]
Table 'NLHE Session 2' 2-max (Play Money) Seat #2 is the button
Seat 1: FDIBA2009 (18441 in chips) 
Seat 2: s70n3fac3 (18238 in chips) 
s70n3fac3: posts small blind 50
FDIBA2009: posts big blind 100
*** HOLE CARDS ***
s70n3fac3: raises 100 to 200
FDIBA2009: calls 100
*** FLOP *** [Ks 3s 6d]
FDIBA2009: checks 
s70n3fac3: checks 
*** TURN *** [Ks 3s 6d] [Td]
FDIBA2009: bets 189
s70n3fac3: raises 311 to 500
FDIBA2009: calls 311
*** RIVER *** [Ks 3s 6d Td] [Qh]
FDIBA2009: checks 
s70n3fac3: bets 1400
FDIBA2009: folds 
Uncalled bet (1400) returned to s70n3fac3
s70n3fac3 collected 1323 from pot
s70n3fac3: doesn't show hand 
*** SUMMARY ***
Total pot 1400 | Rake 77 
Board [Ks 3s 6d Td Qh]
Seat 1: FDIBA2009 (big blind) folded on the River
Seat 2: s70n3fac3 (button) (small blind) collected (1323)



PokerStars Home Game Hand #225904161912: {Club #4781089}  Hold'em No Limit (50/100) - 2021/04/17 0:18:01 EET [2021/04/16 17:18:01 ET]
Table 'NLHE Session 2' 2-max (Play Money) Seat #1 is the button
Seat 1: FDIBA2009 (17741 in chips) 
Seat 2: s70n3fac3 (18861 in chips) 
FDIBA2009: posts small blind 50
s70n3fac3: posts big blind 100
*** HOLE CARDS ***
FDIBA2009: folds 
Uncalled bet (50) returned to s70n3fac3
s70n3fac3 collected 100 from pot
s70n3fac3: doesn't show hand 
*** SUMMARY ***
Total pot 100 | Rake 0 
Seat 1: FDIBA2009 (button) (small blind) folded before Flop
Seat 2: s70n3fac3 (big blind) collected (100)



PokerStars Home Game Hand #225904165036: {Club #4781089}  Hold'em No Limit (50/100) - 2021/04/17 0:18:06 EET [2021/04/16 17:18:06 ET]
Table 'NLHE Session 2' 2-max (Play Money) Seat #2 is the button
Seat 1: FDIBA2009 (17691 in chips) 
Seat 2: s70n3fac3 (18911 in chips) 
s70n3fac3: posts small blind 50
FDIBA2009: posts big blind 100
*** HOLE CARDS ***
s70n3fac3: raises 100 to 200
FDIBA2009: folds 
Uncalled bet (100) returned to s70n3fac3
s70n3fac3 collected 200 from pot
s70n3fac3: doesn't show hand 
*** SUMMARY ***
Total pot 200 | Rake 0 
Seat 1: FDIBA2009 (big blind) folded before Flop
Seat 2: s70n3fac3 (button) (small blind) collected (200)



PokerStars Home Game Hand #225904168977: {Club #4781089}  Hold'em No Limit (50/100) - 2021/04/17 0:18:11 EET [2021/04/16 17:18:11 ET]
Table 'NLHE Session 2' 2-max (Play Money) Seat #1 is the button
Seat 1: FDIBA2009 (17591 in chips) 
Seat 2: s70n3fac3 (19011 in chips) 
FDIBA2009: posts small blind 50
s70n3fac3: posts big blind 100
*** HOLE CARDS ***
FDIBA2009: folds 
Uncalled bet (50) returned to s70n3fac3
s70n3fac3 collected 100 from pot
s70n3fac3: doesn't show hand 
*** SUMMARY ***
Total pot 100 | Rake 0 
Seat 1: FDIBA2009 (button) (small blind) folded before Flop
Seat 2: s70n3fac3 (big blind) collected (100)



PokerStars Home Game Hand #225904172291: {Club #4781089}  Hold'em No Limit (50/100) - 2021/04/17 0:18:16 EET [2021/04/16 17:18:16 ET]
Table 'NLHE Session 2' 2-max (Play Money) Seat #2 is the button
Seat 1: FDIBA2009 (17541 in chips) 
Seat 2: s70n3fac3 (19061 in chips) 
s70n3fac3: posts small blind 50
FDIBA2009: posts big blind 100
*** HOLE CARDS ***
s70n3fac3: folds 
Uncalled bet (50) returned to FDIBA2009
FDIBA2009 collected 100 from pot
*** SUMMARY ***
Total pot 100 | Rake 0 
Seat 1: FDIBA2009 (big blind) collected (100)
Seat 2: s70n3fac3 (button) (small blind) folded before Flop



PokerStars Home Game Hand #225904175163: {Club #4781089}  Hold'em No Limit (50/100) - 2021/04/17 0:18:20 EET [2021/04/16 17:18:20 ET]
Table 'NLHE Session 2' 2-max (Play Money) Seat #1 is the button
Seat 1: FDIBA2009 (17591 in chips) 
Seat 2: s70n3fac3 (19011 in chips) 
FDIBA2009: posts small blind 50
s70n3fac3: posts big blind 100
*** HOLE CARDS ***
FDIBA2009: raises 100 to 200
s70n3fac3: calls 100
*** FLOP *** [Qc 8c 2c]
s70n3fac3: checks 
FDIBA2009: checks 
*** TURN *** [Qc 8c 2c] [Th]
s70n3fac3: checks 
FDIBA2009: bets 300
s70n3fac3: folds 
Uncalled bet (300) returned to FDIBA2009
FDIBA2009 collected 378 from pot
*** SUMMARY ***
Total pot 400 | Rake 22 
Board [Qc 8c 2c Th]
Seat 1: FDIBA2009 (button) (small blind) collected (378)
Seat 2: s70n3fac3 (big blind) folded on the Turn



PokerStars Home Game Hand #225904192761: {Club #4781089}  Hold'em No Limit (50/100) - 2021/04/17 0:18:44 EET [2021/04/16 17:18:44 ET]
Table 'NLHE Session 2' 2-max (Play Money) Seat #2 is the button
Seat 1: FDIBA2009 (17769 in chips) 
Seat 2: s70n3fac3 (18811 in chips) 
s70n3fac3: posts small blind 50
FDIBA2009: posts big blind 100
*** HOLE CARDS ***
s70n3fac3: raises 100 to 200
FDIBA2009: calls 100
*** FLOP *** [3d Ah 6c]
FDIBA2009: checks 
s70n3fac3: bets 200
FDIBA2009: calls 200
*** TURN *** [3d Ah 6c] [8s]
FDIBA2009: checks 
s70n3fac3: bets 400
FDIBA2009: folds 
Uncalled bet (400) returned to s70n3fac3
s70n3fac3 collected 756 from pot
s70n3fac3: doesn't show hand 
*** SUMMARY ***
Total pot 800 | Rake 44 
Board [3d Ah 6c 8s]
Seat 1: FDIBA2009 (big blind) folded on the Turn
Seat 2: s70n3fac3 (button) (small blind) collected (756)



PokerStars Home Game Hand #225904210671: {Club #4781089}  Hold'em No Limit (50/100) - 2021/04/17 0:19:09 EET [2021/04/16 17:19:09 ET]
Table 'NLHE Session 2' 2-max (Play Money) Seat #1 is the button
Seat 1: FDIBA2009 (17369 in chips) 
Seat 2: s70n3fac3 (19167 in chips) 
FDIBA2009: posts small blind 50
s70n3fac3: posts big blind 100
*** HOLE CARDS ***
FDIBA2009: raises 100 to 200
s70n3fac3: raises 300 to 500
FDIBA2009: calls 300
*** FLOP *** [Js Kc 2d]
s70n3fac3: checks 
FDIBA2009: checks 
*** TURN *** [Js Kc 2d] [Ac]
s70n3fac3: bets 500
FDIBA2009: calls 500
*** RIVER *** [Js Kc 2d Ac] [6h]
s70n3fac3: bets 800
FDIBA2009: raises 1400 to 2200
s70n3fac3: calls 1400
*** SHOW DOWN ***
FDIBA2009: shows [Ks 2s] (two pair, Kings and Deuces)
s70n3fac3: mucks hand 
FDIBA2009 collected 6048 from pot
*** SUMMARY ***
Total pot 6400 | Rake 352 
Board [Js Kc 2d Ac 6h]
Seat 1: FDIBA2009 (button) (small blind) showed [Ks 2s] and won (6048) with two pair, Kings and Deuces
Seat 2: s70n3fac3 (big blind) mucked [Th Ah]



PokerStars Home Game Hand #225904233498: {Club #4781089}  Hold'em No Limit (50/100) - 2021/04/17 0:19:41 EET [2021/04/16 17:19:41 ET]
Table 'NLHE Session 2' 2-max (Play Money) Seat #2 is the button
Seat 1: FDIBA2009 (20217 in chips) 
Seat 2: s70n3fac3 (15967 in chips) 
s70n3fac3: posts small blind 50
FDIBA2009: posts big blind 100
*** HOLE CARDS ***
s70n3fac3: raises 150 to 250
FDIBA2009: raises 250 to 500
s70n3fac3: calls 250
*** FLOP *** [Qc 4s Jc]
FDIBA2009: checks 
s70n3fac3: checks 
*** TURN *** [Qc 4s Jc] [3c]
FDIBA2009: checks 
s70n3fac3: checks 
*** RIVER *** [Qc 4s Jc 3c] [3h]
FDIBA2009: bets 300
s70n3fac3: raises 1000 to 1300
FDIBA2009: calls 1000
*** SHOW DOWN ***
s70n3fac3: shows [Ac 9c] (a flush, Ace high)
FDIBA2009: mucks hand 
s70n3fac3 collected 3402 from pot
*** SUMMARY ***
Total pot 3600 | Rake 198 
Board [Qc 4s Jc 3c 3h]
Seat 1: FDIBA2009 (big blind) mucked [7s 7c]
Seat 2: s70n3fac3 (button) (small blind) showed [Ac 9c] and won (3402) with a flush, Ace high



PokerStars Home Game Hand #225904264445: {Club #4781089}  Hold'em No Limit (50/100) - 2021/04/17 0:20:25 EET [2021/04/16 17:20:25 ET]
Table 'NLHE Session 2' 2-max (Play Money) Seat #1 is the button
Seat 1: FDIBA2009 (18417 in chips) 
Seat 2: s70n3fac3 (17569 in chips) 
FDIBA2009: posts small blind 50
s70n3fac3: posts big blind 100
*** HOLE CARDS ***
FDIBA2009: folds 
Uncalled bet (50) returned to s70n3fac3
s70n3fac3 collected 100 from pot
s70n3fac3: doesn't show hand 
*** SUMMARY ***
Total pot 100 | Rake 0 
Seat 1: FDIBA2009 (button) (small blind) folded before Flop
Seat 2: s70n3fac3 (big blind) collected (100)



PokerStars Home Game Hand #225904268125: {Club #4781089}  Hold'em No Limit (50/100) - 2021/04/17 0:20:30 EET [2021/04/16 17:20:30 ET]
Table 'NLHE Session 2' 2-max (Play Money) Seat #2 is the button
Seat 1: FDIBA2009 (18367 in chips) 
Seat 2: s70n3fac3 (17619 in chips) 
s70n3fac3: posts small blind 50
FDIBA2009: posts big blind 100
*** HOLE CARDS ***
s70n3fac3: raises 200 to 300
FDIBA2009: calls 200
*** FLOP *** [7s 2c 6d]
FDIBA2009: checks 
s70n3fac3: checks 
*** TURN *** [7s 2c 6d] [Js]
FDIBA2009: bets 300
s70n3fac3: calls 300
*** RIVER *** [7s 2c 6d Js] [5h]
FDIBA2009: checks 
s70n3fac3: checks 
*** SHOW DOWN ***
FDIBA2009: shows [9h 7d] (a pair of Sevens)
s70n3fac3: mucks hand 
FDIBA2009 collected 1134 from pot
*** SUMMARY ***
Total pot 1200 | Rake 66 
Board [7s 2c 6d Js 5h]
Seat 1: FDIBA2009 (big blind) showed [9h 7d] and won (1134) with a pair of Sevens
Seat 2: s70n3fac3 (button) (small blind) mucked [Ts Ks]



PokerStars Home Game Hand #225904288131: {Club #4781089}  Hold'em No Limit (50/100) - 2021/04/17 0:20:59 EET [2021/04/16 17:20:59 ET]
Table 'NLHE Session 2' 2-max (Play Money) Seat #1 is the button
Seat 1: FDIBA2009 (18901 in chips) 
Seat 2: s70n3fac3 (17019 in chips) 
FDIBA2009: posts small blind 50
s70n3fac3: posts big blind 100
*** HOLE CARDS ***
FDIBA2009: raises 100 to 200
s70n3fac3: calls 100
*** FLOP *** [8d Kc Ts]
s70n3fac3: checks 
FDIBA2009: checks 
*** TURN *** [8d Kc Ts] [6d]
s70n3fac3: bets 200
FDIBA2009: calls 200
*** RIVER *** [8d Kc Ts 6d] [4h]
s70n3fac3: checks 
FDIBA2009: bets 600
s70n3fac3: calls 600
*** SHOW DOWN ***
FDIBA2009: shows [7h Qh] (high card King)
s70n3fac3: shows [5h 6h] (a pair of Sixes)
s70n3fac3 collected 1890 from pot
*** SUMMARY ***
Total pot 2000 | Rake 110 
Board [8d Kc Ts 6d 4h]
Seat 1: FDIBA2009 (button) (small blind) showed [7h Qh] and lost with high card King
Seat 2: s70n3fac3 (big blind) showed [5h 6h] and won (1890) with a pair of Sixes



PokerStars Home Game Hand #225904305075: {Club #4781089}  Hold'em No Limit (50/100) - 2021/04/17 0:21:23 EET [2021/04/16 17:21:23 ET]
Table 'NLHE Session 2' 2-max (Play Money) Seat #2 is the button
Seat 1: FDIBA2009 (17901 in chips) 
Seat 2: s70n3fac3 (17909 in chips) 
s70n3fac3: posts small blind 50
FDIBA2009: posts big blind 100
*** HOLE CARDS ***
s70n3fac3: raises 150 to 250
FDIBA2009: calls 150
*** FLOP *** [4s 7s 6h]
FDIBA2009: bets 472
s70n3fac3: calls 472
*** TURN *** [4s 7s 6h] [2s]
FDIBA2009: bets 1000
s70n3fac3: calls 1000
*** RIVER *** [4s 7s 6h 2s] [Qd]
FDIBA2009: checks 
s70n3fac3: bets 2225
FDIBA2009: calls 2225
*** SHOW DOWN ***
s70n3fac3: shows [As Qs] (a flush, Ace high)
FDIBA2009: mucks hand 
s70n3fac3 collected 7460 from pot
*** SUMMARY ***
Total pot 7894 | Rake 434 
Board [4s 7s 6h 2s Qd]
Seat 1: FDIBA2009 (big blind) mucked [7c Ts]
Seat 2: s70n3fac3 (button) (small blind) showed [As Qs] and won (7460) with a flush, Ace high



PokerStars Home Game Hand #225904343113: {Club #4781089}  Hold'em No Limit (50/100) - 2021/04/17 0:22:18 EET [2021/04/16 17:22:18 ET]
Table 'NLHE Session 2' 2-max (Play Money) Seat #1 is the button
Seat 1: FDIBA2009 (13954 in chips) 
Seat 2: s70n3fac3 (21422 in chips) 
FDIBA2009: posts small blind 50
s70n3fac3: posts big blind 100
*** HOLE CARDS ***
FDIBA2009: raises 1700 to 1800
s70n3fac3: raises 19622 to 21422 and is all-in
FDIBA2009: calls 12154 and is all-in
Uncalled bet (7468) returned to s70n3fac3
*** FLOP *** [2c 4h 4c]
*** TURN *** [2c 4h 4c] [Ac]
*** RIVER *** [2c 4h 4c Ac] [5s]
*** SHOW DOWN ***
s70n3fac3: shows [Kh As] (two pair, Aces and Fours)
FDIBA2009: shows [Qs Kc] (a pair of Fours)
s70n3fac3 collected 26373 from pot
*** SUMMARY ***
Total pot 27908 | Rake 1535 
Board [2c 4h 4c Ac 5s]
Seat 1: FDIBA2009 (button) (small blind) showed [Qs Kc] and lost with a pair of Fours
Seat 2: s70n3fac3 (big blind) showed [Kh As] and won (26373) with two pair, Aces and Fours



