PokerStars Home Game Hand #227557919833: {Club #4781089}  Hold'em No Limit (50/100) - 2021/06/13 23:02:03 EET [2021/06/13 16:02:03 ET]
Table 'VTTP 1306' 2-max (Play Money) Seat #1 is the button
Seat 1: s70n3fac3 (10000 in chips) 
Seat 2: FDIBA2009 (10000 in chips) 
s70n3fac3: posts small blind 50
FDIBA2009: posts big blind 100
*** HOLE CARDS ***
s70n3fac3: calls 50
FDIBA2009: checks 
*** FLOP *** [7s Kd 3s]
FDIBA2009: checks 
s70n3fac3: bets 200
FDIBA2009: calls 200
*** TURN *** [7s Kd 3s] [6s]
FDIBA2009: checks 
s70n3fac3: bets 300
FDIBA2009: calls 300
*** RIVER *** [7s Kd 3s 6s] [8h]
FDIBA2009: checks 
s70n3fac3: checks 
*** SHOW DOWN ***
FDIBA2009: shows [Kc 4h] (a pair of Kings)
s70n3fac3: mucks hand 
FDIBA2009 collected 1134 from pot
*** SUMMARY ***
Total pot 1200 | Rake 66 
Board [7s Kd 3s 6s 8h]
Seat 1: s70n3fac3 (button) (small blind) mucked [Ts 7d]
Seat 2: FDIBA2009 (big blind) showed [Kc 4h] and won (1134) with a pair of Kings



PokerStars Home Game Hand #227557942814: {Club #4781089}  Hold'em No Limit (50/100) - 2021/06/13 23:02:40 EET [2021/06/13 16:02:40 ET]
Table 'VTTP 1306' 2-max (Play Money) Seat #2 is the button
Seat 1: s70n3fac3 (9400 in chips) 
Seat 2: FDIBA2009 (10534 in chips) 
FDIBA2009: posts small blind 50
s70n3fac3: posts big blind 100
*** HOLE CARDS ***
FDIBA2009: raises 250 to 350
s70n3fac3: calls 250
*** FLOP *** [Js Jh Td]
s70n3fac3: checks 
FDIBA2009: bets 450
s70n3fac3: folds 
Uncalled bet (450) returned to FDIBA2009
FDIBA2009 collected 661 from pot
FDIBA2009: doesn't show hand 
*** SUMMARY ***
Total pot 700 | Rake 39 
Board [Js Jh Td]
Seat 1: s70n3fac3 (big blind) folded on the Flop
Seat 2: FDIBA2009 (button) (small blind) collected (661)



PokerStars Home Game Hand #227557951464: {Club #4781089}  Hold'em No Limit (50/100) - 2021/06/13 23:02:58 EET [2021/06/13 16:02:58 ET]
Table 'VTTP 1306' 2-max (Play Money) Seat #1 is the button
Seat 1: s70n3fac3 (9050 in chips) 
Seat 2: FDIBA2009 (10845 in chips) 
s70n3fac3: posts small blind 50
FDIBA2009: posts big blind 100
*** HOLE CARDS ***
s70n3fac3: calls 50
FDIBA2009: checks 
*** FLOP *** [6s 9s Ac]
FDIBA2009: checks 
s70n3fac3: checks 
*** TURN *** [6s 9s Ac] [7h]
FDIBA2009: checks 
s70n3fac3: bets 200
FDIBA2009: calls 200
*** RIVER *** [6s 9s Ac 7h] [Jh]
FDIBA2009: checks 
s70n3fac3: checks 
*** SHOW DOWN ***
FDIBA2009: shows [3s 9c] (a pair of Nines)
s70n3fac3: mucks hand 
FDIBA2009 collected 567 from pot
*** SUMMARY ***
Total pot 600 | Rake 33 
Board [6s 9s Ac 7h Jh]
Seat 1: s70n3fac3 (button) (small blind) mucked [4c 3d]
Seat 2: FDIBA2009 (big blind) showed [3s 9c] and won (567) with a pair of Nines



PokerStars Home Game Hand #227557961506: {Club #4781089}  Hold'em No Limit (50/100) - 2021/06/13 23:03:17 EET [2021/06/13 16:03:17 ET]
Table 'VTTP 1306' 2-max (Play Money) Seat #2 is the button
Seat 1: s70n3fac3 (8750 in chips) 
Seat 2: FDIBA2009 (11112 in chips) 
FDIBA2009: posts small blind 50
s70n3fac3: posts big blind 100
*** HOLE CARDS ***
FDIBA2009: raises 150 to 250
s70n3fac3: calls 150
*** FLOP *** [Qs 3h Tc]
s70n3fac3: checks 
FDIBA2009: checks 
*** TURN *** [Qs 3h Tc] [8h]
s70n3fac3: checks 
FDIBA2009: bets 300
s70n3fac3: calls 300
*** RIVER *** [Qs 3h Tc 8h] [3s]
s70n3fac3: checks 
FDIBA2009: checks 
*** SHOW DOWN ***
s70n3fac3: shows [9s 6h] (a pair of Threes)
FDIBA2009: shows [4s Ks] (a pair of Threes - King kicker)
FDIBA2009 collected 1039 from pot
*** SUMMARY ***
Total pot 1100 | Rake 61 
Board [Qs 3h Tc 8h 3s]
Seat 1: s70n3fac3 (big blind) showed [9s 6h] and lost with a pair of Threes
Seat 2: FDIBA2009 (button) (small blind) showed [4s Ks] and won (1039) with a pair of Threes



PokerStars Home Game Hand #227557973143: {Club #4781089}  Hold'em No Limit (50/100) - 2021/06/13 23:03:39 EET [2021/06/13 16:03:39 ET]
Table 'VTTP 1306' 2-max (Play Money) Seat #1 is the button
Seat 1: s70n3fac3 (8200 in chips) 
Seat 2: FDIBA2009 (11601 in chips) 
s70n3fac3: posts small blind 50
FDIBA2009: posts big blind 100
*** HOLE CARDS ***
s70n3fac3: folds 
Uncalled bet (50) returned to FDIBA2009
FDIBA2009 collected 100 from pot
FDIBA2009: doesn't show hand 
*** SUMMARY ***
Total pot 100 | Rake 0 
Seat 1: s70n3fac3 (button) (small blind) folded before Flop
Seat 2: FDIBA2009 (big blind) collected (100)



PokerStars Home Game Hand #227557975476: {Club #4781089}  Hold'em No Limit (50/100) - 2021/06/13 23:03:43 EET [2021/06/13 16:03:43 ET]
Table 'VTTP 1306' 2-max (Play Money) Seat #2 is the button
Seat 1: s70n3fac3 (8150 in chips) 
Seat 2: FDIBA2009 (11651 in chips) 
FDIBA2009: posts small blind 50
s70n3fac3: posts big blind 100
*** HOLE CARDS ***
FDIBA2009: raises 200 to 300
s70n3fac3: folds 
Uncalled bet (200) returned to FDIBA2009
FDIBA2009 collected 200 from pot
FDIBA2009: doesn't show hand 
*** SUMMARY ***
Total pot 200 | Rake 0 
Seat 1: s70n3fac3 (big blind) folded before Flop
Seat 2: FDIBA2009 (button) (small blind) collected (200)



PokerStars Home Game Hand #227557979432: {Club #4781089}  Hold'em No Limit (50/100) - 2021/06/13 23:03:51 EET [2021/06/13 16:03:51 ET]
Table 'VTTP 1306' 2-max (Play Money) Seat #1 is the button
Seat 1: s70n3fac3 (8050 in chips) 
Seat 2: FDIBA2009 (11751 in chips) 
s70n3fac3: posts small blind 50
FDIBA2009: posts big blind 100
*** HOLE CARDS ***
s70n3fac3: raises 150 to 250
FDIBA2009: calls 150
*** FLOP *** [Jh 8c 2c]
FDIBA2009: checks 
s70n3fac3: checks 
*** TURN *** [Jh 8c 2c] [2s]
FDIBA2009: checks 
s70n3fac3: bets 300
FDIBA2009: folds 
Uncalled bet (300) returned to s70n3fac3
s70n3fac3 collected 472 from pot
s70n3fac3: doesn't show hand 
*** SUMMARY ***
Total pot 500 | Rake 28 
Board [Jh 8c 2c 2s]
Seat 1: s70n3fac3 (button) (small blind) collected (472)
Seat 2: FDIBA2009 (big blind) folded on the Turn



PokerStars Home Game Hand #227557988222: {Club #4781089}  Hold'em No Limit (50/100) - 2021/06/13 23:04:07 EET [2021/06/13 16:04:07 ET]
Table 'VTTP 1306' 2-max (Play Money) Seat #2 is the button
Seat 1: s70n3fac3 (8272 in chips) 
Seat 2: FDIBA2009 (11501 in chips) 
FDIBA2009: posts small blind 50
s70n3fac3: posts big blind 100
*** HOLE CARDS ***
FDIBA2009: folds 
Uncalled bet (50) returned to s70n3fac3
s70n3fac3 collected 100 from pot
s70n3fac3: doesn't show hand 
*** SUMMARY ***
Total pot 100 | Rake 0 
Seat 1: s70n3fac3 (big blind) collected (100)
Seat 2: FDIBA2009 (button) (small blind) folded before Flop



PokerStars Home Game Hand #227557990697: {Club #4781089}  Hold'em No Limit (50/100) - 2021/06/13 23:04:12 EET [2021/06/13 16:04:12 ET]
Table 'VTTP 1306' 2-max (Play Money) Seat #1 is the button
Seat 1: s70n3fac3 (8322 in chips) 
Seat 2: FDIBA2009 (11451 in chips) 
s70n3fac3: posts small blind 50
FDIBA2009: posts big blind 100
*** HOLE CARDS ***
s70n3fac3: folds 
Uncalled bet (50) returned to FDIBA2009
FDIBA2009 collected 100 from pot
FDIBA2009: doesn't show hand 
*** SUMMARY ***
Total pot 100 | Rake 0 
Seat 1: s70n3fac3 (button) (small blind) folded before Flop
Seat 2: FDIBA2009 (big blind) collected (100)



PokerStars Home Game Hand #227557992944: {Club #4781089}  Hold'em No Limit (50/100) - 2021/06/13 23:04:16 EET [2021/06/13 16:04:16 ET]
Table 'VTTP 1306' 2-max (Play Money) Seat #2 is the button
Seat 1: s70n3fac3 (8272 in chips) 
Seat 2: FDIBA2009 (11501 in chips) 
FDIBA2009: posts small blind 50
s70n3fac3: posts big blind 100
*** HOLE CARDS ***
FDIBA2009: raises 200 to 300
s70n3fac3: folds 
Uncalled bet (200) returned to FDIBA2009
FDIBA2009 collected 200 from pot
FDIBA2009: doesn't show hand 
*** SUMMARY ***
Total pot 200 | Rake 0 
Seat 1: s70n3fac3 (big blind) folded before Flop
Seat 2: FDIBA2009 (button) (small blind) collected (200)



PokerStars Home Game Hand #227557996788: {Club #4781089}  Hold'em No Limit (50/100) - 2021/06/13 23:04:23 EET [2021/06/13 16:04:23 ET]
Table 'VTTP 1306' 2-max (Play Money) Seat #1 is the button
Seat 1: s70n3fac3 (8172 in chips) 
Seat 2: FDIBA2009 (11601 in chips) 
s70n3fac3: posts small blind 50
FDIBA2009: posts big blind 100
*** HOLE CARDS ***
s70n3fac3: raises 200 to 300
FDIBA2009: calls 200
*** FLOP *** [7c Kc Kd]
FDIBA2009: checks 
s70n3fac3: bets 350
FDIBA2009: raises 350 to 700
s70n3fac3: calls 350
*** TURN *** [7c Kc Kd] [5d]
FDIBA2009: bets 700
s70n3fac3: calls 700
*** RIVER *** [7c Kc Kd 5d] [Qh]
FDIBA2009: bets 1750
s70n3fac3: folds 
Uncalled bet (1750) returned to FDIBA2009
FDIBA2009 collected 3213 from pot
FDIBA2009: doesn't show hand 
*** SUMMARY ***
Total pot 3400 | Rake 187 
Board [7c Kc Kd 5d Qh]
Seat 1: s70n3fac3 (button) (small blind) folded on the River
Seat 2: FDIBA2009 (big blind) collected (3213)



PokerStars Home Game Hand #227558025238: {Club #4781089}  Hold'em No Limit (50/100) - 2021/06/13 23:05:17 EET [2021/06/13 16:05:17 ET]
Table 'VTTP 1306' 2-max (Play Money) Seat #2 is the button
Seat 1: s70n3fac3 (6472 in chips) 
Seat 2: FDIBA2009 (13114 in chips) 
FDIBA2009: posts small blind 50
s70n3fac3: posts big blind 100
*** HOLE CARDS ***
FDIBA2009: raises 200 to 300
s70n3fac3: raises 600 to 900
FDIBA2009: calls 600
*** FLOP *** [9d Ts 7d]
s70n3fac3: bets 900
FDIBA2009: raises 11314 to 12214 and is all-in
s70n3fac3: calls 4672 and is all-in
Uncalled bet (6642) returned to FDIBA2009
*** TURN *** [9d Ts 7d] [7s]
*** RIVER *** [9d Ts 7d 7s] [2s]
*** SHOW DOWN ***
s70n3fac3: shows [9s 9c] (a full house, Nines full of Sevens)
FDIBA2009: shows [8s 8d] (two pair, Eights and Sevens)
s70n3fac3 collected 12232 from pot
*** SUMMARY ***
Total pot 12944 | Rake 712 
Board [9d Ts 7d 7s 2s]
Seat 1: s70n3fac3 (big blind) showed [9s 9c] and won (12232) with a full house, Nines full of Sevens
Seat 2: FDIBA2009 (button) (small blind) showed [8s 8d] and lost with two pair, Eights and Sevens



PokerStars Home Game Hand #227558039684: {Club #4781089}  Hold'em No Limit (50/100) - 2021/06/13 23:05:44 EET [2021/06/13 16:05:44 ET]
Table 'VTTP 1306' 2-max (Play Money) Seat #1 is the button
Seat 1: s70n3fac3 (12232 in chips) 
Seat 2: FDIBA2009 (6642 in chips) 
s70n3fac3: posts small blind 50
FDIBA2009: posts big blind 100
*** HOLE CARDS ***
s70n3fac3: calls 50
FDIBA2009: checks 
*** FLOP *** [8s 5s Th]
FDIBA2009: checks 
s70n3fac3: bets 200
FDIBA2009: calls 200
*** TURN *** [8s 5s Th] [6h]
FDIBA2009: checks 
s70n3fac3: bets 600
FDIBA2009: folds 
Uncalled bet (600) returned to s70n3fac3
s70n3fac3 collected 567 from pot
s70n3fac3: doesn't show hand 
*** SUMMARY ***
Total pot 600 | Rake 33 
Board [8s 5s Th 6h]
Seat 1: s70n3fac3 (button) (small blind) collected (567)
Seat 2: FDIBA2009 (big blind) folded on the Turn



PokerStars Home Game Hand #227558051186: {Club #4781089}  Hold'em No Limit (50/100) - 2021/06/13 23:06:06 EET [2021/06/13 16:06:06 ET]
Table 'VTTP 1306' 2-max (Play Money) Seat #2 is the button
Seat 1: s70n3fac3 (12499 in chips) 
Seat 2: FDIBA2009 (6342 in chips) 
FDIBA2009: posts small blind 50
s70n3fac3: posts big blind 100
*** HOLE CARDS ***
FDIBA2009: folds 
Uncalled bet (50) returned to s70n3fac3
s70n3fac3 collected 100 from pot
s70n3fac3: doesn't show hand 
*** SUMMARY ***
Total pot 100 | Rake 0 
Seat 1: s70n3fac3 (big blind) collected (100)
Seat 2: FDIBA2009 (button) (small blind) folded before Flop



PokerStars Home Game Hand #227558053889: {Club #4781089}  Hold'em No Limit (50/100) - 2021/06/13 23:06:11 EET [2021/06/13 16:06:11 ET]
Table 'VTTP 1306' 2-max (Play Money) Seat #1 is the button
Seat 1: s70n3fac3 (12549 in chips) 
Seat 2: FDIBA2009 (6292 in chips) 
s70n3fac3: posts small blind 50
FDIBA2009: posts big blind 100
*** HOLE CARDS ***
s70n3fac3: folds 
Uncalled bet (50) returned to FDIBA2009
FDIBA2009 collected 100 from pot
FDIBA2009: doesn't show hand 
*** SUMMARY ***
Total pot 100 | Rake 0 
Seat 1: s70n3fac3 (button) (small blind) folded before Flop
Seat 2: FDIBA2009 (big blind) collected (100)



PokerStars Home Game Hand #227558056082: {Club #4781089}  Hold'em No Limit (50/100) - 2021/06/13 23:06:15 EET [2021/06/13 16:06:15 ET]
Table 'VTTP 1306' 2-max (Play Money) Seat #2 is the button
Seat 1: s70n3fac3 (12499 in chips) 
Seat 2: FDIBA2009 (6342 in chips) 
FDIBA2009: posts small blind 50
s70n3fac3: posts big blind 100
*** HOLE CARDS ***
FDIBA2009: raises 100 to 200
s70n3fac3: calls 100
*** FLOP *** [7c Jc 9d]
s70n3fac3: checks 
FDIBA2009: bets 189
s70n3fac3: calls 189
*** TURN *** [7c Jc 9d] [Ts]
s70n3fac3: checks 
FDIBA2009: checks 
*** RIVER *** [7c Jc 9d Ts] [2h]
s70n3fac3: bets 500
FDIBA2009: folds 
Uncalled bet (500) returned to s70n3fac3
s70n3fac3 collected 735 from pot
s70n3fac3: doesn't show hand 
*** SUMMARY ***
Total pot 778 | Rake 43 
Board [7c Jc 9d Ts 2h]
Seat 1: s70n3fac3 (big blind) collected (735)
Seat 2: FDIBA2009 (button) (small blind) folded on the River



PokerStars Home Game Hand #227558068625: {Club #4781089}  Hold'em No Limit (50/100) - 2021/06/13 23:06:38 EET [2021/06/13 16:06:38 ET]
Table 'VTTP 1306' 2-max (Play Money) Seat #1 is the button
Seat 1: s70n3fac3 (12845 in chips) 
Seat 2: FDIBA2009 (5953 in chips) 
s70n3fac3: posts small blind 50
FDIBA2009: posts big blind 100
*** HOLE CARDS ***
s70n3fac3: raises 150 to 250
FDIBA2009: calls 150
*** FLOP *** [7h 6d 5d]
FDIBA2009: checks 
s70n3fac3: checks 
*** TURN *** [7h 6d 5d] [4d]
FDIBA2009: checks 
s70n3fac3: checks 
*** RIVER *** [7h 6d 5d 4d] [As]
FDIBA2009: checks 
s70n3fac3: checks 
*** SHOW DOWN ***
FDIBA2009: shows [Ks Qh] (high card Ace)
s70n3fac3: mucks hand 
FDIBA2009 collected 472 from pot
*** SUMMARY ***
Total pot 500 | Rake 28 
Board [7h 6d 5d 4d As]
Seat 1: s70n3fac3 (button) (small blind) mucked [Td Kh]
Seat 2: FDIBA2009 (big blind) showed [Ks Qh] and won (472) with high card Ace



PokerStars Home Game Hand #227558079272: {Club #4781089}  Hold'em No Limit (50/100) - 2021/06/13 23:06:59 EET [2021/06/13 16:06:59 ET]
Table 'VTTP 1306' 2-max (Play Money) Seat #2 is the button
Seat 1: s70n3fac3 (12595 in chips) 
Seat 2: FDIBA2009 (6175 in chips) 
FDIBA2009: posts small blind 50
s70n3fac3: posts big blind 100
*** HOLE CARDS ***
FDIBA2009: raises 200 to 300
s70n3fac3: folds 
Uncalled bet (200) returned to FDIBA2009
FDIBA2009 collected 200 from pot
FDIBA2009: doesn't show hand 
*** SUMMARY ***
Total pot 200 | Rake 0 
Seat 1: s70n3fac3 (big blind) folded before Flop
Seat 2: FDIBA2009 (button) (small blind) collected (200)



PokerStars Home Game Hand #227558083386: {Club #4781089}  Hold'em No Limit (50/100) - 2021/06/13 23:07:06 EET [2021/06/13 16:07:06 ET]
Table 'VTTP 1306' 2-max (Play Money) Seat #1 is the button
Seat 1: s70n3fac3 (12495 in chips) 
Seat 2: FDIBA2009 (6275 in chips) 
s70n3fac3: posts small blind 50
FDIBA2009: posts big blind 100
*** HOLE CARDS ***
s70n3fac3: raises 150 to 250
FDIBA2009: raises 500 to 750
s70n3fac3: folds 
Uncalled bet (500) returned to FDIBA2009
FDIBA2009 collected 500 from pot
FDIBA2009: doesn't show hand 
*** SUMMARY ***
Total pot 500 | Rake 0 
Seat 1: s70n3fac3 (button) (small blind) folded before Flop
Seat 2: FDIBA2009 (big blind) collected (500)



PokerStars Home Game Hand #227558088130: {Club #4781089}  Hold'em No Limit (50/100) - 2021/06/13 23:07:15 EET [2021/06/13 16:07:15 ET]
Table 'VTTP 1306' 2-max (Play Money) Seat #2 is the button
Seat 1: s70n3fac3 (12245 in chips) 
Seat 2: FDIBA2009 (6525 in chips) 
FDIBA2009: posts small blind 50
s70n3fac3: posts big blind 100
*** HOLE CARDS ***
FDIBA2009: raises 100 to 200
s70n3fac3: calls 100
*** FLOP *** [2c Jc 5c]
s70n3fac3: checks 
FDIBA2009: checks 
*** TURN *** [2c Jc 5c] [5h]
s70n3fac3: checks 
FDIBA2009: checks 
*** RIVER *** [2c Jc 5c 5h] [Kh]
s70n3fac3: checks 
FDIBA2009: bets 400
s70n3fac3: folds 
Uncalled bet (400) returned to FDIBA2009
FDIBA2009 collected 378 from pot
FDIBA2009: doesn't show hand 
*** SUMMARY ***
Total pot 400 | Rake 22 
Board [2c Jc 5c 5h Kh]
Seat 1: s70n3fac3 (big blind) folded on the River
Seat 2: FDIBA2009 (button) (small blind) collected (378)



PokerStars Home Game Hand #227558099680: {Club #4781089}  Hold'em No Limit (50/100) - 2021/06/13 23:07:37 EET [2021/06/13 16:07:37 ET]
Table 'VTTP 1306' 2-max (Play Money) Seat #1 is the button
Seat 1: s70n3fac3 (12045 in chips) 
Seat 2: FDIBA2009 (6703 in chips) 
s70n3fac3: posts small blind 50
FDIBA2009: posts big blind 100
*** HOLE CARDS ***
s70n3fac3: folds 
Uncalled bet (50) returned to FDIBA2009
FDIBA2009 collected 100 from pot
FDIBA2009: doesn't show hand 
*** SUMMARY ***
Total pot 100 | Rake 0 
Seat 1: s70n3fac3 (button) (small blind) folded before Flop
Seat 2: FDIBA2009 (big blind) collected (100)



PokerStars Home Game Hand #227558101766: {Club #4781089}  Hold'em No Limit (50/100) - 2021/06/13 23:07:41 EET [2021/06/13 16:07:41 ET]
Table 'VTTP 1306' 2-max (Play Money) Seat #2 is the button
Seat 1: s70n3fac3 (11995 in chips) 
Seat 2: FDIBA2009 (6753 in chips) 
FDIBA2009: posts small blind 50
s70n3fac3: posts big blind 100
*** HOLE CARDS ***
FDIBA2009: raises 200 to 300
s70n3fac3: calls 200
*** FLOP *** [Kc 4d Js]
s70n3fac3: checks 
FDIBA2009: bets 300
s70n3fac3: folds 
Uncalled bet (300) returned to FDIBA2009
FDIBA2009 collected 567 from pot
FDIBA2009: doesn't show hand 
*** SUMMARY ***
Total pot 600 | Rake 33 
Board [Kc 4d Js]
Seat 1: s70n3fac3 (big blind) folded on the Flop
Seat 2: FDIBA2009 (button) (small blind) collected (567)



PokerStars Home Game Hand #227558110197: {Club #4781089}  Hold'em No Limit (50/100) - 2021/06/13 23:07:57 EET [2021/06/13 16:07:57 ET]
Table 'VTTP 1306' 2-max (Play Money) Seat #1 is the button
Seat 1: s70n3fac3 (11695 in chips) 
Seat 2: FDIBA2009 (7020 in chips) 
s70n3fac3: posts small blind 50
FDIBA2009: posts big blind 100
*** HOLE CARDS ***
s70n3fac3: folds 
Uncalled bet (50) returned to FDIBA2009
FDIBA2009 collected 100 from pot
FDIBA2009: doesn't show hand 
*** SUMMARY ***
Total pot 100 | Rake 0 
Seat 1: s70n3fac3 (button) (small blind) folded before Flop
Seat 2: FDIBA2009 (big blind) collected (100)



PokerStars Home Game Hand #227558112231: {Club #4781089}  Hold'em No Limit (50/100) - 2021/06/13 23:08:01 EET [2021/06/13 16:08:01 ET]
Table 'VTTP 1306' 2-max (Play Money) Seat #2 is the button
Seat 1: s70n3fac3 (11645 in chips) 
Seat 2: FDIBA2009 (7070 in chips) 
FDIBA2009: posts small blind 50
s70n3fac3: posts big blind 100
*** HOLE CARDS ***
FDIBA2009: raises 100 to 200
s70n3fac3: raises 500 to 700
FDIBA2009: folds 
Uncalled bet (500) returned to s70n3fac3
s70n3fac3 collected 400 from pot
s70n3fac3: doesn't show hand 
*** SUMMARY ***
Total pot 400 | Rake 0 
Seat 1: s70n3fac3 (big blind) collected (400)
Seat 2: FDIBA2009 (button) (small blind) folded before Flop



PokerStars Home Game Hand #227558118508: {Club #4781089}  Hold'em No Limit (50/100) - 2021/06/13 23:08:12 EET [2021/06/13 16:08:12 ET]
Table 'VTTP 1306' 2-max (Play Money) Seat #1 is the button
Seat 1: s70n3fac3 (11845 in chips) 
Seat 2: FDIBA2009 (6870 in chips) 
s70n3fac3: posts small blind 50
FDIBA2009: posts big blind 100
*** HOLE CARDS ***
s70n3fac3: raises 150 to 250
FDIBA2009: raises 500 to 750
s70n3fac3: calls 500
*** FLOP *** [5h 6h 6d]
FDIBA2009: bets 850
s70n3fac3: folds 
Uncalled bet (850) returned to FDIBA2009
FDIBA2009 collected 1417 from pot
FDIBA2009: doesn't show hand 
*** SUMMARY ***
Total pot 1500 | Rake 83 
Board [5h 6h 6d]
Seat 1: s70n3fac3 (button) (small blind) folded on the Flop
Seat 2: FDIBA2009 (big blind) collected (1417)



PokerStars Home Game Hand #227558128204: {Club #4781089}  Hold'em No Limit (50/100) - 2021/06/13 23:08:31 EET [2021/06/13 16:08:31 ET]
Table 'VTTP 1306' 2-max (Play Money) Seat #2 is the button
Seat 1: s70n3fac3 (11095 in chips) 
Seat 2: FDIBA2009 (7537 in chips) 
FDIBA2009: posts small blind 50
s70n3fac3: posts big blind 100
*** HOLE CARDS ***
FDIBA2009: raises 200 to 300
s70n3fac3: folds 
Uncalled bet (200) returned to FDIBA2009
FDIBA2009 collected 200 from pot
FDIBA2009: doesn't show hand 
*** SUMMARY ***
Total pot 200 | Rake 0 
Seat 1: s70n3fac3 (big blind) folded before Flop
Seat 2: FDIBA2009 (button) (small blind) collected (200)



PokerStars Home Game Hand #227558132761: {Club #4781089}  Hold'em No Limit (50/100) - 2021/06/13 23:08:39 EET [2021/06/13 16:08:39 ET]
Table 'VTTP 1306' 2-max (Play Money) Seat #1 is the button
Seat 1: s70n3fac3 (10995 in chips) 
Seat 2: FDIBA2009 (7637 in chips) 
s70n3fac3: posts small blind 50
FDIBA2009: posts big blind 100
*** HOLE CARDS ***
s70n3fac3: raises 100 to 200
FDIBA2009: calls 100
*** FLOP *** [Jh 2h 9d]
FDIBA2009: checks 
s70n3fac3: bets 200
FDIBA2009: calls 200
*** TURN *** [Jh 2h 9d] [Ts]
FDIBA2009: checks 
s70n3fac3: checks 
*** RIVER *** [Jh 2h 9d Ts] [As]
FDIBA2009: checks 
s70n3fac3: checks 
*** SHOW DOWN ***
FDIBA2009: shows [4c Js] (a pair of Jacks)
s70n3fac3: mucks hand 
FDIBA2009 collected 756 from pot
*** SUMMARY ***
Total pot 800 | Rake 44 
Board [Jh 2h 9d Ts As]
Seat 1: s70n3fac3 (button) (small blind) mucked [2c Kh]
Seat 2: FDIBA2009 (big blind) showed [4c Js] and won (756) with a pair of Jacks



PokerStars Home Game Hand #227558144214: {Club #4781089}  Hold'em No Limit (50/100) - 2021/06/13 23:09:01 EET [2021/06/13 16:09:01 ET]
Table 'VTTP 1306' 2-max (Play Money) Seat #2 is the button
Seat 1: s70n3fac3 (10595 in chips) 
Seat 2: FDIBA2009 (7993 in chips) 
FDIBA2009: posts small blind 50
s70n3fac3: posts big blind 100
*** HOLE CARDS ***
FDIBA2009: raises 100 to 200
s70n3fac3: folds 
Uncalled bet (100) returned to FDIBA2009
FDIBA2009 collected 200 from pot
FDIBA2009: doesn't show hand 
*** SUMMARY ***
Total pot 200 | Rake 0 
Seat 1: s70n3fac3 (big blind) folded before Flop
Seat 2: FDIBA2009 (button) (small blind) collected (200)



PokerStars Home Game Hand #227558147805: {Club #4781089}  Hold'em No Limit (50/100) - 2021/06/13 23:09:08 EET [2021/06/13 16:09:08 ET]
Table 'VTTP 1306' 2-max (Play Money) Seat #1 is the button
Seat 1: s70n3fac3 (10495 in chips) 
Seat 2: FDIBA2009 (8093 in chips) 
s70n3fac3: posts small blind 50
FDIBA2009: posts big blind 100
*** HOLE CARDS ***
s70n3fac3: folds 
Uncalled bet (50) returned to FDIBA2009
FDIBA2009 collected 100 from pot
FDIBA2009: doesn't show hand 
*** SUMMARY ***
Total pot 100 | Rake 0 
Seat 1: s70n3fac3 (button) (small blind) folded before Flop
Seat 2: FDIBA2009 (big blind) collected (100)



PokerStars Home Game Hand #227558149913: {Club #4781089}  Hold'em No Limit (50/100) - 2021/06/13 23:09:12 EET [2021/06/13 16:09:12 ET]
Table 'VTTP 1306' 2-max (Play Money) Seat #2 is the button
Seat 1: s70n3fac3 (10445 in chips) 
Seat 2: FDIBA2009 (8143 in chips) 
FDIBA2009: posts small blind 50
s70n3fac3: posts big blind 100
*** HOLE CARDS ***
FDIBA2009: raises 100 to 200
s70n3fac3: calls 100
*** FLOP *** [5s 6d 8s]
s70n3fac3: checks 
FDIBA2009: bets 189
s70n3fac3: calls 189
*** TURN *** [5s 6d 8s] [2c]
s70n3fac3: checks 
FDIBA2009: checks 
*** RIVER *** [5s 6d 8s 2c] [Jd]
s70n3fac3: checks 
FDIBA2009: bets 250
s70n3fac3: calls 250
*** SHOW DOWN ***
FDIBA2009: shows [Jh 9s] (a pair of Jacks)
s70n3fac3: mucks hand 
FDIBA2009 collected 1208 from pot
*** SUMMARY ***
Total pot 1278 | Rake 70 
Board [5s 6d 8s 2c Jd]
Seat 1: s70n3fac3 (big blind) mucked [4d 5d]
Seat 2: FDIBA2009 (button) (small blind) showed [Jh 9s] and won (1208) with a pair of Jacks



PokerStars Home Game Hand #227558164101: {Club #4781089}  Hold'em No Limit (50/100) - 2021/06/13 23:09:39 EET [2021/06/13 16:09:39 ET]
Table 'VTTP 1306' 2-max (Play Money) Seat #1 is the button
Seat 1: s70n3fac3 (9806 in chips) 
Seat 2: FDIBA2009 (8712 in chips) 
s70n3fac3: posts small blind 50
FDIBA2009: posts big blind 100
*** HOLE CARDS ***
s70n3fac3: folds 
Uncalled bet (50) returned to FDIBA2009
FDIBA2009 collected 100 from pot
FDIBA2009: doesn't show hand 
*** SUMMARY ***
Total pot 100 | Rake 0 
Seat 1: s70n3fac3 (button) (small blind) folded before Flop
Seat 2: FDIBA2009 (big blind) collected (100)



PokerStars Home Game Hand #227558166379: {Club #4781089}  Hold'em No Limit (50/100) - 2021/06/13 23:09:44 EET [2021/06/13 16:09:44 ET]
Table 'VTTP 1306' 2-max (Play Money) Seat #2 is the button
Seat 1: s70n3fac3 (9756 in chips) 
Seat 2: FDIBA2009 (8762 in chips) 
FDIBA2009: posts small blind 50
s70n3fac3: posts big blind 100
*** HOLE CARDS ***
FDIBA2009: raises 100 to 200
s70n3fac3: folds 
Uncalled bet (100) returned to FDIBA2009
FDIBA2009 collected 200 from pot
FDIBA2009: doesn't show hand 
*** SUMMARY ***
Total pot 200 | Rake 0 
Seat 1: s70n3fac3 (big blind) folded before Flop
Seat 2: FDIBA2009 (button) (small blind) collected (200)



PokerStars Home Game Hand #227558169826: {Club #4781089}  Hold'em No Limit (50/100) - 2021/06/13 23:09:50 EET [2021/06/13 16:09:50 ET]
Table 'VTTP 1306' 2-max (Play Money) Seat #1 is the button
Seat 1: s70n3fac3 (9656 in chips) 
Seat 2: FDIBA2009 (8862 in chips) 
s70n3fac3: posts small blind 50
FDIBA2009: posts big blind 100
*** HOLE CARDS ***
s70n3fac3: calls 50
FDIBA2009: checks 
*** FLOP *** [Qh Ah 5h]
FDIBA2009: checks 
s70n3fac3: bets 200
FDIBA2009: calls 200
*** TURN *** [Qh Ah 5h] [8s]
FDIBA2009: checks 
s70n3fac3: bets 600
FDIBA2009: calls 600
*** RIVER *** [Qh Ah 5h 8s] [Kh]
FDIBA2009: bets 1701
s70n3fac3: folds 
Uncalled bet (1701) returned to FDIBA2009
FDIBA2009 collected 1701 from pot
FDIBA2009: doesn't show hand 
*** SUMMARY ***
Total pot 1800 | Rake 99 
Board [Qh Ah 5h 8s Kh]
Seat 1: s70n3fac3 (button) (small blind) folded on the River
Seat 2: FDIBA2009 (big blind) collected (1701)



PokerStars Home Game Hand #227558194075: {Club #4781089}  Hold'em No Limit (50/100) - 2021/06/13 23:10:36 EET [2021/06/13 16:10:36 ET]
Table 'VTTP 1306' 2-max (Play Money) Seat #2 is the button
Seat 1: s70n3fac3 (8756 in chips) 
Seat 2: FDIBA2009 (9663 in chips) 
FDIBA2009: posts small blind 50
s70n3fac3: posts big blind 100
*** HOLE CARDS ***
FDIBA2009: raises 100 to 200
s70n3fac3: raises 500 to 700
FDIBA2009: calls 500
*** FLOP *** [7d Qh 5s]
s70n3fac3: bets 900
FDIBA2009: folds 
Uncalled bet (900) returned to s70n3fac3
s70n3fac3 collected 1323 from pot
s70n3fac3: doesn't show hand 
*** SUMMARY ***
Total pot 1400 | Rake 77 
Board [7d Qh 5s]
Seat 1: s70n3fac3 (big blind) collected (1323)
Seat 2: FDIBA2009 (button) (small blind) folded on the Flop



PokerStars Home Game Hand #227558203172: {Club #4781089}  Hold'em No Limit (50/100) - 2021/06/13 23:10:53 EET [2021/06/13 16:10:53 ET]
Table 'VTTP 1306' 2-max (Play Money) Seat #1 is the button
Seat 1: s70n3fac3 (9379 in chips) 
Seat 2: FDIBA2009 (8963 in chips) 
s70n3fac3: posts small blind 50
FDIBA2009: posts big blind 100
*** HOLE CARDS ***
s70n3fac3: raises 100 to 200
FDIBA2009: calls 100
*** FLOP *** [5d 9d Ks]
FDIBA2009: checks 
s70n3fac3: bets 400
FDIBA2009: folds 
Uncalled bet (400) returned to s70n3fac3
s70n3fac3 collected 378 from pot
s70n3fac3: doesn't show hand 
*** SUMMARY ***
Total pot 400 | Rake 22 
Board [5d 9d Ks]
Seat 1: s70n3fac3 (button) (small blind) collected (378)
Seat 2: FDIBA2009 (big blind) folded on the Flop



PokerStars Home Game Hand #227558210033: {Club #4781089}  Hold'em No Limit (50/100) - 2021/06/13 23:11:06 EET [2021/06/13 16:11:06 ET]
Table 'VTTP 1306' 2-max (Play Money) Seat #2 is the button
Seat 1: s70n3fac3 (9557 in chips) 
Seat 2: FDIBA2009 (8763 in chips) 
FDIBA2009: posts small blind 50
s70n3fac3: posts big blind 100
*** HOLE CARDS ***
FDIBA2009: raises 100 to 200
s70n3fac3: folds 
Uncalled bet (100) returned to FDIBA2009
FDIBA2009 collected 200 from pot
FDIBA2009: doesn't show hand 
*** SUMMARY ***
Total pot 200 | Rake 0 
Seat 1: s70n3fac3 (big blind) folded before Flop
Seat 2: FDIBA2009 (button) (small blind) collected (200)



PokerStars Home Game Hand #227558213409: {Club #4781089}  Hold'em No Limit (50/100) - 2021/06/13 23:11:12 EET [2021/06/13 16:11:12 ET]
Table 'VTTP 1306' 2-max (Play Money) Seat #1 is the button
Seat 1: s70n3fac3 (9457 in chips) 
Seat 2: FDIBA2009 (8863 in chips) 
s70n3fac3: posts small blind 50
FDIBA2009: posts big blind 100
*** HOLE CARDS ***
s70n3fac3: folds 
Uncalled bet (50) returned to FDIBA2009
FDIBA2009 collected 100 from pot
FDIBA2009: doesn't show hand 
*** SUMMARY ***
Total pot 100 | Rake 0 
Seat 1: s70n3fac3 (button) (small blind) folded before Flop
Seat 2: FDIBA2009 (big blind) collected (100)



PokerStars Home Game Hand #227558216169: {Club #4781089}  Hold'em No Limit (50/100) - 2021/06/13 23:11:17 EET [2021/06/13 16:11:17 ET]
Table 'VTTP 1306' 2-max (Play Money) Seat #2 is the button
Seat 1: s70n3fac3 (9407 in chips) 
Seat 2: FDIBA2009 (8913 in chips) 
FDIBA2009: posts small blind 50
s70n3fac3: posts big blind 100
*** HOLE CARDS ***
FDIBA2009: raises 200 to 300
s70n3fac3: calls 200
*** FLOP *** [Kh As Js]
s70n3fac3: checks 
FDIBA2009: checks 
*** TURN *** [Kh As Js] [8s]
s70n3fac3: checks 
FDIBA2009: bets 300
s70n3fac3: calls 300
*** RIVER *** [Kh As Js 8s] [6h]
s70n3fac3: checks 
FDIBA2009: checks 
*** SHOW DOWN ***
s70n3fac3: shows [7c Qs] (high card Ace)
FDIBA2009: shows [9s 6c] (a pair of Sixes)
FDIBA2009 collected 1134 from pot
*** SUMMARY ***
Total pot 1200 | Rake 66 
Board [Kh As Js 8s 6h]
Seat 1: s70n3fac3 (big blind) showed [7c Qs] and lost with high card Ace
Seat 2: FDIBA2009 (button) (small blind) showed [9s 6c] and won (1134) with a pair of Sixes



PokerStars Home Game Hand #227558227239: {Club #4781089}  Hold'em No Limit (50/100) - 2021/06/13 23:11:38 EET [2021/06/13 16:11:38 ET]
Table 'VTTP 1306' 2-max (Play Money) Seat #1 is the button
Seat 1: s70n3fac3 (8807 in chips) 
Seat 2: FDIBA2009 (9447 in chips) 
s70n3fac3: posts small blind 50
FDIBA2009: posts big blind 100
*** HOLE CARDS ***
s70n3fac3: folds 
Uncalled bet (50) returned to FDIBA2009
FDIBA2009 collected 100 from pot
FDIBA2009: doesn't show hand 
*** SUMMARY ***
Total pot 100 | Rake 0 
Seat 1: s70n3fac3 (button) (small blind) folded before Flop
Seat 2: FDIBA2009 (big blind) collected (100)



PokerStars Home Game Hand #227558229393: {Club #4781089}  Hold'em No Limit (50/100) - 2021/06/13 23:11:42 EET [2021/06/13 16:11:42 ET]
Table 'VTTP 1306' 2-max (Play Money) Seat #2 is the button
Seat 1: s70n3fac3 (8757 in chips) 
Seat 2: FDIBA2009 (9497 in chips) 
FDIBA2009: posts small blind 50
s70n3fac3: posts big blind 100
*** HOLE CARDS ***
FDIBA2009: raises 100 to 200
s70n3fac3: folds 
Uncalled bet (100) returned to FDIBA2009
FDIBA2009 collected 200 from pot
FDIBA2009: doesn't show hand 
*** SUMMARY ***
Total pot 200 | Rake 0 
Seat 1: s70n3fac3 (big blind) folded before Flop
Seat 2: FDIBA2009 (button) (small blind) collected (200)



PokerStars Home Game Hand #227558232520: {Club #4781089}  Hold'em No Limit (50/100) - 2021/06/13 23:11:48 EET [2021/06/13 16:11:48 ET]
Table 'VTTP 1306' 2-max (Play Money) Seat #1 is the button
Seat 1: s70n3fac3 (8657 in chips) 
Seat 2: FDIBA2009 (9597 in chips) 
s70n3fac3: posts small blind 50
FDIBA2009: posts big blind 100
*** HOLE CARDS ***
s70n3fac3: calls 50
FDIBA2009: raises 250 to 350
s70n3fac3: folds 
Uncalled bet (250) returned to FDIBA2009
FDIBA2009 collected 200 from pot
FDIBA2009: doesn't show hand 
*** SUMMARY ***
Total pot 200 | Rake 0 
Seat 1: s70n3fac3 (button) (small blind) folded before Flop
Seat 2: FDIBA2009 (big blind) collected (200)



PokerStars Home Game Hand #227558236970: {Club #4781089}  Hold'em No Limit (50/100) - 2021/06/13 23:11:57 EET [2021/06/13 16:11:57 ET]
Table 'VTTP 1306' 2-max (Play Money) Seat #2 is the button
Seat 1: s70n3fac3 (8557 in chips) 
Seat 2: FDIBA2009 (9697 in chips) 
FDIBA2009: posts small blind 50
s70n3fac3: posts big blind 100
*** HOLE CARDS ***
FDIBA2009: folds 
Uncalled bet (50) returned to s70n3fac3
s70n3fac3 collected 100 from pot
s70n3fac3: doesn't show hand 
*** SUMMARY ***
Total pot 100 | Rake 0 
Seat 1: s70n3fac3 (big blind) collected (100)
Seat 2: FDIBA2009 (button) (small blind) folded before Flop



PokerStars Home Game Hand #227558239647: {Club #4781089}  Hold'em No Limit (50/100) - 2021/06/13 23:12:02 EET [2021/06/13 16:12:02 ET]
Table 'VTTP 1306' 2-max (Play Money) Seat #1 is the button
Seat 1: s70n3fac3 (8607 in chips) 
Seat 2: FDIBA2009 (9647 in chips) 
s70n3fac3: posts small blind 50
FDIBA2009: posts big blind 100
*** HOLE CARDS ***
s70n3fac3: raises 150 to 250
FDIBA2009: calls 150
*** FLOP *** [9d Jd Kc]
FDIBA2009: checks 
s70n3fac3: bets 300
FDIBA2009: folds 
Uncalled bet (300) returned to s70n3fac3
s70n3fac3 collected 472 from pot
s70n3fac3: doesn't show hand 
*** SUMMARY ***
Total pot 500 | Rake 28 
Board [9d Jd Kc]
Seat 1: s70n3fac3 (button) (small blind) collected (472)
Seat 2: FDIBA2009 (big blind) folded on the Flop



PokerStars Home Game Hand #227558246036: {Club #4781089}  Hold'em No Limit (50/100) - 2021/06/13 23:12:14 EET [2021/06/13 16:12:14 ET]
Table 'VTTP 1306' 2-max (Play Money) Seat #2 is the button
Seat 1: s70n3fac3 (8829 in chips) 
Seat 2: FDIBA2009 (9397 in chips) 
FDIBA2009: posts small blind 50
s70n3fac3: posts big blind 100
*** HOLE CARDS ***
FDIBA2009: raises 100 to 200
s70n3fac3: calls 100
*** FLOP *** [Ts Ah 2s]
s70n3fac3: checks 
FDIBA2009: checks 
*** TURN *** [Ts Ah 2s] [Kh]
s70n3fac3: checks 
FDIBA2009: checks 
*** RIVER *** [Ts Ah 2s Kh] [Qs]
s70n3fac3: bets 378
FDIBA2009: calls 378
*** SHOW DOWN ***
s70n3fac3: shows [Js 5d] (a straight, Ten to Ace)
FDIBA2009: mucks hand 
s70n3fac3 collected 1092 from pot
*** SUMMARY ***
Total pot 1156 | Rake 64 
Board [Ts Ah 2s Kh Qs]
Seat 1: s70n3fac3 (big blind) showed [Js 5d] and won (1092) with a straight, Ten to Ace
Seat 2: FDIBA2009 (button) (small blind) mucked [9c Qc]



PokerStars Home Game Hand #227558263592: {Club #4781089}  Hold'em No Limit (50/100) - 2021/06/13 23:12:42 EET [2021/06/13 16:12:42 ET]
Table 'VTTP 1306' 2-max (Play Money) Seat #1 is the button
Seat 1: s70n3fac3 (9343 in chips) 
Seat 2: FDIBA2009 (8819 in chips) 
s70n3fac3: posts small blind 50
FDIBA2009: posts big blind 100
*** HOLE CARDS ***
s70n3fac3: raises 150 to 250
FDIBA2009: folds 
Uncalled bet (150) returned to s70n3fac3
s70n3fac3 collected 200 from pot
s70n3fac3: doesn't show hand 
*** SUMMARY ***
Total pot 200 | Rake 0 
Seat 1: s70n3fac3 (button) (small blind) collected (200)
Seat 2: FDIBA2009 (big blind) folded before Flop



PokerStars Home Game Hand #227558266712: {Club #4781089}  Hold'em No Limit (50/100) - 2021/06/13 23:12:48 EET [2021/06/13 16:12:48 ET]
Table 'VTTP 1306' 2-max (Play Money) Seat #2 is the button
Seat 1: s70n3fac3 (9443 in chips) 
Seat 2: FDIBA2009 (8719 in chips) 
FDIBA2009: posts small blind 50
s70n3fac3: posts big blind 100
*** HOLE CARDS ***
FDIBA2009: raises 100 to 200
s70n3fac3: calls 100
*** FLOP *** [2c 4d 8h]
s70n3fac3: checks 
FDIBA2009: bets 200
s70n3fac3: raises 389 to 589
FDIBA2009: raises 778 to 1367
s70n3fac3: calls 778
*** TURN *** [2c 4d 8h] [Jd]
s70n3fac3: checks 
FDIBA2009: bets 2000
s70n3fac3: raises 5876 to 7876 and is all-in
FDIBA2009: calls 5152 and is all-in
Uncalled bet (724) returned to s70n3fac3
*** RIVER *** [2c 4d 8h Jd] [Qh]
*** SHOW DOWN ***
s70n3fac3: shows [8s 5d] (a pair of Eights)
FDIBA2009: shows [8c 2h] (two pair, Eights and Deuces)
FDIBA2009 collected 16479 from pot
*** SUMMARY ***
Total pot 17438 | Rake 959 
Board [2c 4d 8h Jd Qh]
Seat 1: s70n3fac3 (big blind) showed [8s 5d] and lost with a pair of Eights
Seat 2: FDIBA2009 (button) (small blind) showed [8c 2h] and won (16479) with two pair, Eights and Deuces



PokerStars Home Game Hand #227558289819: {Club #4781089}  Hold'em No Limit (50/100) - 2021/06/13 23:13:32 EET [2021/06/13 16:13:32 ET]
Table 'VTTP 1306' 2-max (Play Money) Seat #1 is the button
Seat 1: s70n3fac3 (724 in chips) 
Seat 2: FDIBA2009 (16479 in chips) 
s70n3fac3: posts small blind 50
FDIBA2009: posts big blind 100
*** HOLE CARDS ***
s70n3fac3: folds 
Uncalled bet (50) returned to FDIBA2009
FDIBA2009 collected 100 from pot
FDIBA2009: doesn't show hand 
*** SUMMARY ***
Total pot 100 | Rake 0 
Seat 1: s70n3fac3 (button) (small blind) folded before Flop
Seat 2: FDIBA2009 (big blind) collected (100)



PokerStars Home Game Hand #227558292114: {Club #4781089}  Hold'em No Limit (50/100) - 2021/06/13 23:13:36 EET [2021/06/13 16:13:36 ET]
Table 'VTTP 1306' 2-max (Play Money) Seat #2 is the button
Seat 1: s70n3fac3 (674 in chips) 
Seat 2: FDIBA2009 (16529 in chips) 
FDIBA2009: posts small blind 50
s70n3fac3: posts big blind 100
*** HOLE CARDS ***
FDIBA2009: folds 
Uncalled bet (50) returned to s70n3fac3
s70n3fac3 collected 100 from pot
s70n3fac3: doesn't show hand 
*** SUMMARY ***
Total pot 100 | Rake 0 
Seat 1: s70n3fac3 (big blind) collected (100)
Seat 2: FDIBA2009 (button) (small blind) folded before Flop



PokerStars Home Game Hand #227558295617: {Club #4781089}  Hold'em No Limit (50/100) - 2021/06/13 23:13:43 EET [2021/06/13 16:13:43 ET]
Table 'VTTP 1306' 2-max (Play Money) Seat #1 is the button
Seat 1: s70n3fac3 (724 in chips) 
Seat 2: FDIBA2009 (16479 in chips) 
s70n3fac3: posts small blind 50
FDIBA2009: posts big blind 100
*** HOLE CARDS ***
s70n3fac3: raises 624 to 724 and is all-in
FDIBA2009: calls 624
*** FLOP *** [Js 4h Qh]
*** TURN *** [Js 4h Qh] [7h]
*** RIVER *** [Js 4h Qh 7h] [Td]
*** SHOW DOWN ***
FDIBA2009: shows [8c Tc] (a pair of Tens)
s70n3fac3: shows [Qc 7d] (two pair, Queens and Sevens)
s70n3fac3 collected 1368 from pot
*** SUMMARY ***
Total pot 1448 | Rake 80 
Board [Js 4h Qh 7h Td]
Seat 1: s70n3fac3 (button) (small blind) showed [Qc 7d] and won (1368) with two pair, Queens and Sevens
Seat 2: FDIBA2009 (big blind) showed [8c Tc] and lost with a pair of Tens



PokerStars Home Game Hand #227558303149: {Club #4781089}  Hold'em No Limit (50/100) - 2021/06/13 23:13:57 EET [2021/06/13 16:13:57 ET]
Table 'VTTP 1306' 2-max (Play Money) Seat #2 is the button
Seat 1: s70n3fac3 (1368 in chips) 
Seat 2: FDIBA2009 (15755 in chips) 
FDIBA2009: posts small blind 50
s70n3fac3: posts big blind 100
*** HOLE CARDS ***
FDIBA2009: folds 
Uncalled bet (50) returned to s70n3fac3
s70n3fac3 collected 100 from pot
s70n3fac3: doesn't show hand 
*** SUMMARY ***
Total pot 100 | Rake 0 
Seat 1: s70n3fac3 (big blind) collected (100)
Seat 2: FDIBA2009 (button) (small blind) folded before Flop



PokerStars Home Game Hand #227558306187: {Club #4781089}  Hold'em No Limit (50/100) - 2021/06/13 23:14:03 EET [2021/06/13 16:14:03 ET]
Table 'VTTP 1306' 2-max (Play Money) Seat #1 is the button
Seat 1: s70n3fac3 (1418 in chips) 
Seat 2: FDIBA2009 (15705 in chips) 
s70n3fac3: posts small blind 50
FDIBA2009: posts big blind 100
*** HOLE CARDS ***
s70n3fac3: folds 
Uncalled bet (50) returned to FDIBA2009
FDIBA2009 collected 100 from pot
FDIBA2009: doesn't show hand 
*** SUMMARY ***
Total pot 100 | Rake 0 
Seat 1: s70n3fac3 (button) (small blind) folded before Flop
Seat 2: FDIBA2009 (big blind) collected (100)



PokerStars Home Game Hand #227558308407: {Club #4781089}  Hold'em No Limit (50/100) - 2021/06/13 23:14:07 EET [2021/06/13 16:14:07 ET]
Table 'VTTP 1306' 2-max (Play Money) Seat #2 is the button
Seat 1: s70n3fac3 (1368 in chips) 
Seat 2: FDIBA2009 (15755 in chips) 
FDIBA2009: posts small blind 50
s70n3fac3: posts big blind 100
*** HOLE CARDS ***
FDIBA2009: calls 50
s70n3fac3: raises 1268 to 1368 and is all-in
FDIBA2009: calls 1268
*** FLOP *** [8c 7c Qd]
*** TURN *** [8c 7c Qd] [9s]
*** RIVER *** [8c 7c Qd 9s] [3d]
*** SHOW DOWN ***
s70n3fac3: shows [Jd As] (high card Ace)
FDIBA2009: shows [8s Qs] (two pair, Queens and Eights)
FDIBA2009 collected 2586 from pot
*** SUMMARY ***
Total pot 2736 | Rake 150 
Board [8c 7c Qd 9s 3d]
Seat 1: s70n3fac3 (big blind) showed [Jd As] and lost with high card Ace
Seat 2: FDIBA2009 (button) (small blind) showed [8s Qs] and won (2586) with two pair, Queens and Eights



PokerStars Home Game Hand #227558325247: {Club #4781089}  Hold'em No Limit (50/100) - 2021/06/13 23:14:40 EET [2021/06/13 16:14:40 ET]
Table 'VTTP 1306' 2-max (Play Money) Seat #1 is the button
Seat 1: s70n3fac3 (10000 in chips) 
Seat 2: FDIBA2009 (16973 in chips) 
s70n3fac3: posts small blind 50
FDIBA2009: posts big blind 100
*** HOLE CARDS ***
s70n3fac3: raises 400 to 500
FDIBA2009: calls 400
*** FLOP *** [3c 4c 9d]
FDIBA2009: checks 
s70n3fac3: bets 1100
FDIBA2009: folds 
Uncalled bet (1100) returned to s70n3fac3
s70n3fac3 collected 945 from pot
s70n3fac3: doesn't show hand 
*** SUMMARY ***
Total pot 1000 | Rake 55 
Board [3c 4c 9d]
Seat 1: s70n3fac3 (button) (small blind) collected (945)
Seat 2: FDIBA2009 (big blind) folded on the Flop



PokerStars Home Game Hand #227558333847: {Club #4781089}  Hold'em No Limit (50/100) - 2021/06/13 23:14:56 EET [2021/06/13 16:14:56 ET]
Table 'VTTP 1306' 2-max (Play Money) Seat #2 is the button
Seat 1: s70n3fac3 (10445 in chips) 
Seat 2: FDIBA2009 (16473 in chips) 
FDIBA2009: posts small blind 50
s70n3fac3: posts big blind 100
*** HOLE CARDS ***
FDIBA2009: folds 
Uncalled bet (50) returned to s70n3fac3
s70n3fac3 collected 100 from pot
s70n3fac3: doesn't show hand 
*** SUMMARY ***
Total pot 100 | Rake 0 
Seat 1: s70n3fac3 (big blind) collected (100)
Seat 2: FDIBA2009 (button) (small blind) folded before Flop



PokerStars Home Game Hand #227558336569: {Club #4781089}  Hold'em No Limit (50/100) - 2021/06/13 23:15:02 EET [2021/06/13 16:15:02 ET]
Table 'VTTP 1306' 2-max (Play Money) Seat #1 is the button
Seat 1: s70n3fac3 (10495 in chips) 
Seat 2: FDIBA2009 (16423 in chips) 
s70n3fac3: posts small blind 50
FDIBA2009: posts big blind 100
*** HOLE CARDS ***
s70n3fac3: raises 300 to 400
FDIBA2009: folds 
Uncalled bet (300) returned to s70n3fac3
s70n3fac3 collected 200 from pot
s70n3fac3: doesn't show hand 
*** SUMMARY ***
Total pot 200 | Rake 0 
Seat 1: s70n3fac3 (button) (small blind) collected (200)
Seat 2: FDIBA2009 (big blind) folded before Flop



PokerStars Home Game Hand #227558340563: {Club #4781089}  Hold'em No Limit (50/100) - 2021/06/13 23:15:09 EET [2021/06/13 16:15:09 ET]
Table 'VTTP 1306' 2-max (Play Money) Seat #2 is the button
Seat 1: s70n3fac3 (10595 in chips) 
Seat 2: FDIBA2009 (16323 in chips) 
FDIBA2009: posts small blind 50
s70n3fac3: posts big blind 100
*** HOLE CARDS ***
FDIBA2009: raises 100 to 200
s70n3fac3: raises 600 to 800
FDIBA2009: folds 
Uncalled bet (600) returned to s70n3fac3
s70n3fac3 collected 400 from pot
s70n3fac3: doesn't show hand 
*** SUMMARY ***
Total pot 400 | Rake 0 
Seat 1: s70n3fac3 (big blind) collected (400)
Seat 2: FDIBA2009 (button) (small blind) folded before Flop



PokerStars Home Game Hand #227558345648: {Club #4781089}  Hold'em No Limit (50/100) - 2021/06/13 23:15:18 EET [2021/06/13 16:15:18 ET]
Table 'VTTP 1306' 2-max (Play Money) Seat #1 is the button
Seat 1: s70n3fac3 (10795 in chips) 
Seat 2: FDIBA2009 (16123 in chips) 
s70n3fac3: posts small blind 50
FDIBA2009: posts big blind 100
*** HOLE CARDS ***
s70n3fac3: raises 400 to 500
FDIBA2009: folds 
Uncalled bet (400) returned to s70n3fac3
s70n3fac3 collected 200 from pot
s70n3fac3: doesn't show hand 
*** SUMMARY ***
Total pot 200 | Rake 0 
Seat 1: s70n3fac3 (button) (small blind) collected (200)
Seat 2: FDIBA2009 (big blind) folded before Flop



PokerStars Home Game Hand #227558349709: {Club #4781089}  Hold'em No Limit (50/100) - 2021/06/13 23:15:26 EET [2021/06/13 16:15:26 ET]
Table 'VTTP 1306' 2-max (Play Money) Seat #2 is the button
Seat 1: s70n3fac3 (10895 in chips) 
Seat 2: FDIBA2009 (16023 in chips) 
FDIBA2009: posts small blind 50
s70n3fac3: posts big blind 100
*** HOLE CARDS ***
FDIBA2009: raises 100 to 200
s70n3fac3: calls 100
*** FLOP *** [2h As 5h]
s70n3fac3: checks 
FDIBA2009: bets 200
s70n3fac3: calls 200
*** TURN *** [2h As 5h] [8c]
s70n3fac3: checks 
FDIBA2009: checks 
*** RIVER *** [2h As 5h 8c] [Ts]
s70n3fac3: checks 
FDIBA2009: bets 600
s70n3fac3: calls 600
*** SHOW DOWN ***
FDIBA2009: shows [6c Qs] (high card Ace)
s70n3fac3: shows [3s 2s] (a pair of Deuces)
s70n3fac3 collected 1890 from pot
*** SUMMARY ***
Total pot 2000 | Rake 110 
Board [2h As 5h 8c Ts]
Seat 1: s70n3fac3 (big blind) showed [3s 2s] and won (1890) with a pair of Deuces
Seat 2: FDIBA2009 (button) (small blind) showed [6c Qs] and lost with high card Ace



PokerStars Home Game Hand #227558364794: {Club #4781089}  Hold'em No Limit (50/100) - 2021/06/13 23:15:55 EET [2021/06/13 16:15:55 ET]
Table 'VTTP 1306' 2-max (Play Money) Seat #1 is the button
Seat 1: s70n3fac3 (11785 in chips) 
Seat 2: FDIBA2009 (15023 in chips) 
s70n3fac3: posts small blind 50
FDIBA2009: posts big blind 100
*** HOLE CARDS ***
s70n3fac3: raises 150 to 250
FDIBA2009: calls 150
*** FLOP *** [9h 4s Kh]
FDIBA2009: checks 
s70n3fac3: checks 
*** TURN *** [9h 4s Kh] [Th]
FDIBA2009: checks 
s70n3fac3: checks 
*** RIVER *** [9h 4s Kh Th] [8c]
FDIBA2009: checks 
s70n3fac3: bets 800
FDIBA2009: folds 
Uncalled bet (800) returned to s70n3fac3
s70n3fac3 collected 472 from pot
s70n3fac3: doesn't show hand 
*** SUMMARY ***
Total pot 500 | Rake 28 
Board [9h 4s Kh Th 8c]
Seat 1: s70n3fac3 (button) (small blind) collected (472)
Seat 2: FDIBA2009 (big blind) folded on the River



PokerStars Home Game Hand #227558376444: {Club #4781089}  Hold'em No Limit (50/100) - 2021/06/13 23:16:17 EET [2021/06/13 16:16:17 ET]
Table 'VTTP 1306' 2-max (Play Money) Seat #2 is the button
Seat 1: s70n3fac3 (12007 in chips) 
Seat 2: FDIBA2009 (14773 in chips) 
FDIBA2009: posts small blind 50
s70n3fac3: posts big blind 100
*** HOLE CARDS ***
FDIBA2009: raises 100 to 200
s70n3fac3: raises 700 to 900
FDIBA2009: calls 700
*** FLOP *** [7d 3h 5c]
s70n3fac3: bets 1900
FDIBA2009: calls 1900
*** TURN *** [7d 3h 5c] [4s]
s70n3fac3: bets 5292
FDIBA2009 has timed out
FDIBA2009: folds 
Uncalled bet (5292) returned to s70n3fac3
s70n3fac3 collected 5292 from pot
s70n3fac3: doesn't show hand 
*** SUMMARY ***
Total pot 5600 | Rake 308 
Board [7d 3h 5c 4s]
Seat 1: s70n3fac3 (big blind) collected (5292)
Seat 2: FDIBA2009 (button) (small blind) folded on the Turn



PokerStars Home Game Hand #227558404664: {Club #4781089}  Hold'em No Limit (50/100) - 2021/06/13 23:17:02 EET [2021/06/13 16:17:02 ET]
Table 'VTTP 1306' 2-max (Play Money) Seat #1 is the button
Seat 1: s70n3fac3 (14499 in chips) 
Seat 2: FDIBA2009 (11973 in chips) 
s70n3fac3: posts small blind 50
FDIBA2009: posts big blind 100
*** HOLE CARDS ***
s70n3fac3: calls 50
FDIBA2009: checks 
*** FLOP *** [Th 2d 8d]
FDIBA2009: checks 
s70n3fac3: checks 
*** TURN *** [Th 2d 8d] [Tc]
FDIBA2009: bets 189
s70n3fac3: folds 
Uncalled bet (189) returned to FDIBA2009
FDIBA2009 collected 189 from pot
FDIBA2009: doesn't show hand 
*** SUMMARY ***
Total pot 200 | Rake 11 
Board [Th 2d 8d Tc]
Seat 1: s70n3fac3 (button) (small blind) folded on the Turn
Seat 2: FDIBA2009 (big blind) collected (189)



PokerStars Home Game Hand #227558413345: {Club #4781089}  Hold'em No Limit (50/100) - 2021/06/13 23:17:18 EET [2021/06/13 16:17:18 ET]
Table 'VTTP 1306' 2-max (Play Money) Seat #2 is the button
Seat 1: s70n3fac3 (14399 in chips) 
Seat 2: FDIBA2009 (12062 in chips) 
FDIBA2009: posts small blind 50
s70n3fac3: posts big blind 100
*** HOLE CARDS ***
FDIBA2009: raises 100 to 200
s70n3fac3: raises 700 to 900
FDIBA2009: folds 
Uncalled bet (700) returned to s70n3fac3
s70n3fac3 collected 400 from pot
s70n3fac3: doesn't show hand 
*** SUMMARY ***
Total pot 400 | Rake 0 
Seat 1: s70n3fac3 (big blind) collected (400)
Seat 2: FDIBA2009 (button) (small blind) folded before Flop



PokerStars Home Game Hand #227558420699: {Club #4781089}  Hold'em No Limit (50/100) - 2021/06/13 23:17:32 EET [2021/06/13 16:17:32 ET]
Table 'VTTP 1306' 2-max (Play Money) Seat #1 is the button
Seat 1: s70n3fac3 (14599 in chips) 
Seat 2: FDIBA2009 (11862 in chips) 
s70n3fac3: posts small blind 50
FDIBA2009: posts big blind 100
*** HOLE CARDS ***
s70n3fac3: folds 
Uncalled bet (50) returned to FDIBA2009
FDIBA2009 collected 100 from pot
FDIBA2009: doesn't show hand 
*** SUMMARY ***
Total pot 100 | Rake 0 
Seat 1: s70n3fac3 (button) (small blind) folded before Flop
Seat 2: FDIBA2009 (big blind) collected (100)



PokerStars Home Game Hand #227558422784: {Club #4781089}  Hold'em No Limit (50/100) - 2021/06/13 23:17:36 EET [2021/06/13 16:17:36 ET]
Table 'VTTP 1306' 2-max (Play Money) Seat #2 is the button
Seat 1: s70n3fac3 (14549 in chips) 
Seat 2: FDIBA2009 (11912 in chips) 
FDIBA2009: posts small blind 50
s70n3fac3: posts big blind 100
*** HOLE CARDS ***
FDIBA2009: raises 100 to 200
s70n3fac3: calls 100
*** FLOP *** [9c 7d Th]
s70n3fac3: checks 
FDIBA2009: checks 
*** TURN *** [9c 7d Th] [5c]
s70n3fac3: checks 
FDIBA2009: bets 200
s70n3fac3: calls 200
*** RIVER *** [9c 7d Th 5c] [8s]
s70n3fac3: checks 
FDIBA2009: checks 
*** SHOW DOWN ***
s70n3fac3: shows [Jd 7h] (a straight, Seven to Jack)
FDIBA2009: mucks hand 
s70n3fac3 collected 756 from pot
*** SUMMARY ***
Total pot 800 | Rake 44 
Board [9c 7d Th 5c 8s]
Seat 1: s70n3fac3 (big blind) showed [Jd 7h] and won (756) with a straight, Seven to Jack
Seat 2: FDIBA2009 (button) (small blind) mucked [Ah 2c]



PokerStars Home Game Hand #227558434555: {Club #4781089}  Hold'em No Limit (50/100) - 2021/06/13 23:17:58 EET [2021/06/13 16:17:58 ET]
Table 'VTTP 1306' 2-max (Play Money) Seat #1 is the button
Seat 1: s70n3fac3 (14905 in chips) 
Seat 2: FDIBA2009 (11512 in chips) 
s70n3fac3: posts small blind 50
FDIBA2009: posts big blind 100
*** HOLE CARDS ***
s70n3fac3: calls 50
FDIBA2009: checks 
*** FLOP *** [Qs 6c 8s]
FDIBA2009: checks 
s70n3fac3: checks 
*** TURN *** [Qs 6c 8s] [Js]
FDIBA2009: bets 189
s70n3fac3: calls 189
*** RIVER *** [Qs 6c 8s Js] [As]
FDIBA2009: checks 
s70n3fac3: bets 546
FDIBA2009: calls 546
*** SHOW DOWN ***
s70n3fac3: shows [4c 4s] (a flush, Ace high)
FDIBA2009: shows [6s Qd] (a flush, Ace high - Six higher)
FDIBA2009 collected 1578 from pot
*** SUMMARY ***
Total pot 1670 | Rake 92 
Board [Qs 6c 8s Js As]
Seat 1: s70n3fac3 (button) (small blind) showed [4c 4s] and lost with a flush, Ace high
Seat 2: FDIBA2009 (big blind) showed [6s Qd] and won (1578) with a flush, Ace high



PokerStars Home Game Hand #227558446681: {Club #4781089}  Hold'em No Limit (50/100) - 2021/06/13 23:18:20 EET [2021/06/13 16:18:20 ET]
Table 'VTTP 1306' 2-max (Play Money) Seat #2 is the button
Seat 1: s70n3fac3 (14070 in chips) 
Seat 2: FDIBA2009 (12255 in chips) 
FDIBA2009: posts small blind 50
s70n3fac3: posts big blind 100
*** HOLE CARDS ***
FDIBA2009: raises 100 to 200
s70n3fac3: folds 
Uncalled bet (100) returned to FDIBA2009
FDIBA2009 collected 200 from pot
FDIBA2009: doesn't show hand 
*** SUMMARY ***
Total pot 200 | Rake 0 
Seat 1: s70n3fac3 (big blind) folded before Flop
Seat 2: FDIBA2009 (button) (small blind) collected (200)



PokerStars Home Game Hand #227558451015: {Club #4781089}  Hold'em No Limit (50/100) - 2021/06/13 23:18:28 EET [2021/06/13 16:18:28 ET]
Table 'VTTP 1306' 2-max (Play Money) Seat #1 is the button
Seat 1: s70n3fac3 (13970 in chips) 
Seat 2: FDIBA2009 (12355 in chips) 
s70n3fac3: posts small blind 50
FDIBA2009: posts big blind 100
*** HOLE CARDS ***
s70n3fac3: calls 50
FDIBA2009: checks 
*** FLOP *** [7s Ts 9h]
FDIBA2009: checks 
s70n3fac3: bets 200
FDIBA2009: calls 200
*** TURN *** [7s Ts 9h] [Kc]
FDIBA2009: checks 
s70n3fac3: checks 
*** RIVER *** [7s Ts 9h Kc] [Kh]
FDIBA2009: bets 200
s70n3fac3: folds 
Uncalled bet (200) returned to FDIBA2009
FDIBA2009 collected 567 from pot
FDIBA2009: doesn't show hand 
*** SUMMARY ***
Total pot 600 | Rake 33 
Board [7s Ts 9h Kc Kh]
Seat 1: s70n3fac3 (button) (small blind) folded on the River
Seat 2: FDIBA2009 (big blind) collected (567)



PokerStars Home Game Hand #227558462069: {Club #4781089}  Hold'em No Limit (50/100) - 2021/06/13 23:18:49 EET [2021/06/13 16:18:49 ET]
Table 'VTTP 1306' 2-max (Play Money) Seat #2 is the button
Seat 1: s70n3fac3 (13670 in chips) 
Seat 2: FDIBA2009 (12622 in chips) 
FDIBA2009: posts small blind 50
s70n3fac3: posts big blind 100
*** HOLE CARDS ***
FDIBA2009: raises 100 to 200
s70n3fac3: folds 
Uncalled bet (100) returned to FDIBA2009
FDIBA2009 collected 200 from pot
FDIBA2009: doesn't show hand 
*** SUMMARY ***
Total pot 200 | Rake 0 
Seat 1: s70n3fac3 (big blind) folded before Flop
Seat 2: FDIBA2009 (button) (small blind) collected (200)



PokerStars Home Game Hand #227558465421: {Club #4781089}  Hold'em No Limit (50/100) - 2021/06/13 23:18:55 EET [2021/06/13 16:18:55 ET]
Table 'VTTP 1306' 2-max (Play Money) Seat #1 is the button
Seat 1: s70n3fac3 (13570 in chips) 
Seat 2: FDIBA2009 (12722 in chips) 
s70n3fac3: posts small blind 50
FDIBA2009: posts big blind 100
*** HOLE CARDS ***
s70n3fac3: raises 200 to 300
FDIBA2009: folds 
Uncalled bet (200) returned to s70n3fac3
s70n3fac3 collected 200 from pot
s70n3fac3: doesn't show hand 
*** SUMMARY ***
Total pot 200 | Rake 0 
Seat 1: s70n3fac3 (button) (small blind) collected (200)
Seat 2: FDIBA2009 (big blind) folded before Flop



PokerStars Home Game Hand #227558469235: {Club #4781089}  Hold'em No Limit (50/100) - 2021/06/13 23:19:02 EET [2021/06/13 16:19:02 ET]
Table 'VTTP 1306' 2-max (Play Money) Seat #2 is the button
Seat 1: s70n3fac3 (13670 in chips) 
Seat 2: FDIBA2009 (12622 in chips) 
FDIBA2009: posts small blind 50
s70n3fac3: posts big blind 100
*** HOLE CARDS ***
FDIBA2009: raises 100 to 200
s70n3fac3: calls 100
*** FLOP *** [4s 2h Tc]
s70n3fac3: checks 
FDIBA2009: checks 
*** TURN *** [4s 2h Tc] [Ts]
s70n3fac3: checks 
FDIBA2009: checks 
*** RIVER *** [4s 2h Tc Ts] [Qd]
s70n3fac3: bets 400
FDIBA2009: folds 
Uncalled bet (400) returned to s70n3fac3
s70n3fac3 collected 378 from pot
s70n3fac3: doesn't show hand 
*** SUMMARY ***
Total pot 400 | Rake 22 
Board [4s 2h Tc Ts Qd]
Seat 1: s70n3fac3 (big blind) collected (378)
Seat 2: FDIBA2009 (button) (small blind) folded on the River



PokerStars Home Game Hand #227558478224: {Club #4781089}  Hold'em No Limit (50/100) - 2021/06/13 23:19:18 EET [2021/06/13 16:19:18 ET]
Table 'VTTP 1306' 2-max (Play Money) Seat #1 is the button
Seat 1: s70n3fac3 (13848 in chips) 
Seat 2: FDIBA2009 (12422 in chips) 
s70n3fac3: posts small blind 50
FDIBA2009: posts big blind 100
*** HOLE CARDS ***
s70n3fac3: raises 200 to 300
FDIBA2009: calls 200
*** FLOP *** [Kc Jh 9s]
FDIBA2009: checks 
s70n3fac3: bets 400
FDIBA2009: folds 
Uncalled bet (400) returned to s70n3fac3
s70n3fac3 collected 567 from pot
s70n3fac3: doesn't show hand 
*** SUMMARY ***
Total pot 600 | Rake 33 
Board [Kc Jh 9s]
Seat 1: s70n3fac3 (button) (small blind) collected (567)
Seat 2: FDIBA2009 (big blind) folded on the Flop



PokerStars Home Game Hand #227558484405: {Club #4781089}  Hold'em No Limit (50/100) - 2021/06/13 23:19:30 EET [2021/06/13 16:19:30 ET]
Table 'VTTP 1306' 2-max (Play Money) Seat #2 is the button
Seat 1: s70n3fac3 (14115 in chips) 
Seat 2: FDIBA2009 (12122 in chips) 
FDIBA2009: posts small blind 50
s70n3fac3: posts big blind 100
*** HOLE CARDS ***
FDIBA2009: folds 
Uncalled bet (50) returned to s70n3fac3
s70n3fac3 collected 100 from pot
s70n3fac3: doesn't show hand 
*** SUMMARY ***
Total pot 100 | Rake 0 
Seat 1: s70n3fac3 (big blind) collected (100)
Seat 2: FDIBA2009 (button) (small blind) folded before Flop



PokerStars Home Game Hand #227558487709: {Club #4781089}  Hold'em No Limit (50/100) - 2021/06/13 23:19:36 EET [2021/06/13 16:19:36 ET]
Table 'VTTP 1306' 2-max (Play Money) Seat #1 is the button
Seat 1: s70n3fac3 (14165 in chips) 
Seat 2: FDIBA2009 (12072 in chips) 
s70n3fac3: posts small blind 50
FDIBA2009: posts big blind 100
*** HOLE CARDS ***
s70n3fac3: folds 
Uncalled bet (50) returned to FDIBA2009
FDIBA2009 collected 100 from pot
FDIBA2009: doesn't show hand 
*** SUMMARY ***
Total pot 100 | Rake 0 
Seat 1: s70n3fac3 (button) (small blind) folded before Flop
Seat 2: FDIBA2009 (big blind) collected (100)



PokerStars Home Game Hand #227558489893: {Club #4781089}  Hold'em No Limit (50/100) - 2021/06/13 23:19:40 EET [2021/06/13 16:19:40 ET]
Table 'VTTP 1306' 2-max (Play Money) Seat #2 is the button
Seat 1: s70n3fac3 (14115 in chips) 
Seat 2: FDIBA2009 (12122 in chips) 
FDIBA2009: posts small blind 50
s70n3fac3: posts big blind 100
*** HOLE CARDS ***
FDIBA2009: calls 50
s70n3fac3: checks 
*** FLOP *** [Qd 8s 7h]
s70n3fac3: checks 
FDIBA2009: checks 
*** TURN *** [Qd 8s 7h] [7s]
s70n3fac3: checks 
FDIBA2009: bets 200
s70n3fac3: folds 
Uncalled bet (200) returned to FDIBA2009
FDIBA2009 collected 189 from pot
FDIBA2009: doesn't show hand 
*** SUMMARY ***
Total pot 200 | Rake 11 
Board [Qd 8s 7h 7s]
Seat 1: s70n3fac3 (big blind) folded on the Turn
Seat 2: FDIBA2009 (button) (small blind) collected (189)



PokerStars Home Game Hand #227558498387: {Club #4781089}  Hold'em No Limit (50/100) - 2021/06/13 23:19:56 EET [2021/06/13 16:19:56 ET]
Table 'VTTP 1306' 2-max (Play Money) Seat #1 is the button
Seat 1: s70n3fac3 (14015 in chips) 
Seat 2: FDIBA2009 (12211 in chips) 
s70n3fac3: posts small blind 50
FDIBA2009: posts big blind 100
*** HOLE CARDS ***
s70n3fac3: raises 400 to 500
FDIBA2009: folds 
Uncalled bet (400) returned to s70n3fac3
s70n3fac3 collected 200 from pot
s70n3fac3: doesn't show hand 
*** SUMMARY ***
Total pot 200 | Rake 0 
Seat 1: s70n3fac3 (button) (small blind) collected (200)
Seat 2: FDIBA2009 (big blind) folded before Flop



PokerStars Home Game Hand #227558502340: {Club #4781089}  Hold'em No Limit (50/100) - 2021/06/13 23:20:04 EET [2021/06/13 16:20:04 ET]
Table 'VTTP 1306' 2-max (Play Money) Seat #2 is the button
Seat 1: s70n3fac3 (14115 in chips) 
Seat 2: FDIBA2009 (12111 in chips) 
FDIBA2009: posts small blind 50
s70n3fac3: posts big blind 100
*** HOLE CARDS ***
FDIBA2009: raises 100 to 200
s70n3fac3: calls 100
*** FLOP *** [2h Ad 4d]
s70n3fac3: checks 
FDIBA2009: checks 
*** TURN *** [2h Ad 4d] [2c]
s70n3fac3: checks 
FDIBA2009: bets 378
s70n3fac3: folds 
Uncalled bet (378) returned to FDIBA2009
FDIBA2009 collected 378 from pot
FDIBA2009: doesn't show hand 
*** SUMMARY ***
Total pot 400 | Rake 22 
Board [2h Ad 4d 2c]
Seat 1: s70n3fac3 (big blind) folded on the Turn
Seat 2: FDIBA2009 (button) (small blind) collected (378)



PokerStars Home Game Hand #227558511246: {Club #4781089}  Hold'em No Limit (50/100) - 2021/06/13 23:20:20 EET [2021/06/13 16:20:20 ET]
Table 'VTTP 1306' 2-max (Play Money) Seat #1 is the button
Seat 1: s70n3fac3 (13915 in chips) 
Seat 2: FDIBA2009 (12289 in chips) 
s70n3fac3: posts small blind 50
FDIBA2009: posts big blind 100
*** HOLE CARDS ***
s70n3fac3: calls 50
FDIBA2009: checks 
*** FLOP *** [6h 2d 9s]
FDIBA2009: checks 
s70n3fac3: bets 200
FDIBA2009: calls 200
*** TURN *** [6h 2d 9s] [Qs]
FDIBA2009: checks 
s70n3fac3: bets 400
FDIBA2009: folds 
Uncalled bet (400) returned to s70n3fac3
s70n3fac3 collected 567 from pot
s70n3fac3: doesn't show hand 
*** SUMMARY ***
Total pot 600 | Rake 33 
Board [6h 2d 9s Qs]
Seat 1: s70n3fac3 (button) (small blind) collected (567)
Seat 2: FDIBA2009 (big blind) folded on the Turn



PokerStars Home Game Hand #227558520753: {Club #4781089}  Hold'em No Limit (50/100) - 2021/06/13 23:20:37 EET [2021/06/13 16:20:37 ET]
Table 'VTTP 1306' 2-max (Play Money) Seat #2 is the button
Seat 1: s70n3fac3 (14182 in chips) 
Seat 2: FDIBA2009 (11989 in chips) 
FDIBA2009: posts small blind 50
s70n3fac3: posts big blind 100
*** HOLE CARDS ***
FDIBA2009: folds 
Uncalled bet (50) returned to s70n3fac3
s70n3fac3 collected 100 from pot
s70n3fac3: doesn't show hand 
*** SUMMARY ***
Total pot 100 | Rake 0 
Seat 1: s70n3fac3 (big blind) collected (100)
Seat 2: FDIBA2009 (button) (small blind) folded before Flop



PokerStars Home Game Hand #227558523502: {Club #4781089}  Hold'em No Limit (50/100) - 2021/06/13 23:20:43 EET [2021/06/13 16:20:43 ET]
Table 'VTTP 1306' 2-max (Play Money) Seat #1 is the button
Seat 1: s70n3fac3 (14232 in chips) 
Seat 2: FDIBA2009 (11939 in chips) 
s70n3fac3: posts small blind 50
FDIBA2009: posts big blind 100
*** HOLE CARDS ***
s70n3fac3: raises 300 to 400
FDIBA2009: calls 300
*** FLOP *** [Js 4d 8s]
FDIBA2009: checks 
s70n3fac3: bets 600
FDIBA2009: calls 600
*** TURN *** [Js 4d 8s] [As]
FDIBA2009: checks 
s70n3fac3: bets 1100
FDIBA2009: folds 
Uncalled bet (1100) returned to s70n3fac3
s70n3fac3 collected 1890 from pot
s70n3fac3: doesn't show hand 
*** SUMMARY ***
Total pot 2000 | Rake 110 
Board [Js 4d 8s As]
Seat 1: s70n3fac3 (button) (small blind) collected (1890)
Seat 2: FDIBA2009 (big blind) folded on the Turn



PokerStars Home Game Hand #227558541183: {Club #4781089}  Hold'em No Limit (50/100) - 2021/06/13 23:21:08 EET [2021/06/13 16:21:08 ET]
Table 'VTTP 1306' 2-max (Play Money) Seat #2 is the button
Seat 1: s70n3fac3 (15122 in chips) 
Seat 2: FDIBA2009 (10939 in chips) 
FDIBA2009: posts small blind 50
s70n3fac3: posts big blind 100
*** HOLE CARDS ***
FDIBA2009: raises 100 to 200
s70n3fac3: folds 
Uncalled bet (100) returned to FDIBA2009
FDIBA2009 collected 200 from pot
FDIBA2009: doesn't show hand 
*** SUMMARY ***
Total pot 200 | Rake 0 
Seat 1: s70n3fac3 (big blind) folded before Flop
Seat 2: FDIBA2009 (button) (small blind) collected (200)



PokerStars Home Game Hand #227558544667: {Club #4781089}  Hold'em No Limit (50/100) - 2021/06/13 23:21:15 EET [2021/06/13 16:21:15 ET]
Table 'VTTP 1306' 2-max (Play Money) Seat #1 is the button
Seat 1: s70n3fac3 (15022 in chips) 
Seat 2: FDIBA2009 (11039 in chips) 
s70n3fac3: posts small blind 50
FDIBA2009: posts big blind 100
*** HOLE CARDS ***
s70n3fac3: raises 300 to 400
FDIBA2009: folds 
Uncalled bet (300) returned to s70n3fac3
s70n3fac3 collected 200 from pot
s70n3fac3: doesn't show hand 
*** SUMMARY ***
Total pot 200 | Rake 0 
Seat 1: s70n3fac3 (button) (small blind) collected (200)
Seat 2: FDIBA2009 (big blind) folded before Flop



PokerStars Home Game Hand #227558548128: {Club #4781089}  Hold'em No Limit (50/100) - 2021/06/13 23:21:21 EET [2021/06/13 16:21:21 ET]
Table 'VTTP 1306' 2-max (Play Money) Seat #2 is the button
Seat 1: s70n3fac3 (15122 in chips) 
Seat 2: FDIBA2009 (10939 in chips) 
FDIBA2009: posts small blind 50
s70n3fac3: posts big blind 100
*** HOLE CARDS ***
FDIBA2009: raises 100 to 200
s70n3fac3: calls 100
*** FLOP *** [6s 8c Ad]
s70n3fac3: checks 
FDIBA2009: bets 200
s70n3fac3: calls 200
*** TURN *** [6s 8c Ad] [4d]
s70n3fac3: checks 
FDIBA2009: bets 400
s70n3fac3: folds 
Uncalled bet (400) returned to FDIBA2009
FDIBA2009 collected 756 from pot
FDIBA2009: doesn't show hand 
*** SUMMARY ***
Total pot 800 | Rake 44 
Board [6s 8c Ad 4d]
Seat 1: s70n3fac3 (big blind) folded on the Turn
Seat 2: FDIBA2009 (button) (small blind) collected (756)



PokerStars Home Game Hand #227558558941: {Club #4781089}  Hold'em No Limit (50/100) - 2021/06/13 23:21:41 EET [2021/06/13 16:21:41 ET]
Table 'VTTP 1306' 2-max (Play Money) Seat #1 is the button
Seat 1: s70n3fac3 (14722 in chips) 
Seat 2: FDIBA2009 (11295 in chips) 
s70n3fac3: posts small blind 50
FDIBA2009: posts big blind 100
*** HOLE CARDS ***
s70n3fac3: raises 150 to 250
FDIBA2009: folds 
Uncalled bet (150) returned to s70n3fac3
s70n3fac3 collected 200 from pot
s70n3fac3: doesn't show hand 
*** SUMMARY ***
Total pot 200 | Rake 0 
Seat 1: s70n3fac3 (button) (small blind) collected (200)
Seat 2: FDIBA2009 (big blind) folded before Flop



PokerStars Home Game Hand #227558562038: {Club #4781089}  Hold'em No Limit (50/100) - 2021/06/13 23:21:47 EET [2021/06/13 16:21:47 ET]
Table 'VTTP 1306' 2-max (Play Money) Seat #2 is the button
Seat 1: s70n3fac3 (14822 in chips) 
Seat 2: FDIBA2009 (11195 in chips) 
FDIBA2009: posts small blind 50
s70n3fac3: posts big blind 100
*** HOLE CARDS ***
FDIBA2009: raises 100 to 200
s70n3fac3: calls 100
*** FLOP *** [2s 3s 5c]
s70n3fac3: checks 
FDIBA2009: checks 
*** TURN *** [2s 3s 5c] [6c]
s70n3fac3: checks 
FDIBA2009: bets 200
s70n3fac3: calls 200
*** RIVER *** [2s 3s 5c 6c] [9s]
s70n3fac3: checks 
FDIBA2009: bets 650
s70n3fac3: calls 650
*** SHOW DOWN ***
FDIBA2009: shows [4s Kd] (a straight, Deuce to Six)
s70n3fac3: mucks hand 
FDIBA2009 collected 1984 from pot
*** SUMMARY ***
Total pot 2100 | Rake 116 
Board [2s 3s 5c 6c 9s]
Seat 1: s70n3fac3 (big blind) mucked [8c 5h]
Seat 2: FDIBA2009 (button) (small blind) showed [4s Kd] and won (1984) with a straight, Deuce to Six



PokerStars Home Game Hand #227558580943: {Club #4781089}  Hold'em No Limit (50/100) - 2021/06/13 23:22:22 EET [2021/06/13 16:22:22 ET]
Table 'VTTP 1306' 2-max (Play Money) Seat #1 is the button
Seat 1: s70n3fac3 (13772 in chips) 
Seat 2: FDIBA2009 (12129 in chips) 
s70n3fac3: posts small blind 50
FDIBA2009: posts big blind 100
*** HOLE CARDS ***
s70n3fac3: calls 50
FDIBA2009: raises 200 to 300
s70n3fac3: calls 200
*** FLOP *** [8h 3s Qh]
FDIBA2009: checks 
s70n3fac3: checks 
*** TURN *** [8h 3s Qh] [3d]
FDIBA2009: checks 
s70n3fac3: checks 
*** RIVER *** [8h 3s Qh 3d] [9h]
FDIBA2009: bets 200
s70n3fac3: raises 1000 to 1200
FDIBA2009: folds 
Uncalled bet (1000) returned to s70n3fac3
s70n3fac3 collected 945 from pot
s70n3fac3: doesn't show hand 
*** SUMMARY ***
Total pot 1000 | Rake 55 
Board [8h 3s Qh 3d 9h]
Seat 1: s70n3fac3 (button) (small blind) collected (945)
Seat 2: FDIBA2009 (big blind) folded on the River



PokerStars Home Game Hand #227558596305: {Club #4781089}  Hold'em No Limit (50/100) - 2021/06/13 23:22:50 EET [2021/06/13 16:22:50 ET]
Table 'VTTP 1306' 2-max (Play Money) Seat #2 is the button
Seat 1: s70n3fac3 (14217 in chips) 
Seat 2: FDIBA2009 (11629 in chips) 
FDIBA2009: posts small blind 50
s70n3fac3: posts big blind 100
*** HOLE CARDS ***
FDIBA2009: calls 50
s70n3fac3: checks 
*** FLOP *** [6h Qc 3s]
s70n3fac3: checks 
FDIBA2009: bets 100
s70n3fac3: folds 
Uncalled bet (100) returned to FDIBA2009
FDIBA2009 collected 189 from pot
FDIBA2009: doesn't show hand 
*** SUMMARY ***
Total pot 200 | Rake 11 
Board [6h Qc 3s]
Seat 1: s70n3fac3 (big blind) folded on the Flop
Seat 2: FDIBA2009 (button) (small blind) collected (189)



PokerStars Home Game Hand #227558603177: {Club #4781089}  Hold'em No Limit (50/100) - 2021/06/13 23:23:03 EET [2021/06/13 16:23:03 ET]
Table 'VTTP 1306' 2-max (Play Money) Seat #1 is the button
Seat 1: s70n3fac3 (14117 in chips) 
Seat 2: FDIBA2009 (11718 in chips) 
s70n3fac3: posts small blind 50
FDIBA2009: posts big blind 100
*** HOLE CARDS ***
s70n3fac3: calls 50
FDIBA2009: raises 200 to 300
s70n3fac3: calls 200
*** FLOP *** [7c 9c Js]
FDIBA2009: bets 400
s70n3fac3: calls 400
*** TURN *** [7c 9c Js] [2s]
FDIBA2009: bets 950
s70n3fac3: calls 950
*** RIVER *** [7c 9c Js 2s] [Ks]
FDIBA2009: checks 
s70n3fac3: checks 
*** SHOW DOWN ***
FDIBA2009: shows [Qs Ac] (high card Ace)
s70n3fac3: shows [5h Jh] (a pair of Jacks)
s70n3fac3 collected 3118 from pot
*** SUMMARY ***
Total pot 3300 | Rake 182 
Board [7c 9c Js 2s Ks]
Seat 1: s70n3fac3 (button) (small blind) showed [5h Jh] and won (3118) with a pair of Jacks
Seat 2: FDIBA2009 (big blind) showed [Qs Ac] and lost with high card Ace



PokerStars Home Game Hand #227558619900: {Club #4781089}  Hold'em No Limit (50/100) - 2021/06/13 23:23:34 EET [2021/06/13 16:23:34 ET]
Table 'VTTP 1306' 2-max (Play Money) Seat #2 is the button
Seat 1: s70n3fac3 (15585 in chips) 
Seat 2: FDIBA2009 (10068 in chips) 
FDIBA2009: posts small blind 50
s70n3fac3: posts big blind 100
*** HOLE CARDS ***
FDIBA2009: folds 
Uncalled bet (50) returned to s70n3fac3
s70n3fac3 collected 100 from pot
s70n3fac3: doesn't show hand 
*** SUMMARY ***
Total pot 100 | Rake 0 
Seat 1: s70n3fac3 (big blind) collected (100)
Seat 2: FDIBA2009 (button) (small blind) folded before Flop



PokerStars Home Game Hand #227558623121: {Club #4781089}  Hold'em No Limit (50/100) - 2021/06/13 23:23:40 EET [2021/06/13 16:23:40 ET]
Table 'VTTP 1306' 2-max (Play Money) Seat #1 is the button
Seat 1: s70n3fac3 (15635 in chips) 
Seat 2: FDIBA2009 (10018 in chips) 
s70n3fac3: posts small blind 50
FDIBA2009: posts big blind 100
*** HOLE CARDS ***
s70n3fac3: raises 200 to 300
FDIBA2009: calls 200
*** FLOP *** [2d 3h 3s]
FDIBA2009: checks 
s70n3fac3: checks 
*** TURN *** [2d 3h 3s] [As]
FDIBA2009: bets 300
s70n3fac3: folds 
Uncalled bet (300) returned to FDIBA2009
FDIBA2009 collected 567 from pot
FDIBA2009: doesn't show hand 
*** SUMMARY ***
Total pot 600 | Rake 33 
Board [2d 3h 3s As]
Seat 1: s70n3fac3 (button) (small blind) folded on the Turn
Seat 2: FDIBA2009 (big blind) collected (567)



PokerStars Home Game Hand #227558632764: {Club #4781089}  Hold'em No Limit (50/100) - 2021/06/13 23:23:58 EET [2021/06/13 16:23:58 ET]
Table 'VTTP 1306' 2-max (Play Money) Seat #2 is the button
Seat 1: s70n3fac3 (15335 in chips) 
Seat 2: FDIBA2009 (10285 in chips) 
FDIBA2009: posts small blind 50
s70n3fac3: posts big blind 100
*** HOLE CARDS ***
FDIBA2009: raises 100 to 200
s70n3fac3: calls 100
*** FLOP *** [9d Qh 3s]
s70n3fac3: checks 
FDIBA2009: checks 
*** TURN *** [9d Qh 3s] [2h]
s70n3fac3: checks 
FDIBA2009: bets 378
s70n3fac3: folds 
Uncalled bet (378) returned to FDIBA2009
FDIBA2009 collected 378 from pot
FDIBA2009: doesn't show hand 
*** SUMMARY ***
Total pot 400 | Rake 22 
Board [9d Qh 3s 2h]
Seat 1: s70n3fac3 (big blind) folded on the Turn
Seat 2: FDIBA2009 (button) (small blind) collected (378)



PokerStars Home Game Hand #227558640102: {Club #4781089}  Hold'em No Limit (50/100) - 2021/06/13 23:24:12 EET [2021/06/13 16:24:12 ET]
Table 'VTTP 1306' 2-max (Play Money) Seat #1 is the button
Seat 1: s70n3fac3 (15135 in chips) 
Seat 2: FDIBA2009 (10463 in chips) 
s70n3fac3: posts small blind 50
FDIBA2009: posts big blind 100
*** HOLE CARDS ***
s70n3fac3: calls 50
FDIBA2009: raises 200 to 300
s70n3fac3: calls 200
*** FLOP *** [8h 9c 7h]
FDIBA2009: bets 300
s70n3fac3: calls 300
*** TURN *** [8h 9c 7h] [5c]
FDIBA2009: checks 
s70n3fac3: bets 600
FDIBA2009: calls 600
*** RIVER *** [8h 9c 7h 5c] [Kh]
FDIBA2009: checks 
s70n3fac3: bets 1200
FDIBA2009: folds 
Uncalled bet (1200) returned to s70n3fac3
s70n3fac3 collected 2268 from pot
s70n3fac3: doesn't show hand 
*** SUMMARY ***
Total pot 2400 | Rake 132 
Board [8h 9c 7h 5c Kh]
Seat 1: s70n3fac3 (button) (small blind) collected (2268)
Seat 2: FDIBA2009 (big blind) folded on the River



PokerStars Home Game Hand #227558663693: {Club #4781089}  Hold'em No Limit (50/100) - 2021/06/13 23:24:56 EET [2021/06/13 16:24:56 ET]
Table 'VTTP 1306' 2-max (Play Money) Seat #2 is the button
Seat 1: s70n3fac3 (16203 in chips) 
Seat 2: FDIBA2009 (9263 in chips) 
FDIBA2009: posts small blind 50
s70n3fac3: posts big blind 100
*** HOLE CARDS ***
FDIBA2009: raises 100 to 200
s70n3fac3: calls 100
*** FLOP *** [4c Ts Qd]
s70n3fac3: checks 
FDIBA2009: checks 
*** TURN *** [4c Ts Qd] [7s]
s70n3fac3: checks 
FDIBA2009: checks 
*** RIVER *** [4c Ts Qd 7s] [Ad]
s70n3fac3: checks 
FDIBA2009: bets 100
s70n3fac3: calls 100
*** SHOW DOWN ***
FDIBA2009: shows [Kh 6h] (high card Ace)
s70n3fac3: shows [6c Ks] (high card Ace)
s70n3fac3 collected 284 from pot
FDIBA2009 collected 283 from pot
*** SUMMARY ***
Total pot 600 | Rake 33 
Board [4c Ts Qd 7s Ad]
Seat 1: s70n3fac3 (big blind) showed [6c Ks] and won (284) with high card Ace
Seat 2: FDIBA2009 (button) (small blind) showed [Kh 6h] and won (283) with high card Ace



PokerStars Home Game Hand #227558673444: {Club #4781089}  Hold'em No Limit (50/100) - 2021/06/13 23:25:14 EET [2021/06/13 16:25:14 ET]
Table 'VTTP 1306' 2-max (Play Money) Seat #1 is the button
Seat 1: s70n3fac3 (16187 in chips) 
Seat 2: FDIBA2009 (9246 in chips) 
s70n3fac3: posts small blind 50
FDIBA2009: posts big blind 100
*** HOLE CARDS ***
s70n3fac3: calls 50
FDIBA2009: checks 
*** FLOP *** [3h 9s Jd]
FDIBA2009: checks 
s70n3fac3: checks 
*** TURN *** [3h 9s Jd] [6s]
FDIBA2009: checks 
s70n3fac3: checks 
*** RIVER *** [3h 9s Jd 6s] [9d]
FDIBA2009: checks 
s70n3fac3: checks 
*** SHOW DOWN ***
FDIBA2009: shows [2h 8d] (a pair of Nines)
s70n3fac3: shows [4d Td] (a pair of Nines - Jack+Ten kicker)
s70n3fac3 collected 189 from pot
*** SUMMARY ***
Total pot 200 | Rake 11 
Board [3h 9s Jd 6s 9d]
Seat 1: s70n3fac3 (button) (small blind) showed [4d Td] and won (189) with a pair of Nines
Seat 2: FDIBA2009 (big blind) showed [2h 8d] and lost with a pair of Nines



PokerStars Home Game Hand #227558682293: {Club #4781089}  Hold'em No Limit (50/100) - 2021/06/13 23:25:31 EET [2021/06/13 16:25:31 ET]
Table 'VTTP 1306' 2-max (Play Money) Seat #2 is the button
Seat 1: s70n3fac3 (16276 in chips) 
Seat 2: FDIBA2009 (9146 in chips) 
FDIBA2009: posts small blind 50
s70n3fac3: posts big blind 100
*** HOLE CARDS ***
FDIBA2009: raises 100 to 200
s70n3fac3: calls 100
*** FLOP *** [8c 9h 4d]
s70n3fac3: checks 
FDIBA2009: checks 
*** TURN *** [8c 9h 4d] [Qc]
s70n3fac3: checks 
FDIBA2009: bets 378
s70n3fac3: calls 378
*** RIVER *** [8c 9h 4d Qc] [3c]
s70n3fac3: checks 
FDIBA2009: bets 550
s70n3fac3: folds 
Uncalled bet (550) returned to FDIBA2009
FDIBA2009 collected 1092 from pot
FDIBA2009: doesn't show hand 
*** SUMMARY ***
Total pot 1156 | Rake 64 
Board [8c 9h 4d Qc 3c]
Seat 1: s70n3fac3 (big blind) folded on the River
Seat 2: FDIBA2009 (button) (small blind) collected (1092)



PokerStars Home Game Hand #227558695210: {Club #4781089}  Hold'em No Limit (50/100) - 2021/06/13 23:25:55 EET [2021/06/13 16:25:55 ET]
Table 'VTTP 1306' 2-max (Play Money) Seat #1 is the button
Seat 1: s70n3fac3 (15698 in chips) 
Seat 2: FDIBA2009 (9660 in chips) 
s70n3fac3: posts small blind 50
FDIBA2009: posts big blind 100
*** HOLE CARDS ***
s70n3fac3: calls 50
FDIBA2009: raises 100 to 200
s70n3fac3: calls 100
*** FLOP *** [4s 2h Th]
FDIBA2009: checks 
s70n3fac3: bets 300
FDIBA2009: folds 
Uncalled bet (300) returned to s70n3fac3
s70n3fac3 collected 378 from pot
s70n3fac3: doesn't show hand 
*** SUMMARY ***
Total pot 400 | Rake 22 
Board [4s 2h Th]
Seat 1: s70n3fac3 (button) (small blind) collected (378)
Seat 2: FDIBA2009 (big blind) folded on the Flop



PokerStars Home Game Hand #227558701836: {Club #4781089}  Hold'em No Limit (50/100) - 2021/06/13 23:26:07 EET [2021/06/13 16:26:07 ET]
Table 'VTTP 1306' 2-max (Play Money) Seat #2 is the button
Seat 1: s70n3fac3 (15876 in chips) 
Seat 2: FDIBA2009 (9460 in chips) 
FDIBA2009: posts small blind 50
s70n3fac3: posts big blind 100
*** HOLE CARDS ***
FDIBA2009: raises 150 to 250
s70n3fac3: calls 150
*** FLOP *** [4s 8d Ts]
s70n3fac3: checks 
FDIBA2009: bets 300
s70n3fac3: calls 300
*** TURN *** [4s 8d Ts] [Qd]
s70n3fac3: checks 
FDIBA2009: bets 700
s70n3fac3: calls 700
*** RIVER *** [4s 8d Ts Qd] [Jd]
s70n3fac3: checks 
FDIBA2009: checks 
*** SHOW DOWN ***
s70n3fac3: shows [6h 9d] (a straight, Eight to Queen)
FDIBA2009: mucks hand 
s70n3fac3 collected 2362 from pot
*** SUMMARY ***
Total pot 2500 | Rake 138 
Board [4s 8d Ts Qd Jd]
Seat 1: s70n3fac3 (big blind) showed [6h 9d] and won (2362) with a straight, Eight to Queen
Seat 2: FDIBA2009 (button) (small blind) mucked [Ks Tc]



PokerStars Home Game Hand #227558713017: {Club #4781089}  Hold'em No Limit (50/100) - 2021/06/13 23:26:28 EET [2021/06/13 16:26:28 ET]
Table 'VTTP 1306' 2-max (Play Money) Seat #1 is the button
Seat 1: s70n3fac3 (16988 in chips) 
Seat 2: FDIBA2009 (8210 in chips) 
s70n3fac3: posts small blind 50
FDIBA2009: posts big blind 100
*** HOLE CARDS ***
s70n3fac3: calls 50
FDIBA2009: raises 200 to 300
s70n3fac3: calls 200
*** FLOP *** [3h Kh 2d]
FDIBA2009: checks 
s70n3fac3: checks 
*** TURN *** [3h Kh 2d] [8d]
FDIBA2009: checks 
s70n3fac3: checks 
*** RIVER *** [3h Kh 2d 8d] [5c]
FDIBA2009: checks 
s70n3fac3: checks 
*** SHOW DOWN ***
FDIBA2009: shows [As 9d] (high card Ace)
s70n3fac3: mucks hand 
FDIBA2009 collected 567 from pot
*** SUMMARY ***
Total pot 600 | Rake 33 
Board [3h Kh 2d 8d 5c]
Seat 1: s70n3fac3 (button) (small blind) mucked [6s 7c]
Seat 2: FDIBA2009 (big blind) showed [As 9d] and won (567) with high card Ace



PokerStars Home Game Hand #227558729024: {Club #4781089}  Hold'em No Limit (50/100) - 2021/06/13 23:26:58 EET [2021/06/13 16:26:58 ET]
Table 'VTTP 1306' 2-max (Play Money) Seat #2 is the button
Seat 1: s70n3fac3 (16688 in chips) 
Seat 2: FDIBA2009 (8477 in chips) 
FDIBA2009: posts small blind 50
s70n3fac3: posts big blind 100
*** HOLE CARDS ***
FDIBA2009: raises 200 to 300
s70n3fac3: folds 
Uncalled bet (200) returned to FDIBA2009
FDIBA2009 collected 200 from pot
FDIBA2009: doesn't show hand 
*** SUMMARY ***
Total pot 200 | Rake 0 
Seat 1: s70n3fac3 (big blind) folded before Flop
Seat 2: FDIBA2009 (button) (small blind) collected (200)



PokerStars Home Game Hand #227558733061: {Club #4781089}  Hold'em No Limit (50/100) - 2021/06/13 23:27:06 EET [2021/06/13 16:27:06 ET]
Table 'VTTP 1306' 2-max (Play Money) Seat #1 is the button
Seat 1: s70n3fac3 (16588 in chips) 
Seat 2: FDIBA2009 (8577 in chips) 
s70n3fac3: posts small blind 50
FDIBA2009: posts big blind 100
*** HOLE CARDS ***
s70n3fac3: raises 400 to 500
FDIBA2009: folds 
Uncalled bet (400) returned to s70n3fac3
s70n3fac3 collected 200 from pot
s70n3fac3: doesn't show hand 
*** SUMMARY ***
Total pot 200 | Rake 0 
Seat 1: s70n3fac3 (button) (small blind) collected (200)
Seat 2: FDIBA2009 (big blind) folded before Flop



PokerStars Home Game Hand #227558736238: {Club #4781089}  Hold'em No Limit (50/100) - 2021/06/13 23:27:12 EET [2021/06/13 16:27:12 ET]
Table 'VTTP 1306' 2-max (Play Money) Seat #2 is the button
Seat 1: s70n3fac3 (16688 in chips) 
Seat 2: FDIBA2009 (8477 in chips) 
FDIBA2009: posts small blind 50
s70n3fac3: posts big blind 100
*** HOLE CARDS ***
FDIBA2009: raises 200 to 300
s70n3fac3: calls 200
*** FLOP *** [Qd 7h 6c]
s70n3fac3: checks 
FDIBA2009: checks 
*** TURN *** [Qd 7h 6c] [Td]
s70n3fac3: checks 
FDIBA2009: bets 567
s70n3fac3: calls 567
*** RIVER *** [Qd 7h 6c Td] [Ts]
s70n3fac3: checks 
FDIBA2009: checks 
*** SHOW DOWN ***
s70n3fac3: shows [4d 6s] (two pair, Tens and Sixes)
FDIBA2009: shows [Kd 7d] (two pair, Tens and Sevens)
FDIBA2009 collected 1639 from pot
*** SUMMARY ***
Total pot 1734 | Rake 95 
Board [Qd 7h 6c Td Ts]
Seat 1: s70n3fac3 (big blind) showed [4d 6s] and lost with two pair, Tens and Sixes
Seat 2: FDIBA2009 (button) (small blind) showed [Kd 7d] and won (1639) with two pair, Tens and Sevens



PokerStars Home Game Hand #227558745856: {Club #4781089}  Hold'em No Limit (50/100) - 2021/06/13 23:27:30 EET [2021/06/13 16:27:30 ET]
Table 'VTTP 1306' 2-max (Play Money) Seat #1 is the button
Seat 1: s70n3fac3 (15821 in chips) 
Seat 2: FDIBA2009 (9249 in chips) 
s70n3fac3: posts small blind 50
FDIBA2009: posts big blind 100
*** HOLE CARDS ***
s70n3fac3: folds 
Uncalled bet (50) returned to FDIBA2009
FDIBA2009 collected 100 from pot
FDIBA2009: doesn't show hand 
*** SUMMARY ***
Total pot 100 | Rake 0 
Seat 1: s70n3fac3 (button) (small blind) folded before Flop
Seat 2: FDIBA2009 (big blind) collected (100)



PokerStars Home Game Hand #227558747924: {Club #4781089}  Hold'em No Limit (50/100) - 2021/06/13 23:27:34 EET [2021/06/13 16:27:34 ET]
Table 'VTTP 1306' 2-max (Play Money) Seat #2 is the button
Seat 1: s70n3fac3 (15771 in chips) 
Seat 2: FDIBA2009 (9299 in chips) 
FDIBA2009: posts small blind 50
s70n3fac3: posts big blind 100
*** HOLE CARDS ***
FDIBA2009: raises 100 to 200
s70n3fac3: raises 600 to 800
FDIBA2009: calls 600
*** FLOP *** [7s Ks Kc]
s70n3fac3: checks 
FDIBA2009: bets 800
s70n3fac3: folds 
Uncalled bet (800) returned to FDIBA2009
FDIBA2009 collected 1512 from pot
FDIBA2009: doesn't show hand 
*** SUMMARY ***
Total pot 1600 | Rake 88 
Board [7s Ks Kc]
Seat 1: s70n3fac3 (big blind) folded on the Flop
Seat 2: FDIBA2009 (button) (small blind) collected (1512)



PokerStars Home Game Hand #227558756840: {Club #4781089}  Hold'em No Limit (50/100) - 2021/06/13 23:27:51 EET [2021/06/13 16:27:51 ET]
Table 'VTTP 1306' 2-max (Play Money) Seat #1 is the button
Seat 1: s70n3fac3 (14971 in chips) 
Seat 2: FDIBA2009 (10011 in chips) 
s70n3fac3: posts small blind 50
FDIBA2009: posts big blind 100
*** HOLE CARDS ***
s70n3fac3: folds 
Uncalled bet (50) returned to FDIBA2009
FDIBA2009 collected 100 from pot
FDIBA2009: doesn't show hand 
*** SUMMARY ***
Total pot 100 | Rake 0 
Seat 1: s70n3fac3 (button) (small blind) folded before Flop
Seat 2: FDIBA2009 (big blind) collected (100)



PokerStars Home Game Hand #227558759082: {Club #4781089}  Hold'em No Limit (50/100) - 2021/06/13 23:27:55 EET [2021/06/13 16:27:55 ET]
Table 'VTTP 1306' 2-max (Play Money) Seat #2 is the button
Seat 1: s70n3fac3 (14921 in chips) 
Seat 2: FDIBA2009 (10061 in chips) 
FDIBA2009: posts small blind 50
s70n3fac3: posts big blind 100
*** HOLE CARDS ***
FDIBA2009: raises 100 to 200
s70n3fac3: calls 100
*** FLOP *** [4d Ts 2d]
s70n3fac3: checks 
FDIBA2009: checks 
*** TURN *** [4d Ts 2d] [Jc]
s70n3fac3: checks 
FDIBA2009: checks 
*** RIVER *** [4d Ts 2d Jc] [3c]
s70n3fac3: checks 
FDIBA2009: bets 378
s70n3fac3: calls 378
*** SHOW DOWN ***
FDIBA2009: shows [6c 8d] (high card Jack)
s70n3fac3: shows [3s Qc] (a pair of Threes)
s70n3fac3 collected 1092 from pot
*** SUMMARY ***
Total pot 1156 | Rake 64 
Board [4d Ts 2d Jc 3c]
Seat 1: s70n3fac3 (big blind) showed [3s Qc] and won (1092) with a pair of Threes
Seat 2: FDIBA2009 (button) (small blind) showed [6c 8d] and lost with high card Jack



PokerStars Home Game Hand #227558766357: {Club #4781089}  Hold'em No Limit (50/100) - 2021/06/13 23:28:09 EET [2021/06/13 16:28:09 ET]
Table 'VTTP 1306' 2-max (Play Money) Seat #1 is the button
Seat 1: s70n3fac3 (15435 in chips) 
Seat 2: FDIBA2009 (9483 in chips) 
s70n3fac3: posts small blind 50
FDIBA2009: posts big blind 100
*** HOLE CARDS ***
s70n3fac3: folds 
Uncalled bet (50) returned to FDIBA2009
FDIBA2009 collected 100 from pot
FDIBA2009: doesn't show hand 
*** SUMMARY ***
Total pot 100 | Rake 0 
Seat 1: s70n3fac3 (button) (small blind) folded before Flop
Seat 2: FDIBA2009 (big blind) collected (100)



PokerStars Home Game Hand #227558768419: {Club #4781089}  Hold'em No Limit (50/100) - 2021/06/13 23:28:13 EET [2021/06/13 16:28:13 ET]
Table 'VTTP 1306' 2-max (Play Money) Seat #2 is the button
Seat 1: s70n3fac3 (15385 in chips) 
Seat 2: FDIBA2009 (9533 in chips) 
FDIBA2009: posts small blind 50
s70n3fac3: posts big blind 100
*** HOLE CARDS ***
FDIBA2009: raises 200 to 300
s70n3fac3: raises 700 to 1000
FDIBA2009: calls 700
*** FLOP *** [2h 7c Th]
s70n3fac3: checks 
FDIBA2009: checks 
*** TURN *** [2h 7c Th] [4s]
s70n3fac3: bets 1000
FDIBA2009: folds 
Uncalled bet (1000) returned to s70n3fac3
s70n3fac3 collected 1890 from pot
s70n3fac3: doesn't show hand 
*** SUMMARY ***
Total pot 2000 | Rake 110 
Board [2h 7c Th 4s]
Seat 1: s70n3fac3 (big blind) collected (1890)
Seat 2: FDIBA2009 (button) (small blind) folded on the Turn



PokerStars Home Game Hand #227558782970: {Club #4781089}  Hold'em No Limit (50/100) - 2021/06/13 23:28:41 EET [2021/06/13 16:28:41 ET]
Table 'VTTP 1306' 2-max (Play Money) Seat #1 is the button
Seat 1: s70n3fac3 (16275 in chips) 
Seat 2: FDIBA2009 (8533 in chips) 
s70n3fac3: posts small blind 50
FDIBA2009: posts big blind 100
*** HOLE CARDS ***
s70n3fac3: calls 50
FDIBA2009: checks 
*** FLOP *** [3s As 6d]
FDIBA2009: checks 
s70n3fac3: checks 
*** TURN *** [3s As 6d] [5c]
FDIBA2009: bets 189
s70n3fac3: calls 189
*** RIVER *** [3s As 6d 5c] [Qh]
FDIBA2009: checks 
s70n3fac3: checks 
*** SHOW DOWN ***
FDIBA2009: shows [4d 5s] (a pair of Fives)
s70n3fac3: mucks hand 
FDIBA2009 collected 546 from pot
*** SUMMARY ***
Total pot 578 | Rake 32 
Board [3s As 6d 5c Qh]
Seat 1: s70n3fac3 (button) (small blind) mucked [8c 4s]
Seat 2: FDIBA2009 (big blind) showed [4d 5s] and won (546) with a pair of Fives



PokerStars Home Game Hand #227558792464: {Club #4781089}  Hold'em No Limit (50/100) - 2021/06/13 23:28:59 EET [2021/06/13 16:28:59 ET]
Table 'VTTP 1306' 2-max (Play Money) Seat #2 is the button
Seat 1: s70n3fac3 (15986 in chips) 
Seat 2: FDIBA2009 (8790 in chips) 
FDIBA2009: posts small blind 50
s70n3fac3: posts big blind 100
*** HOLE CARDS ***
FDIBA2009: raises 200 to 300
s70n3fac3: calls 200
*** FLOP *** [Kh 4c Th]
s70n3fac3: checks 
FDIBA2009: bets 300
s70n3fac3: calls 300
*** TURN *** [Kh 4c Th] [As]
s70n3fac3: checks 
FDIBA2009: bets 650
s70n3fac3: folds 
Uncalled bet (650) returned to FDIBA2009
FDIBA2009 collected 1134 from pot
FDIBA2009: doesn't show hand 
*** SUMMARY ***
Total pot 1200 | Rake 66 
Board [Kh 4c Th As]
Seat 1: s70n3fac3 (big blind) folded on the Turn
Seat 2: FDIBA2009 (button) (small blind) collected (1134)



PokerStars Home Game Hand #227558803304: {Club #4781089}  Hold'em No Limit (50/100) - 2021/06/13 23:29:19 EET [2021/06/13 16:29:19 ET]
Table 'VTTP 1306' 2-max (Play Money) Seat #1 is the button
Seat 1: s70n3fac3 (15386 in chips) 
Seat 2: FDIBA2009 (9324 in chips) 
s70n3fac3: posts small blind 50
FDIBA2009: posts big blind 100
*** HOLE CARDS ***
s70n3fac3: calls 50
FDIBA2009: checks 
*** FLOP *** [6c Tc 3s]
FDIBA2009: checks 
s70n3fac3: checks 
*** TURN *** [6c Tc 3s] [Td]
FDIBA2009: bets 189
s70n3fac3: folds 
Uncalled bet (189) returned to FDIBA2009
FDIBA2009 collected 189 from pot
FDIBA2009: doesn't show hand 
*** SUMMARY ***
Total pot 200 | Rake 11 
Board [6c Tc 3s Td]
Seat 1: s70n3fac3 (button) (small blind) folded on the Turn
Seat 2: FDIBA2009 (big blind) collected (189)



PokerStars Home Game Hand #227558811092: {Club #4781089}  Hold'em No Limit (50/100) - 2021/06/13 23:29:34 EET [2021/06/13 16:29:34 ET]
Table 'VTTP 1306' 2-max (Play Money) Seat #2 is the button
Seat 1: s70n3fac3 (15286 in chips) 
Seat 2: FDIBA2009 (9413 in chips) 
FDIBA2009: posts small blind 50
s70n3fac3: posts big blind 100
*** HOLE CARDS ***
FDIBA2009: raises 100 to 200
s70n3fac3: calls 100
*** FLOP *** [Qd 5h 2d]
s70n3fac3: checks 
FDIBA2009: checks 
*** TURN *** [Qd 5h 2d] [7d]
s70n3fac3: checks 
FDIBA2009: bets 378
s70n3fac3: calls 378
*** RIVER *** [Qd 5h 2d 7d] [6c]
s70n3fac3: checks 
FDIBA2009: checks 
*** SHOW DOWN ***
s70n3fac3: shows [5c 4c] (a pair of Fives)
FDIBA2009: mucks hand 
s70n3fac3 collected 1092 from pot
*** SUMMARY ***
Total pot 1156 | Rake 64 
Board [Qd 5h 2d 7d 6c]
Seat 1: s70n3fac3 (big blind) showed [5c 4c] and won (1092) with a pair of Fives
Seat 2: FDIBA2009 (button) (small blind) mucked [8s Ad]



PokerStars Home Game Hand #227558822217: {Club #4781089}  Hold'em No Limit (50/100) - 2021/06/13 23:29:54 EET [2021/06/13 16:29:54 ET]
Table 'VTTP 1306' 2-max (Play Money) Seat #1 is the button
Seat 1: s70n3fac3 (15800 in chips) 
Seat 2: FDIBA2009 (8835 in chips) 
s70n3fac3: posts small blind 50
FDIBA2009: posts big blind 100
*** HOLE CARDS ***
s70n3fac3: raises 300 to 400
FDIBA2009: calls 300
*** FLOP *** [Ad 7h Ac]
FDIBA2009: checks 
s70n3fac3: bets 700
FDIBA2009: folds 
Uncalled bet (700) returned to s70n3fac3
s70n3fac3 collected 756 from pot
s70n3fac3: doesn't show hand 
*** SUMMARY ***
Total pot 800 | Rake 44 
Board [Ad 7h Ac]
Seat 1: s70n3fac3 (button) (small blind) collected (756)
Seat 2: FDIBA2009 (big blind) folded on the Flop



PokerStars Home Game Hand #227558831060: {Club #4781089}  Hold'em No Limit (50/100) - 2021/06/13 23:30:11 EET [2021/06/13 16:30:11 ET]
Table 'VTTP 1306' 2-max (Play Money) Seat #2 is the button
Seat 1: s70n3fac3 (16156 in chips) 
Seat 2: FDIBA2009 (8435 in chips) 
FDIBA2009: posts small blind 50
s70n3fac3: posts big blind 100
*** HOLE CARDS ***
FDIBA2009: raises 200 to 300
s70n3fac3: folds 
Uncalled bet (200) returned to FDIBA2009
FDIBA2009 collected 200 from pot
FDIBA2009: doesn't show hand 
*** SUMMARY ***
Total pot 200 | Rake 0 
Seat 1: s70n3fac3 (big blind) folded before Flop
Seat 2: FDIBA2009 (button) (small blind) collected (200)



PokerStars Home Game Hand #227558834812: {Club #4781089}  Hold'em No Limit (50/100) - 2021/06/13 23:30:18 EET [2021/06/13 16:30:18 ET]
Table 'VTTP 1306' 2-max (Play Money) Seat #1 is the button
Seat 1: s70n3fac3 (16056 in chips) 
Seat 2: FDIBA2009 (8535 in chips) 
s70n3fac3: posts small blind 50
FDIBA2009: posts big blind 100
*** HOLE CARDS ***
s70n3fac3: raises 150 to 250
FDIBA2009: folds 
Uncalled bet (150) returned to s70n3fac3
s70n3fac3 collected 200 from pot
s70n3fac3: doesn't show hand 
*** SUMMARY ***
Total pot 200 | Rake 0 
Seat 1: s70n3fac3 (button) (small blind) collected (200)
Seat 2: FDIBA2009 (big blind) folded before Flop



PokerStars Home Game Hand #227558838435: {Club #4781089}  Hold'em No Limit (50/100) - 2021/06/13 23:30:25 EET [2021/06/13 16:30:25 ET]
Table 'VTTP 1306' 2-max (Play Money) Seat #2 is the button
Seat 1: s70n3fac3 (16156 in chips) 
Seat 2: FDIBA2009 (8435 in chips) 
FDIBA2009: posts small blind 50
s70n3fac3: posts big blind 100
*** HOLE CARDS ***
FDIBA2009: raises 100 to 200
s70n3fac3: folds 
Uncalled bet (100) returned to FDIBA2009
FDIBA2009 collected 200 from pot
FDIBA2009: doesn't show hand 
*** SUMMARY ***
Total pot 200 | Rake 0 
Seat 1: s70n3fac3 (big blind) folded before Flop
Seat 2: FDIBA2009 (button) (small blind) collected (200)



PokerStars Home Game Hand #227558842679: {Club #4781089}  Hold'em No Limit (50/100) - 2021/06/13 23:30:33 EET [2021/06/13 16:30:33 ET]
Table 'VTTP 1306' 2-max (Play Money) Seat #1 is the button
Seat 1: s70n3fac3 (16056 in chips) 
Seat 2: FDIBA2009 (8535 in chips) 
s70n3fac3: posts small blind 50
FDIBA2009: posts big blind 100
*** HOLE CARDS ***
s70n3fac3: calls 50
FDIBA2009: raises 200 to 300
s70n3fac3: calls 200
*** FLOP *** [6h Kc Td]
FDIBA2009: bets 300
s70n3fac3: folds 
Uncalled bet (300) returned to FDIBA2009
FDIBA2009 collected 567 from pot
FDIBA2009: doesn't show hand 
*** SUMMARY ***
Total pot 600 | Rake 33 
Board [6h Kc Td]
Seat 1: s70n3fac3 (button) (small blind) folded on the Flop
Seat 2: FDIBA2009 (big blind) collected (567)



PokerStars Home Game Hand #227558849383: {Club #4781089}  Hold'em No Limit (50/100) - 2021/06/13 23:30:45 EET [2021/06/13 16:30:45 ET]
Table 'VTTP 1306' 2-max (Play Money) Seat #2 is the button
Seat 1: s70n3fac3 (15756 in chips) 
Seat 2: FDIBA2009 (8802 in chips) 
FDIBA2009: posts small blind 50
s70n3fac3: posts big blind 100
*** HOLE CARDS ***
FDIBA2009: raises 100 to 200
s70n3fac3: calls 100
*** FLOP *** [Jh 9d 8h]
s70n3fac3: checks 
FDIBA2009: checks 
*** TURN *** [Jh 9d 8h] [5h]
s70n3fac3: checks 
FDIBA2009: bets 200
s70n3fac3: calls 200
*** RIVER *** [Jh 9d 8h 5h] [Ks]
s70n3fac3: checks 
FDIBA2009: checks 
*** SHOW DOWN ***
s70n3fac3: shows [2c 8c] (a pair of Eights)
FDIBA2009: mucks hand 
s70n3fac3 collected 756 from pot
*** SUMMARY ***
Total pot 800 | Rake 44 
Board [Jh 9d 8h 5h Ks]
Seat 1: s70n3fac3 (big blind) showed [2c 8c] and won (756) with a pair of Eights
Seat 2: FDIBA2009 (button) (small blind) mucked [6h As]



PokerStars Home Game Hand #227558858977: {Club #4781089}  Hold'em No Limit (50/100) - 2021/06/13 23:31:03 EET [2021/06/13 16:31:03 ET]
Table 'VTTP 1306' 2-max (Play Money) Seat #1 is the button
Seat 1: s70n3fac3 (16112 in chips) 
Seat 2: FDIBA2009 (8402 in chips) 
s70n3fac3: posts small blind 50
FDIBA2009: posts big blind 100
*** HOLE CARDS ***
s70n3fac3: raises 200 to 300
FDIBA2009: calls 200
*** FLOP *** [Js Th 7h]
FDIBA2009: checks 
s70n3fac3: bets 500
FDIBA2009: folds 
Uncalled bet (500) returned to s70n3fac3
s70n3fac3 collected 567 from pot
s70n3fac3: doesn't show hand 
*** SUMMARY ***
Total pot 600 | Rake 33 
Board [Js Th 7h]
Seat 1: s70n3fac3 (button) (small blind) collected (567)
Seat 2: FDIBA2009 (big blind) folded on the Flop



PokerStars Home Game Hand #227558866555: {Club #4781089}  Hold'em No Limit (50/100) - 2021/06/13 23:31:18 EET [2021/06/13 16:31:18 ET]
Table 'VTTP 1306' 2-max (Play Money) Seat #2 is the button
Seat 1: s70n3fac3 (16379 in chips) 
Seat 2: FDIBA2009 (8102 in chips) 
FDIBA2009: posts small blind 50
s70n3fac3: posts big blind 100
*** HOLE CARDS ***
FDIBA2009: raises 100 to 200
s70n3fac3: calls 100
*** FLOP *** [8h Kc 7d]
s70n3fac3: checks 
FDIBA2009: bets 250
s70n3fac3: calls 250
*** TURN *** [8h Kc 7d] [Ah]
s70n3fac3: checks 
FDIBA2009: checks 
*** RIVER *** [8h Kc 7d Ah] [4s]
s70n3fac3: bets 600
FDIBA2009: folds 
Uncalled bet (600) returned to s70n3fac3
s70n3fac3 collected 850 from pot
s70n3fac3: doesn't show hand 
*** SUMMARY ***
Total pot 900 | Rake 50 
Board [8h Kc 7d Ah 4s]
Seat 1: s70n3fac3 (big blind) collected (850)
Seat 2: FDIBA2009 (button) (small blind) folded on the River



PokerStars Home Game Hand #227558881323: {Club #4781089}  Hold'em No Limit (50/100) - 2021/06/13 23:31:39 EET [2021/06/13 16:31:39 ET]
Table 'VTTP 1306' 2-max (Play Money) Seat #1 is the button
Seat 1: s70n3fac3 (16779 in chips) 
Seat 2: FDIBA2009 (7652 in chips) 
s70n3fac3: posts small blind 50
FDIBA2009: posts big blind 100
*** HOLE CARDS ***
s70n3fac3: calls 50
FDIBA2009: raises 200 to 300
s70n3fac3: calls 200
*** FLOP *** [Jc 3d 5d]
FDIBA2009: checks 
s70n3fac3: bets 700
FDIBA2009: folds 
Uncalled bet (700) returned to s70n3fac3
s70n3fac3 collected 567 from pot
s70n3fac3: doesn't show hand 
*** SUMMARY ***
Total pot 600 | Rake 33 
Board [Jc 3d 5d]
Seat 1: s70n3fac3 (button) (small blind) collected (567)
Seat 2: FDIBA2009 (big blind) folded on the Flop



PokerStars Home Game Hand #227558890942: {Club #4781089}  Hold'em No Limit (50/100) - 2021/06/13 23:31:53 EET [2021/06/13 16:31:53 ET]
Table 'VTTP 1306' 2-max (Play Money) Seat #2 is the button
Seat 1: s70n3fac3 (17046 in chips) 
Seat 2: FDIBA2009 (7352 in chips) 
FDIBA2009: posts small blind 50
s70n3fac3: posts big blind 100
*** HOLE CARDS ***
FDIBA2009: raises 100 to 200
s70n3fac3: folds 
Uncalled bet (100) returned to FDIBA2009
FDIBA2009 collected 200 from pot
FDIBA2009: doesn't show hand 
*** SUMMARY ***
Total pot 200 | Rake 0 
Seat 1: s70n3fac3 (big blind) folded before Flop
Seat 2: FDIBA2009 (button) (small blind) collected (200)



PokerStars Home Game Hand #227558894385: {Club #4781089}  Hold'em No Limit (50/100) - 2021/06/13 23:32:00 EET [2021/06/13 16:32:00 ET]
Table 'VTTP 1306' 2-max (Play Money) Seat #1 is the button
Seat 1: s70n3fac3 (16946 in chips) 
Seat 2: FDIBA2009 (7452 in chips) 
s70n3fac3: posts small blind 50
FDIBA2009: posts big blind 100
*** HOLE CARDS ***
s70n3fac3: calls 50
FDIBA2009: checks 
*** FLOP *** [3c Jd 4s]
FDIBA2009: checks 
s70n3fac3: bets 200
FDIBA2009: calls 200
*** TURN *** [3c Jd 4s] [As]
FDIBA2009: checks 
s70n3fac3: bets 500
FDIBA2009: folds 
Uncalled bet (500) returned to s70n3fac3
s70n3fac3 collected 567 from pot
s70n3fac3: doesn't show hand 
*** SUMMARY ***
Total pot 600 | Rake 33 
Board [3c Jd 4s As]
Seat 1: s70n3fac3 (button) (small blind) collected (567)
Seat 2: FDIBA2009 (big blind) folded on the Turn



PokerStars Home Game Hand #227558902622: {Club #4781089}  Hold'em No Limit (50/100) - 2021/06/13 23:32:16 EET [2021/06/13 16:32:16 ET]
Table 'VTTP 1306' 2-max (Play Money) Seat #2 is the button
Seat 1: s70n3fac3 (17213 in chips) 
Seat 2: FDIBA2009 (7152 in chips) 
FDIBA2009: posts small blind 50
s70n3fac3: posts big blind 100
*** HOLE CARDS ***
FDIBA2009: raises 100 to 200
s70n3fac3: calls 100
*** FLOP *** [Kh 4c 8h]
s70n3fac3: checks 
FDIBA2009: checks 
*** TURN *** [Kh 4c 8h] [2c]
s70n3fac3: checks 
FDIBA2009: checks 
*** RIVER *** [Kh 4c 8h 2c] [2d]
s70n3fac3: checks 
FDIBA2009: bets 378
s70n3fac3: calls 378
*** SHOW DOWN ***
FDIBA2009: shows [5s 9d] (a pair of Deuces)
s70n3fac3: shows [7d Ac] (a pair of Deuces - Ace kicker)
s70n3fac3 collected 1092 from pot
*** SUMMARY ***
Total pot 1156 | Rake 64 
Board [Kh 4c 8h 2c 2d]
Seat 1: s70n3fac3 (big blind) showed [7d Ac] and won (1092) with a pair of Deuces
Seat 2: FDIBA2009 (button) (small blind) showed [5s 9d] and lost with a pair of Deuces



PokerStars Home Game Hand #227558911006: {Club #4781089}  Hold'em No Limit (50/100) - 2021/06/13 23:32:33 EET [2021/06/13 16:32:33 ET]
Table 'VTTP 1306' 2-max (Play Money) Seat #1 is the button
Seat 1: s70n3fac3 (17727 in chips) 
Seat 2: FDIBA2009 (6574 in chips) 
s70n3fac3: posts small blind 50
FDIBA2009: posts big blind 100
*** HOLE CARDS ***
s70n3fac3: calls 50
FDIBA2009: checks 
*** FLOP *** [Jh 3h Kh]
FDIBA2009: checks 
s70n3fac3: checks 
*** TURN *** [Jh 3h Kh] [Tc]
FDIBA2009: bets 189
s70n3fac3: calls 189
*** RIVER *** [Jh 3h Kh Tc] [Ts]
FDIBA2009: checks 
s70n3fac3: checks 
*** SHOW DOWN ***
FDIBA2009: shows [Jc 4h] (two pair, Jacks and Tens)
s70n3fac3: mucks hand 
FDIBA2009 collected 546 from pot
*** SUMMARY ***
Total pot 578 | Rake 32 
Board [Jh 3h Kh Tc Ts]
Seat 1: s70n3fac3 (button) (small blind) mucked [3d Qh]
Seat 2: FDIBA2009 (big blind) showed [Jc 4h] and won (546) with two pair, Jacks and Tens



PokerStars Home Game Hand #227558921280: {Club #4781089}  Hold'em No Limit (50/100) - 2021/06/13 23:32:52 EET [2021/06/13 16:32:52 ET]
Table 'VTTP 1306' 2-max (Play Money) Seat #2 is the button
Seat 1: s70n3fac3 (17438 in chips) 
Seat 2: FDIBA2009 (6831 in chips) 
FDIBA2009: posts small blind 50
s70n3fac3: posts big blind 100
*** HOLE CARDS ***
FDIBA2009: raises 200 to 300
s70n3fac3: calls 200
*** FLOP *** [6c 3s 4d]
s70n3fac3: checks 
FDIBA2009: bets 300
s70n3fac3: folds 
Uncalled bet (300) returned to FDIBA2009
FDIBA2009 collected 567 from pot
FDIBA2009: doesn't show hand 
*** SUMMARY ***
Total pot 600 | Rake 33 
Board [6c 3s 4d]
Seat 1: s70n3fac3 (big blind) folded on the Flop
Seat 2: FDIBA2009 (button) (small blind) collected (567)



PokerStars Home Game Hand #227558928639: {Club #4781089}  Hold'em No Limit (50/100) - 2021/06/13 23:33:07 EET [2021/06/13 16:33:07 ET]
Table 'VTTP 1306' 2-max (Play Money) Seat #1 is the button
Seat 1: s70n3fac3 (17138 in chips) 
Seat 2: FDIBA2009 (7098 in chips) 
s70n3fac3: posts small blind 50
FDIBA2009: posts big blind 100
*** HOLE CARDS ***
s70n3fac3: folds 
Uncalled bet (50) returned to FDIBA2009
FDIBA2009 collected 100 from pot
FDIBA2009: doesn't show hand 
*** SUMMARY ***
Total pot 100 | Rake 0 
Seat 1: s70n3fac3 (button) (small blind) folded before Flop
Seat 2: FDIBA2009 (big blind) collected (100)



PokerStars Home Game Hand #227558930743: {Club #4781089}  Hold'em No Limit (50/100) - 2021/06/13 23:33:11 EET [2021/06/13 16:33:11 ET]
Table 'VTTP 1306' 2-max (Play Money) Seat #2 is the button
Seat 1: s70n3fac3 (17088 in chips) 
Seat 2: FDIBA2009 (7148 in chips) 
FDIBA2009: posts small blind 50
s70n3fac3: posts big blind 100
*** HOLE CARDS ***
FDIBA2009: folds 
Uncalled bet (50) returned to s70n3fac3
s70n3fac3 collected 100 from pot
s70n3fac3: doesn't show hand 
*** SUMMARY ***
Total pot 100 | Rake 0 
Seat 1: s70n3fac3 (big blind) collected (100)
Seat 2: FDIBA2009 (button) (small blind) folded before Flop



PokerStars Home Game Hand #227558933415: {Club #4781089}  Hold'em No Limit (50/100) - 2021/06/13 23:33:16 EET [2021/06/13 16:33:16 ET]
Table 'VTTP 1306' 2-max (Play Money) Seat #1 is the button
Seat 1: s70n3fac3 (17138 in chips) 
Seat 2: FDIBA2009 (7098 in chips) 
s70n3fac3: posts small blind 50
FDIBA2009: posts big blind 100
*** HOLE CARDS ***
s70n3fac3: calls 50
FDIBA2009: checks 
*** FLOP *** [8c Th 9c]
FDIBA2009: checks 
s70n3fac3: checks 
*** TURN *** [8c Th 9c] [Ts]
FDIBA2009: bets 189
s70n3fac3: calls 189
*** RIVER *** [8c Th 9c Ts] [4h]
FDIBA2009: bets 550
s70n3fac3: folds 
Uncalled bet (550) returned to FDIBA2009
FDIBA2009 collected 546 from pot
FDIBA2009: doesn't show hand 
*** SUMMARY ***
Total pot 578 | Rake 32 
Board [8c Th 9c Ts 4h]
Seat 1: s70n3fac3 (button) (small blind) folded on the River
Seat 2: FDIBA2009 (big blind) collected (546)



PokerStars Home Game Hand #227558943763: {Club #4781089}  Hold'em No Limit (50/100) - 2021/06/13 23:33:36 EET [2021/06/13 16:33:36 ET]
Table 'VTTP 1306' 2-max (Play Money) Seat #2 is the button
Seat 1: s70n3fac3 (16849 in chips) 
Seat 2: FDIBA2009 (7355 in chips) 
FDIBA2009: posts small blind 50
s70n3fac3: posts big blind 100
*** HOLE CARDS ***
FDIBA2009: raises 100 to 200
s70n3fac3: calls 100
*** FLOP *** [6h Kh 8s]
s70n3fac3: checks 
FDIBA2009: bets 200
s70n3fac3: calls 200
*** TURN *** [6h Kh 8s] [9c]
s70n3fac3: checks 
FDIBA2009: bets 500
s70n3fac3: folds 
Uncalled bet (500) returned to FDIBA2009
FDIBA2009 collected 756 from pot
FDIBA2009: doesn't show hand 
*** SUMMARY ***
Total pot 800 | Rake 44 
Board [6h Kh 8s 9c]
Seat 1: s70n3fac3 (big blind) folded on the Turn
Seat 2: FDIBA2009 (button) (small blind) collected (756)



PokerStars Home Game Hand #227558952270: {Club #4781089}  Hold'em No Limit (50/100) - 2021/06/13 23:33:52 EET [2021/06/13 16:33:52 ET]
Table 'VTTP 1306' 2-max (Play Money) Seat #1 is the button
Seat 1: s70n3fac3 (16449 in chips) 
Seat 2: FDIBA2009 (7711 in chips) 
s70n3fac3: posts small blind 50
FDIBA2009: posts big blind 100
*** HOLE CARDS ***
s70n3fac3: raises 300 to 400
FDIBA2009: calls 300
*** FLOP *** [8c 6s 4c]
FDIBA2009: checks 
s70n3fac3: checks 
*** TURN *** [8c 6s 4c] [Jc]
FDIBA2009: checks 
s70n3fac3: checks 
*** RIVER *** [8c 6s 4c Jc] [Qd]
FDIBA2009: bets 450
s70n3fac3: folds 
Uncalled bet (450) returned to FDIBA2009
FDIBA2009 collected 756 from pot
FDIBA2009: doesn't show hand 
*** SUMMARY ***
Total pot 800 | Rake 44 
Board [8c 6s 4c Jc Qd]
Seat 1: s70n3fac3 (button) (small blind) folded on the River
Seat 2: FDIBA2009 (big blind) collected (756)



PokerStars Home Game Hand #227558963551: {Club #4781089}  Hold'em No Limit (50/100) - 2021/06/13 23:34:14 EET [2021/06/13 16:34:14 ET]
Table 'VTTP 1306' 2-max (Play Money) Seat #2 is the button
Seat 1: s70n3fac3 (16049 in chips) 
Seat 2: FDIBA2009 (8067 in chips) 
FDIBA2009: posts small blind 50
s70n3fac3: posts big blind 100
*** HOLE CARDS ***
FDIBA2009: raises 100 to 200
s70n3fac3: raises 700 to 900
FDIBA2009: folds 
Uncalled bet (700) returned to s70n3fac3
s70n3fac3 collected 400 from pot
s70n3fac3: doesn't show hand 
*** SUMMARY ***
Total pot 400 | Rake 0 
Seat 1: s70n3fac3 (big blind) collected (400)
Seat 2: FDIBA2009 (button) (small blind) folded before Flop



PokerStars Home Game Hand #227558968629: {Club #4781089}  Hold'em No Limit (50/100) - 2021/06/13 23:34:24 EET [2021/06/13 16:34:24 ET]
Table 'VTTP 1306' 2-max (Play Money) Seat #1 is the button
Seat 1: s70n3fac3 (16249 in chips) 
Seat 2: FDIBA2009 (7867 in chips) 
s70n3fac3: posts small blind 50
FDIBA2009: posts big blind 100
*** HOLE CARDS ***
s70n3fac3: folds 
Uncalled bet (50) returned to FDIBA2009
FDIBA2009 collected 100 from pot
FDIBA2009: doesn't show hand 
*** SUMMARY ***
Total pot 100 | Rake 0 
Seat 1: s70n3fac3 (button) (small blind) folded before Flop
Seat 2: FDIBA2009 (big blind) collected (100)



PokerStars Home Game Hand #227558970735: {Club #4781089}  Hold'em No Limit (50/100) - 2021/06/13 23:34:28 EET [2021/06/13 16:34:28 ET]
Table 'VTTP 1306' 2-max (Play Money) Seat #2 is the button
Seat 1: s70n3fac3 (16199 in chips) 
Seat 2: FDIBA2009 (7917 in chips) 
FDIBA2009: posts small blind 50
s70n3fac3: posts big blind 100
*** HOLE CARDS ***
FDIBA2009: raises 100 to 200
s70n3fac3: calls 100
*** FLOP *** [5s As 2h]
s70n3fac3: checks 
FDIBA2009: bets 100
s70n3fac3: calls 100
*** TURN *** [5s As 2h] [7h]
s70n3fac3: checks 
FDIBA2009: checks 
*** RIVER *** [5s As 2h 7h] [Qh]
s70n3fac3: checks 
FDIBA2009: checks 
*** SHOW DOWN ***
s70n3fac3: shows [4h 4c] (a pair of Fours)
FDIBA2009: mucks hand 
s70n3fac3 collected 567 from pot
*** SUMMARY ***
Total pot 600 | Rake 33 
Board [5s As 2h 7h Qh]
Seat 1: s70n3fac3 (big blind) showed [4h 4c] and won (567) with a pair of Fours
Seat 2: FDIBA2009 (button) (small blind) mucked [Th 2s]



PokerStars Home Game Hand #227558979848: {Club #4781089}  Hold'em No Limit (50/100) - 2021/06/13 23:34:46 EET [2021/06/13 16:34:46 ET]
Table 'VTTP 1306' 2-max (Play Money) Seat #1 is the button
Seat 1: s70n3fac3 (16466 in chips) 
Seat 2: FDIBA2009 (7617 in chips) 
s70n3fac3: posts small blind 50
FDIBA2009: posts big blind 100
*** HOLE CARDS ***
s70n3fac3: folds 
Uncalled bet (50) returned to FDIBA2009
FDIBA2009 collected 100 from pot
FDIBA2009: doesn't show hand 
*** SUMMARY ***
Total pot 100 | Rake 0 
Seat 1: s70n3fac3 (button) (small blind) folded before Flop
Seat 2: FDIBA2009 (big blind) collected (100)



PokerStars Home Game Hand #227558981915: {Club #4781089}  Hold'em No Limit (50/100) - 2021/06/13 23:34:50 EET [2021/06/13 16:34:50 ET]
Table 'VTTP 1306' 2-max (Play Money) Seat #2 is the button
Seat 1: s70n3fac3 (16416 in chips) 
Seat 2: FDIBA2009 (7667 in chips) 
FDIBA2009: posts small blind 50
s70n3fac3: posts big blind 100
*** HOLE CARDS ***
FDIBA2009: calls 50
s70n3fac3: checks 
*** FLOP *** [Kc 3h 9h]
s70n3fac3: checks 
FDIBA2009: checks 
*** TURN *** [Kc 3h 9h] [7h]
s70n3fac3: checks 
FDIBA2009: checks 
*** RIVER *** [Kc 3h 9h 7h] [3d]
s70n3fac3: checks 
FDIBA2009: checks 
*** SHOW DOWN ***
s70n3fac3: shows [As 6d] (a pair of Threes)
FDIBA2009: mucks hand 
s70n3fac3 collected 189 from pot
*** SUMMARY ***
Total pot 200 | Rake 11 
Board [Kc 3h 9h 7h 3d]
Seat 1: s70n3fac3 (big blind) showed [As 6d] and won (189) with a pair of Threes
Seat 2: FDIBA2009 (button) (small blind) mucked [Qc 4h]



PokerStars Home Game Hand #227558991118: {Club #4781089}  Hold'em No Limit (50/100) - 2021/06/13 23:35:07 EET [2021/06/13 16:35:07 ET]
Table 'VTTP 1306' 2-max (Play Money) Seat #1 is the button
Seat 1: s70n3fac3 (16505 in chips) 
Seat 2: FDIBA2009 (7567 in chips) 
s70n3fac3: posts small blind 50
FDIBA2009: posts big blind 100
*** HOLE CARDS ***
s70n3fac3: raises 400 to 500
FDIBA2009: calls 400
*** FLOP *** [Ks 5s 9s]
FDIBA2009: checks 
s70n3fac3: bets 800
FDIBA2009: raises 2545 to 3345
s70n3fac3: raises 12655 to 16000
FDIBA2009: calls 3722 and is all-in
Uncalled bet (8933) returned to s70n3fac3
*** TURN *** [Ks 5s 9s] [Tc]
*** RIVER *** [Ks 5s 9s Tc] [3s]
*** SHOW DOWN ***
FDIBA2009: shows [9d Kd] (two pair, Kings and Nines)
s70n3fac3: shows [Qd As] (a flush, Ace high)
s70n3fac3 collected 14302 from pot
*** SUMMARY ***
Total pot 15134 | Rake 832 
Board [Ks 5s 9s Tc 3s]
Seat 1: s70n3fac3 (button) (small blind) showed [Qd As] and won (14302) with a flush, Ace high
Seat 2: FDIBA2009 (big blind) showed [9d Kd] and lost with two pair, Kings and Nines



PokerStars Home Game Hand #227559014566: {Club #4781089}  Hold'em No Limit (50/100) - 2021/06/13 23:35:54 EET [2021/06/13 16:35:54 ET]
Table 'VTTP 1306' 2-max (Play Money) Seat #2 is the button
Seat 1: s70n3fac3 (23240 in chips) 
Seat 2: FDIBA2009 (10000 in chips) 
FDIBA2009: posts small blind 50
s70n3fac3: posts big blind 100
*** HOLE CARDS ***
FDIBA2009: calls 50
s70n3fac3: checks 
*** FLOP *** [7s Qd Kc]
s70n3fac3: checks 
FDIBA2009: checks 
*** TURN *** [7s Qd Kc] [Td]
s70n3fac3: checks 
FDIBA2009: checks 
*** RIVER *** [7s Qd Kc Td] [8h]
s70n3fac3: checks 
FDIBA2009: bets 200
s70n3fac3: folds 
Uncalled bet (200) returned to FDIBA2009
FDIBA2009 collected 189 from pot
FDIBA2009: doesn't show hand 
*** SUMMARY ***
Total pot 200 | Rake 11 
Board [7s Qd Kc Td 8h]
Seat 1: s70n3fac3 (big blind) folded on the River
Seat 2: FDIBA2009 (button) (small blind) collected (189)



PokerStars Home Game Hand #227559025801: {Club #4781089}  Hold'em No Limit (50/100) - 2021/06/13 23:36:16 EET [2021/06/13 16:36:16 ET]
Table 'VTTP 1306' 2-max (Play Money) Seat #1 is the button
Seat 1: s70n3fac3 (23140 in chips) 
Seat 2: FDIBA2009 (10089 in chips) 
s70n3fac3: posts small blind 50
FDIBA2009: posts big blind 100
*** HOLE CARDS ***
s70n3fac3: calls 50
FDIBA2009: checks 
*** FLOP *** [8h Jh Ks]
FDIBA2009: checks 
s70n3fac3: bets 200
FDIBA2009: folds 
Uncalled bet (200) returned to s70n3fac3
s70n3fac3 collected 189 from pot
s70n3fac3: doesn't show hand 
*** SUMMARY ***
Total pot 200 | Rake 11 
Board [8h Jh Ks]
Seat 1: s70n3fac3 (button) (small blind) collected (189)
Seat 2: FDIBA2009 (big blind) folded on the Flop



PokerStars Home Game Hand #227559032768: {Club #4781089}  Hold'em No Limit (50/100) - 2021/06/13 23:36:30 EET [2021/06/13 16:36:30 ET]
Table 'VTTP 1306' 2-max (Play Money) Seat #2 is the button
Seat 1: s70n3fac3 (23229 in chips) 
Seat 2: FDIBA2009 (9989 in chips) 
FDIBA2009: posts small blind 50
s70n3fac3: posts big blind 100
*** HOLE CARDS ***
FDIBA2009: raises 250 to 350
s70n3fac3: folds 
Uncalled bet (250) returned to FDIBA2009
FDIBA2009 collected 200 from pot
FDIBA2009: doesn't show hand 
*** SUMMARY ***
Total pot 200 | Rake 0 
Seat 1: s70n3fac3 (big blind) folded before Flop
Seat 2: FDIBA2009 (button) (small blind) collected (200)



PokerStars Home Game Hand #227559036703: {Club #4781089}  Hold'em No Limit (50/100) - 2021/06/13 23:36:38 EET [2021/06/13 16:36:38 ET]
Table 'VTTP 1306' 2-max (Play Money) Seat #1 is the button
Seat 1: s70n3fac3 (23129 in chips) 
Seat 2: FDIBA2009 (10089 in chips) 
s70n3fac3: posts small blind 50
FDIBA2009: posts big blind 100
*** HOLE CARDS ***
s70n3fac3: calls 50
FDIBA2009: raises 200 to 300
s70n3fac3: calls 200
*** FLOP *** [5h Qs 5c]
FDIBA2009: checks 
s70n3fac3: checks 
*** TURN *** [5h Qs 5c] [7s]
FDIBA2009: bets 350
s70n3fac3: calls 350
*** RIVER *** [5h Qs 5c 7s] [9s]
FDIBA2009: bets 850
s70n3fac3: calls 850
*** SHOW DOWN ***
FDIBA2009: shows [Ks Js] (a flush, King high)
s70n3fac3: mucks hand 
FDIBA2009 collected 2835 from pot
*** SUMMARY ***
Total pot 3000 | Rake 165 
Board [5h Qs 5c 7s 9s]
Seat 1: s70n3fac3 (button) (small blind) mucked [5d 4h]
Seat 2: FDIBA2009 (big blind) showed [Ks Js] and won (2835) with a flush, King high



PokerStars Home Game Hand #227559048953: {Club #4781089}  Hold'em No Limit (50/100) - 2021/06/13 23:37:02 EET [2021/06/13 16:37:02 ET]
Table 'VTTP 1306' 2-max (Play Money) Seat #2 is the button
Seat 1: s70n3fac3 (21629 in chips) 
Seat 2: FDIBA2009 (11424 in chips) 
FDIBA2009: posts small blind 50
s70n3fac3: posts big blind 100
*** HOLE CARDS ***
FDIBA2009: folds 
Uncalled bet (50) returned to s70n3fac3
s70n3fac3 collected 100 from pot
s70n3fac3: doesn't show hand 
*** SUMMARY ***
Total pot 100 | Rake 0 
Seat 1: s70n3fac3 (big blind) collected (100)
Seat 2: FDIBA2009 (button) (small blind) folded before Flop



PokerStars Home Game Hand #227559053593: {Club #4781089}  Hold'em No Limit (50/100) - 2021/06/13 23:37:11 EET [2021/06/13 16:37:11 ET]
Table 'VTTP 1306' 2-max (Play Money) Seat #1 is the button
Seat 1: s70n3fac3 (21679 in chips) 
Seat 2: FDIBA2009 (11374 in chips) 
s70n3fac3: posts small blind 50
FDIBA2009: posts big blind 100
*** HOLE CARDS ***
s70n3fac3: calls 50
FDIBA2009: checks 
*** FLOP *** [4d Kc Td]
FDIBA2009: checks 
s70n3fac3: bets 200
FDIBA2009: folds 
Uncalled bet (200) returned to s70n3fac3
s70n3fac3 collected 189 from pot
s70n3fac3: doesn't show hand 
*** SUMMARY ***
Total pot 200 | Rake 11 
Board [4d Kc Td]
Seat 1: s70n3fac3 (button) (small blind) collected (189)
Seat 2: FDIBA2009 (big blind) folded on the Flop



PokerStars Home Game Hand #227559060433: {Club #4781089}  Hold'em No Limit (50/100) - 2021/06/13 23:37:25 EET [2021/06/13 16:37:25 ET]
Table 'VTTP 1306' 2-max (Play Money) Seat #2 is the button
Seat 1: s70n3fac3 (21768 in chips) 
Seat 2: FDIBA2009 (11274 in chips) 
FDIBA2009: posts small blind 50
s70n3fac3: posts big blind 100
*** HOLE CARDS ***
FDIBA2009: folds 
Uncalled bet (50) returned to s70n3fac3
s70n3fac3 collected 100 from pot
s70n3fac3: doesn't show hand 
*** SUMMARY ***
Total pot 100 | Rake 0 
Seat 1: s70n3fac3 (big blind) collected (100)
Seat 2: FDIBA2009 (button) (small blind) folded before Flop



PokerStars Home Game Hand #227559063186: {Club #4781089}  Hold'em No Limit (50/100) - 2021/06/13 23:37:30 EET [2021/06/13 16:37:30 ET]
Table 'VTTP 1306' 2-max (Play Money) Seat #1 is the button
Seat 1: s70n3fac3 (21818 in chips) 
Seat 2: FDIBA2009 (11224 in chips) 
s70n3fac3: posts small blind 50
FDIBA2009: posts big blind 100
*** HOLE CARDS ***
s70n3fac3: calls 50
FDIBA2009: raises 100 to 200
s70n3fac3: calls 100
*** FLOP *** [8s Qs Jc]
FDIBA2009: bets 150
s70n3fac3: raises 350 to 500
FDIBA2009: raises 1378 to 1878
s70n3fac3: folds 
Uncalled bet (1378) returned to FDIBA2009
FDIBA2009 collected 1323 from pot
FDIBA2009: doesn't show hand 
*** SUMMARY ***
Total pot 1400 | Rake 77 
Board [8s Qs Jc]
Seat 1: s70n3fac3 (button) (small blind) folded on the Flop
Seat 2: FDIBA2009 (big blind) collected (1323)



PokerStars Home Game Hand #227559076989: {Club #4781089}  Hold'em No Limit (50/100) - 2021/06/13 23:37:57 EET [2021/06/13 16:37:57 ET]
Table 'VTTP 1306' 2-max (Play Money) Seat #2 is the button
Seat 1: s70n3fac3 (21118 in chips) 
Seat 2: FDIBA2009 (11847 in chips) 
FDIBA2009: posts small blind 50
s70n3fac3: posts big blind 100
*** HOLE CARDS ***
FDIBA2009: raises 100 to 200
s70n3fac3: calls 100
*** FLOP *** [3h 3s 8h]
s70n3fac3: checks 
FDIBA2009: checks 
*** TURN *** [3h 3s 8h] [3c]
s70n3fac3: checks 
FDIBA2009: checks 
*** RIVER *** [3h 3s 8h 3c] [3d]
s70n3fac3: checks 
FDIBA2009: bets 100
s70n3fac3: folds 
Uncalled bet (100) returned to FDIBA2009
FDIBA2009 collected 378 from pot
FDIBA2009: doesn't show hand 
*** SUMMARY ***
Total pot 400 | Rake 22 
Board [3h 3s 8h 3c 3d]
Seat 1: s70n3fac3 (big blind) folded on the River
Seat 2: FDIBA2009 (button) (small blind) collected (378)



PokerStars Home Game Hand #227559085827: {Club #4781089}  Hold'em No Limit (50/100) - 2021/06/13 23:38:15 EET [2021/06/13 16:38:15 ET]
Table 'VTTP 1306' 2-max (Play Money) Seat #1 is the button
Seat 1: s70n3fac3 (20918 in chips) 
Seat 2: FDIBA2009 (12025 in chips) 
s70n3fac3: posts small blind 50
FDIBA2009: posts big blind 100
*** HOLE CARDS ***
s70n3fac3: calls 50
FDIBA2009: raises 100 to 200
s70n3fac3: calls 100
*** FLOP *** [6s 7h 6d]
FDIBA2009: checks 
s70n3fac3: checks 
*** TURN *** [6s 7h 6d] [9c]
FDIBA2009: checks 
s70n3fac3: bets 300
FDIBA2009: folds 
Uncalled bet (300) returned to s70n3fac3
s70n3fac3 collected 378 from pot
s70n3fac3: doesn't show hand 
*** SUMMARY ***
Total pot 400 | Rake 22 
Board [6s 7h 6d 9c]
Seat 1: s70n3fac3 (button) (small blind) collected (378)
Seat 2: FDIBA2009 (big blind) folded on the Turn



PokerStars Home Game Hand #227559095705: {Club #4781089}  Hold'em No Limit (50/100) - 2021/06/13 23:38:34 EET [2021/06/13 16:38:34 ET]
Table 'VTTP 1306' 2-max (Play Money) Seat #2 is the button
Seat 1: s70n3fac3 (21096 in chips) 
Seat 2: FDIBA2009 (11825 in chips) 
FDIBA2009: posts small blind 50
s70n3fac3: posts big blind 100
*** HOLE CARDS ***
FDIBA2009: raises 100 to 200
s70n3fac3: calls 100
*** FLOP *** [Qc 3h 4c]
s70n3fac3: checks 
FDIBA2009: checks 
*** TURN *** [Qc 3h 4c] [9h]
s70n3fac3: checks 
FDIBA2009: checks 
*** RIVER *** [Qc 3h 4c 9h] [Kh]
s70n3fac3: checks 
FDIBA2009: checks 
*** SHOW DOWN ***
s70n3fac3: shows [8s 5c] (high card King)
FDIBA2009: shows [Th 6d] (high card King - Queen+Ten kicker)
FDIBA2009 collected 378 from pot
*** SUMMARY ***
Total pot 400 | Rake 22 
Board [Qc 3h 4c 9h Kh]
Seat 1: s70n3fac3 (big blind) showed [8s 5c] and lost with high card King
Seat 2: FDIBA2009 (button) (small blind) showed [Th 6d] and won (378) with high card King



PokerStars Home Game Hand #227559113188: {Club #4781089}  Hold'em No Limit (50/100) - 2021/06/13 23:38:49 EET [2021/06/13 16:38:49 ET]
Table 'VTTP 1306' 2-max (Play Money) Seat #1 is the button
Seat 1: s70n3fac3 (20896 in chips) 
Seat 2: FDIBA2009 (12003 in chips) 
s70n3fac3: posts small blind 50
FDIBA2009: posts big blind 100
*** HOLE CARDS ***
s70n3fac3: calls 50
FDIBA2009: raises 100 to 200
s70n3fac3: calls 100
*** FLOP *** [6d 4s 7d]
FDIBA2009: bets 100
s70n3fac3: calls 100
*** TURN *** [6d 4s 7d] [9h]
FDIBA2009: checks 
s70n3fac3: checks 
*** RIVER *** [6d 4s 7d 9h] [Ks]
FDIBA2009: checks 
s70n3fac3: bets 500
FDIBA2009: folds 
Uncalled bet (500) returned to s70n3fac3
s70n3fac3 collected 567 from pot
s70n3fac3: doesn't show hand 
*** SUMMARY ***
Total pot 600 | Rake 33 
Board [6d 4s 7d 9h Ks]
Seat 1: s70n3fac3 (button) (small blind) collected (567)
Seat 2: FDIBA2009 (big blind) folded on the River



PokerStars Home Game Hand #227559125589: {Club #4781089}  Hold'em No Limit (50/100) - 2021/06/13 23:39:13 EET [2021/06/13 16:39:13 ET]
Table 'VTTP 1306' 2-max (Play Money) Seat #2 is the button
Seat 1: s70n3fac3 (21163 in chips) 
Seat 2: FDIBA2009 (11703 in chips) 
FDIBA2009: posts small blind 50
s70n3fac3: posts big blind 100
*** HOLE CARDS ***
FDIBA2009: raises 100 to 200
s70n3fac3: calls 100
*** FLOP *** [Ah 6c 5h]
s70n3fac3: checks 
FDIBA2009: checks 
*** TURN *** [Ah 6c 5h] [7c]
s70n3fac3: bets 300
FDIBA2009: folds 
Uncalled bet (300) returned to s70n3fac3
s70n3fac3 collected 378 from pot
s70n3fac3: doesn't show hand 
*** SUMMARY ***
Total pot 400 | Rake 22 
Board [Ah 6c 5h 7c]
Seat 1: s70n3fac3 (big blind) collected (378)
Seat 2: FDIBA2009 (button) (small blind) folded on the Turn



PokerStars Home Game Hand #227559131646: {Club #4781089}  Hold'em No Limit (50/100) - 2021/06/13 23:39:25 EET [2021/06/13 16:39:25 ET]
Table 'VTTP 1306' 2-max (Play Money) Seat #1 is the button
Seat 1: s70n3fac3 (21341 in chips) 
Seat 2: FDIBA2009 (11503 in chips) 
s70n3fac3: posts small blind 50
FDIBA2009: posts big blind 100
*** HOLE CARDS ***
s70n3fac3: folds 
Uncalled bet (50) returned to FDIBA2009
FDIBA2009 collected 100 from pot
FDIBA2009: doesn't show hand 
*** SUMMARY ***
Total pot 100 | Rake 0 
Seat 1: s70n3fac3 (button) (small blind) folded before Flop
Seat 2: FDIBA2009 (big blind) collected (100)



PokerStars Home Game Hand #227559133702: {Club #4781089}  Hold'em No Limit (50/100) - 2021/06/13 23:39:30 EET [2021/06/13 16:39:30 ET]
Table 'VTTP 1306' 2-max (Play Money) Seat #2 is the button
Seat 1: s70n3fac3 (21291 in chips) 
Seat 2: FDIBA2009 (11553 in chips) 
FDIBA2009: posts small blind 50
s70n3fac3: posts big blind 100
*** HOLE CARDS ***
FDIBA2009: raises 100 to 200
s70n3fac3: calls 100
*** FLOP *** [2h 7s 5d]
s70n3fac3: checks 
FDIBA2009: bets 200
s70n3fac3: calls 200
*** TURN *** [2h 7s 5d] [2s]
s70n3fac3: checks 
FDIBA2009: bets 400
s70n3fac3: calls 400
*** RIVER *** [2h 7s 5d 2s] [6d]
s70n3fac3: checks 
FDIBA2009: checks 
*** SHOW DOWN ***
s70n3fac3: shows [5s 6s] (two pair, Sixes and Fives)
FDIBA2009: mucks hand 
s70n3fac3 collected 1512 from pot
*** SUMMARY ***
Total pot 1600 | Rake 88 
Board [2h 7s 5d 2s 6d]
Seat 1: s70n3fac3 (big blind) showed [5s 6s] and won (1512) with two pair, Sixes and Fives
Seat 2: FDIBA2009 (button) (small blind) mucked [6c 9h]



PokerStars Home Game Hand #227559147388: {Club #4781089}  Hold'em No Limit (50/100) - 2021/06/13 23:39:56 EET [2021/06/13 16:39:56 ET]
Table 'VTTP 1306' 2-max (Play Money) Seat #1 is the button
Seat 1: s70n3fac3 (22003 in chips) 
Seat 2: FDIBA2009 (10753 in chips) 
s70n3fac3: posts small blind 50
FDIBA2009: posts big blind 100
*** HOLE CARDS ***
s70n3fac3: raises 300 to 400
FDIBA2009: folds 
Uncalled bet (300) returned to s70n3fac3
s70n3fac3 collected 200 from pot
s70n3fac3: doesn't show hand 
*** SUMMARY ***
Total pot 200 | Rake 0 
Seat 1: s70n3fac3 (button) (small blind) collected (200)
Seat 2: FDIBA2009 (big blind) folded before Flop



PokerStars Home Game Hand #227559154173: {Club #4781089}  Hold'em No Limit (50/100) - 2021/06/13 23:40:10 EET [2021/06/13 16:40:10 ET]
Table 'VTTP 1306' 2-max (Play Money) Seat #2 is the button
Seat 1: s70n3fac3 (22103 in chips) 
Seat 2: FDIBA2009 (10653 in chips) 
FDIBA2009: posts small blind 50
s70n3fac3: posts big blind 100
*** HOLE CARDS ***
FDIBA2009: raises 100 to 200
s70n3fac3: calls 100
*** FLOP *** [Jd 3c 9d]
s70n3fac3: checks 
FDIBA2009: checks 
*** TURN *** [Jd 3c 9d] [4s]
s70n3fac3: checks 
FDIBA2009: bets 100
s70n3fac3: calls 100
*** RIVER *** [Jd 3c 9d 4s] [9c]
s70n3fac3: checks 
FDIBA2009: bets 150
s70n3fac3: folds 
Uncalled bet (150) returned to FDIBA2009
FDIBA2009 collected 567 from pot
FDIBA2009: doesn't show hand 
*** SUMMARY ***
Total pot 600 | Rake 33 
Board [Jd 3c 9d 4s 9c]
Seat 1: s70n3fac3 (big blind) folded on the River
Seat 2: FDIBA2009 (button) (small blind) collected (567)



PokerStars Home Game Hand #227559163787: {Club #4781089}  Hold'em No Limit (50/100) - 2021/06/13 23:40:29 EET [2021/06/13 16:40:29 ET]
Table 'VTTP 1306' 2-max (Play Money) Seat #1 is the button
Seat 1: s70n3fac3 (21803 in chips) 
Seat 2: FDIBA2009 (10920 in chips) 
s70n3fac3: posts small blind 50
FDIBA2009: posts big blind 100
*** HOLE CARDS ***
s70n3fac3: raises 200 to 300
FDIBA2009: calls 200
*** FLOP *** [Qc Jh Tc]
FDIBA2009: checks 
s70n3fac3: bets 400
FDIBA2009: calls 400
*** TURN *** [Qc Jh Tc] [6d]
FDIBA2009: checks 
s70n3fac3: bets 800
FDIBA2009: folds 
Uncalled bet (800) returned to s70n3fac3
s70n3fac3 collected 1323 from pot
s70n3fac3: doesn't show hand 
*** SUMMARY ***
Total pot 1400 | Rake 77 
Board [Qc Jh Tc 6d]
Seat 1: s70n3fac3 (button) (small blind) collected (1323)
Seat 2: FDIBA2009 (big blind) folded on the Turn



PokerStars Home Game Hand #227559179350: {Club #4781089}  Hold'em No Limit (50/100) - 2021/06/13 23:40:59 EET [2021/06/13 16:40:59 ET]
Table 'VTTP 1306' 2-max (Play Money) Seat #2 is the button
Seat 1: s70n3fac3 (22426 in chips) 
Seat 2: FDIBA2009 (10220 in chips) 
FDIBA2009: posts small blind 50
s70n3fac3: posts big blind 100
*** HOLE CARDS ***
FDIBA2009: raises 100 to 200
s70n3fac3: raises 600 to 800
FDIBA2009: folds 
Uncalled bet (600) returned to s70n3fac3
s70n3fac3 collected 400 from pot
s70n3fac3: doesn't show hand 
*** SUMMARY ***
Total pot 400 | Rake 0 
Seat 1: s70n3fac3 (big blind) collected (400)
Seat 2: FDIBA2009 (button) (small blind) folded before Flop



PokerStars Home Game Hand #227559185167: {Club #4781089}  Hold'em No Limit (50/100) - 2021/06/13 23:41:11 EET [2021/06/13 16:41:11 ET]
Table 'VTTP 1306' 2-max (Play Money) Seat #1 is the button
Seat 1: s70n3fac3 (22626 in chips) 
Seat 2: FDIBA2009 (10020 in chips) 
s70n3fac3: posts small blind 50
FDIBA2009: posts big blind 100
*** HOLE CARDS ***
s70n3fac3: raises 300 to 400
FDIBA2009: calls 300
*** FLOP *** [Kd Qs 2d]
FDIBA2009: checks 
s70n3fac3: bets 600
FDIBA2009: folds 
Uncalled bet (600) returned to s70n3fac3
s70n3fac3 collected 756 from pot
s70n3fac3: doesn't show hand 
*** SUMMARY ***
Total pot 800 | Rake 44 
Board [Kd Qs 2d]
Seat 1: s70n3fac3 (button) (small blind) collected (756)
Seat 2: FDIBA2009 (big blind) folded on the Flop



PokerStars Home Game Hand #227559191833: {Club #4781089}  Hold'em No Limit (50/100) - 2021/06/13 23:41:24 EET [2021/06/13 16:41:24 ET]
Table 'VTTP 1306' 2-max (Play Money) Seat #2 is the button
Seat 1: s70n3fac3 (22982 in chips) 
Seat 2: FDIBA2009 (9620 in chips) 
FDIBA2009: posts small blind 50
s70n3fac3: posts big blind 100
*** HOLE CARDS ***
FDIBA2009: raises 100 to 200
s70n3fac3: calls 100
*** FLOP *** [Qd 8h Jd]
s70n3fac3: checks 
FDIBA2009: bets 200
s70n3fac3: calls 200
*** TURN *** [Qd 8h Jd] [Ks]
s70n3fac3: checks 
FDIBA2009: checks 
*** RIVER *** [Qd 8h Jd Ks] [Ad]
s70n3fac3: bets 400
FDIBA2009: folds 
Uncalled bet (400) returned to s70n3fac3
s70n3fac3 collected 756 from pot
s70n3fac3: doesn't show hand 
*** SUMMARY ***
Total pot 800 | Rake 44 
Board [Qd 8h Jd Ks Ad]
Seat 1: s70n3fac3 (big blind) collected (756)
Seat 2: FDIBA2009 (button) (small blind) folded on the River



PokerStars Home Game Hand #227559203560: {Club #4781089}  Hold'em No Limit (50/100) - 2021/06/13 23:41:48 EET [2021/06/13 16:41:48 ET]
Table 'VTTP 1306' 2-max (Play Money) Seat #1 is the button
Seat 1: s70n3fac3 (23338 in chips) 
Seat 2: FDIBA2009 (9220 in chips) 
s70n3fac3: posts small blind 50
FDIBA2009: posts big blind 100
*** HOLE CARDS ***
s70n3fac3: calls 50
FDIBA2009: checks 
*** FLOP *** [6s Ts Th]
FDIBA2009: checks 
s70n3fac3: checks 
*** TURN *** [6s Ts Th] [6c]
FDIBA2009: bets 189
s70n3fac3: calls 189
*** RIVER *** [6s Ts Th 6c] [2c]
FDIBA2009: checks 
s70n3fac3: checks 
*** SHOW DOWN ***
FDIBA2009: shows [9d Tc] (a full house, Tens full of Sixes)
s70n3fac3: mucks hand 
FDIBA2009 collected 546 from pot
*** SUMMARY ***
Total pot 578 | Rake 32 
Board [6s Ts Th 6c 2c]
Seat 1: s70n3fac3 (button) (small blind) mucked [3s 5s]
Seat 2: FDIBA2009 (big blind) showed [9d Tc] and won (546) with a full house, Tens full of Sixes



PokerStars Home Game Hand #227559215793: {Club #4781089}  Hold'em No Limit (50/100) - 2021/06/13 23:42:13 EET [2021/06/13 16:42:13 ET]
Table 'VTTP 1306' 2-max (Play Money) Seat #2 is the button
Seat 1: s70n3fac3 (23049 in chips) 
Seat 2: FDIBA2009 (9477 in chips) 
FDIBA2009: posts small blind 50
s70n3fac3: posts big blind 100
*** HOLE CARDS ***
FDIBA2009: raises 200 to 300
s70n3fac3: folds 
Uncalled bet (200) returned to FDIBA2009
FDIBA2009 collected 200 from pot
FDIBA2009: doesn't show hand 
*** SUMMARY ***
Total pot 200 | Rake 0 
Seat 1: s70n3fac3 (big blind) folded before Flop
Seat 2: FDIBA2009 (button) (small blind) collected (200)



PokerStars Home Game Hand #227559222028: {Club #4781089}  Hold'em No Limit (50/100) - 2021/06/13 23:42:26 EET [2021/06/13 16:42:26 ET]
Table 'VTTP 1306' 2-max (Play Money) Seat #1 is the button
Seat 1: s70n3fac3 (22949 in chips) 
Seat 2: FDIBA2009 (9577 in chips) 
s70n3fac3: posts small blind 50
FDIBA2009: posts big blind 100
*** HOLE CARDS ***
s70n3fac3: calls 50
FDIBA2009: checks 
*** FLOP *** [Js 8c Jd]
FDIBA2009: checks 
s70n3fac3: bets 200
FDIBA2009: folds 
Uncalled bet (200) returned to s70n3fac3
s70n3fac3 collected 189 from pot
s70n3fac3: doesn't show hand 
*** SUMMARY ***
Total pot 200 | Rake 11 
Board [Js 8c Jd]
Seat 1: s70n3fac3 (button) (small blind) collected (189)
Seat 2: FDIBA2009 (big blind) folded on the Flop



PokerStars Home Game Hand #227559227293: {Club #4781089}  Hold'em No Limit (50/100) - 2021/06/13 23:42:37 EET [2021/06/13 16:42:37 ET]
Table 'VTTP 1306' 2-max (Play Money) Seat #2 is the button
Seat 1: s70n3fac3 (23038 in chips) 
Seat 2: FDIBA2009 (9477 in chips) 
FDIBA2009: posts small blind 50
s70n3fac3: posts big blind 100
*** HOLE CARDS ***
FDIBA2009: folds 
Uncalled bet (50) returned to s70n3fac3
s70n3fac3 collected 100 from pot
s70n3fac3: doesn't show hand 
*** SUMMARY ***
Total pot 100 | Rake 0 
Seat 1: s70n3fac3 (big blind) collected (100)
Seat 2: FDIBA2009 (button) (small blind) folded before Flop



PokerStars Home Game Hand #227559230097: {Club #4781089}  Hold'em No Limit (50/100) - 2021/06/13 23:42:43 EET [2021/06/13 16:42:43 ET]
Table 'VTTP 1306' 2-max (Play Money) Seat #1 is the button
Seat 1: s70n3fac3 (23088 in chips) 
Seat 2: FDIBA2009 (9427 in chips) 
s70n3fac3: posts small blind 50
FDIBA2009: posts big blind 100
*** HOLE CARDS ***
s70n3fac3: raises 200 to 300
FDIBA2009: calls 200
*** FLOP *** [7h 2d 5d]
FDIBA2009: checks 
s70n3fac3: bets 400
FDIBA2009: calls 400
*** TURN *** [7h 2d 5d] [6s]
FDIBA2009: checks 
s70n3fac3: checks 
*** RIVER *** [7h 2d 5d 6s] [Jh]
FDIBA2009: bets 1350
s70n3fac3: folds 
Uncalled bet (1350) returned to FDIBA2009
FDIBA2009 collected 1323 from pot
FDIBA2009: doesn't show hand 
*** SUMMARY ***
Total pot 1400 | Rake 77 
Board [7h 2d 5d 6s Jh]
Seat 1: s70n3fac3 (button) (small blind) folded on the River
Seat 2: FDIBA2009 (big blind) collected (1323)



PokerStars Home Game Hand #227559253125: {Club #4781089}  Hold'em No Limit (50/100) - 2021/06/13 23:43:29 EET [2021/06/13 16:43:29 ET]
Table 'VTTP 1306' 2-max (Play Money) Seat #2 is the button
Seat 1: s70n3fac3 (22388 in chips) 
Seat 2: FDIBA2009 (10050 in chips) 
FDIBA2009: posts small blind 50
s70n3fac3: posts big blind 100
*** HOLE CARDS ***
FDIBA2009: raises 100 to 200
s70n3fac3: calls 100
*** FLOP *** [Th 3c 7h]
s70n3fac3: checks 
FDIBA2009: checks 
*** TURN *** [Th 3c 7h] [As]
s70n3fac3: checks 
FDIBA2009: bets 200
s70n3fac3: folds 
Uncalled bet (200) returned to FDIBA2009
FDIBA2009 collected 378 from pot
FDIBA2009: doesn't show hand 
*** SUMMARY ***
Total pot 400 | Rake 22 
Board [Th 3c 7h As]
Seat 1: s70n3fac3 (big blind) folded on the Turn
Seat 2: FDIBA2009 (button) (small blind) collected (378)



PokerStars Home Game Hand #227559262352: {Club #4781089}  Hold'em No Limit (50/100) - 2021/06/13 23:43:47 EET [2021/06/13 16:43:47 ET]
Table 'VTTP 1306' 2-max (Play Money) Seat #1 is the button
Seat 1: s70n3fac3 (22188 in chips) 
Seat 2: FDIBA2009 (10228 in chips) 
s70n3fac3: posts small blind 50
FDIBA2009: posts big blind 100
*** HOLE CARDS ***
s70n3fac3: calls 50
FDIBA2009: raises 200 to 300
s70n3fac3: calls 200
*** FLOP *** [7c Qc 3d]
FDIBA2009: checks 
s70n3fac3: checks 
*** TURN *** [7c Qc 3d] [2s]
FDIBA2009: bets 300
s70n3fac3: calls 300
*** RIVER *** [7c Qc 3d 2s] [8d]
FDIBA2009: checks 
s70n3fac3: bets 1200
FDIBA2009: folds 
Uncalled bet (1200) returned to s70n3fac3
s70n3fac3 collected 1134 from pot
s70n3fac3: doesn't show hand 
*** SUMMARY ***
Total pot 1200 | Rake 66 
Board [7c Qc 3d 2s 8d]
Seat 1: s70n3fac3 (button) (small blind) collected (1134)
Seat 2: FDIBA2009 (big blind) folded on the River



PokerStars Home Game Hand #227559282309: {Club #4781089}  Hold'em No Limit (50/100) - 2021/06/13 23:44:18 EET [2021/06/13 16:44:18 ET]
Table 'VTTP 1306' 2-max (Play Money) Seat #2 is the button
Seat 1: s70n3fac3 (22722 in chips) 
Seat 2: FDIBA2009 (9628 in chips) 
FDIBA2009: posts small blind 50
s70n3fac3: posts big blind 100
*** HOLE CARDS ***
FDIBA2009: raises 100 to 200
s70n3fac3: raises 600 to 800
FDIBA2009: folds 
Uncalled bet (600) returned to s70n3fac3
s70n3fac3 collected 400 from pot
s70n3fac3: doesn't show hand 
*** SUMMARY ***
Total pot 400 | Rake 0 
Seat 1: s70n3fac3 (big blind) collected (400)
Seat 2: FDIBA2009 (button) (small blind) folded before Flop



PokerStars Home Game Hand #227559286972: {Club #4781089}  Hold'em No Limit (50/100) - 2021/06/13 23:44:27 EET [2021/06/13 16:44:27 ET]
Table 'VTTP 1306' 2-max (Play Money) Seat #1 is the button
Seat 1: s70n3fac3 (22922 in chips) 
Seat 2: FDIBA2009 (9428 in chips) 
s70n3fac3: posts small blind 50
FDIBA2009: posts big blind 100
*** HOLE CARDS ***
s70n3fac3: calls 50
FDIBA2009: checks 
*** FLOP *** [8d 5h 8c]
FDIBA2009: bets 189
s70n3fac3: calls 189
*** TURN *** [8d 5h 8c] [Qc]
FDIBA2009: bets 546
s70n3fac3: folds 
Uncalled bet (546) returned to FDIBA2009
FDIBA2009 collected 546 from pot
FDIBA2009: doesn't show hand 
*** SUMMARY ***
Total pot 578 | Rake 32 
Board [8d 5h 8c Qc]
Seat 1: s70n3fac3 (button) (small blind) folded on the Turn
Seat 2: FDIBA2009 (big blind) collected (546)



PokerStars Home Game Hand #227559295660: {Club #4781089}  Hold'em No Limit (50/100) - 2021/06/13 23:44:44 EET [2021/06/13 16:44:44 ET]
Table 'VTTP 1306' 2-max (Play Money) Seat #2 is the button
Seat 1: s70n3fac3 (22633 in chips) 
Seat 2: FDIBA2009 (9685 in chips) 
FDIBA2009: posts small blind 50
s70n3fac3: posts big blind 100
*** HOLE CARDS ***
FDIBA2009: raises 100 to 200
s70n3fac3: calls 100
*** FLOP *** [2d 8d Ah]
s70n3fac3: checks 
FDIBA2009: bets 200
s70n3fac3: folds 
Uncalled bet (200) returned to FDIBA2009
FDIBA2009 collected 378 from pot
FDIBA2009: doesn't show hand 
*** SUMMARY ***
Total pot 400 | Rake 22 
Board [2d 8d Ah]
Seat 1: s70n3fac3 (big blind) folded on the Flop
Seat 2: FDIBA2009 (button) (small blind) collected (378)



PokerStars Home Game Hand #227559303071: {Club #4781089}  Hold'em No Limit (50/100) - 2021/06/13 23:44:59 EET [2021/06/13 16:44:59 ET]
Table 'VTTP 1306' 2-max (Play Money) Seat #1 is the button
Seat 1: s70n3fac3 (22433 in chips) 
Seat 2: FDIBA2009 (9863 in chips) 
s70n3fac3: posts small blind 50
FDIBA2009: posts big blind 100
*** HOLE CARDS ***
s70n3fac3: raises 300 to 400
FDIBA2009: calls 300
*** FLOP *** [8s Jh 5c]
FDIBA2009: checks 
s70n3fac3: bets 600
FDIBA2009: calls 600
*** TURN *** [8s Jh 5c] [4c]
FDIBA2009: checks 
s70n3fac3: bets 1200
FDIBA2009: folds 
Uncalled bet (1200) returned to s70n3fac3
s70n3fac3 collected 1890 from pot
s70n3fac3: doesn't show hand 
*** SUMMARY ***
Total pot 2000 | Rake 110 
Board [8s Jh 5c 4c]
Seat 1: s70n3fac3 (button) (small blind) collected (1890)
Seat 2: FDIBA2009 (big blind) folded on the Turn



PokerStars Home Game Hand #227559320172: {Club #4781089}  Hold'em No Limit (50/100) - 2021/06/13 23:45:33 EET [2021/06/13 16:45:33 ET]
Table 'VTTP 1306' 2-max (Play Money) Seat #2 is the button
Seat 1: s70n3fac3 (23323 in chips) 
Seat 2: FDIBA2009 (8863 in chips) 
FDIBA2009: posts small blind 50
s70n3fac3: posts big blind 100
*** HOLE CARDS ***
FDIBA2009: folds 
Uncalled bet (50) returned to s70n3fac3
s70n3fac3 collected 100 from pot
s70n3fac3: doesn't show hand 
*** SUMMARY ***
Total pot 100 | Rake 0 
Seat 1: s70n3fac3 (big blind) collected (100)
Seat 2: FDIBA2009 (button) (small blind) folded before Flop



PokerStars Home Game Hand #227559322497: {Club #4781089}  Hold'em No Limit (50/100) - 2021/06/13 23:45:38 EET [2021/06/13 16:45:38 ET]
Table 'VTTP 1306' 2-max (Play Money) Seat #1 is the button
Seat 1: s70n3fac3 (23373 in chips) 
Seat 2: FDIBA2009 (8813 in chips) 
s70n3fac3: posts small blind 50
FDIBA2009: posts big blind 100
*** HOLE CARDS ***
s70n3fac3: raises 300 to 400
FDIBA2009: raises 8413 to 8813 and is all-in
s70n3fac3: folds 
Uncalled bet (8413) returned to FDIBA2009
FDIBA2009 collected 800 from pot
FDIBA2009: doesn't show hand 
*** SUMMARY ***
Total pot 800 | Rake 0 
Seat 1: s70n3fac3 (button) (small blind) folded before Flop
Seat 2: FDIBA2009 (big blind) collected (800)



PokerStars Home Game Hand #227559332034: {Club #4781089}  Hold'em No Limit (50/100) - 2021/06/13 23:45:56 EET [2021/06/13 16:45:56 ET]
Table 'VTTP 1306' 2-max (Play Money) Seat #2 is the button
Seat 1: s70n3fac3 (22973 in chips) 
Seat 2: FDIBA2009 (9213 in chips) 
FDIBA2009: posts small blind 50
s70n3fac3: posts big blind 100
*** HOLE CARDS ***
FDIBA2009: raises 100 to 200
s70n3fac3: calls 100
*** FLOP *** [4c 4d Ac]
s70n3fac3: checks 
FDIBA2009: checks 
*** TURN *** [4c 4d Ac] [Ks]
s70n3fac3: checks 
FDIBA2009: bets 200
s70n3fac3: folds 
Uncalled bet (200) returned to FDIBA2009
FDIBA2009 collected 378 from pot
FDIBA2009: doesn't show hand 
*** SUMMARY ***
Total pot 400 | Rake 22 
Board [4c 4d Ac Ks]
Seat 1: s70n3fac3 (big blind) folded on the Turn
Seat 2: FDIBA2009 (button) (small blind) collected (378)



PokerStars Home Game Hand #227559339016: {Club #4781089}  Hold'em No Limit (50/100) - 2021/06/13 23:46:10 EET [2021/06/13 16:46:10 ET]
Table 'VTTP 1306' 2-max (Play Money) Seat #1 is the button
Seat 1: s70n3fac3 (22773 in chips) 
Seat 2: FDIBA2009 (9391 in chips) 
s70n3fac3: posts small blind 50
FDIBA2009: posts big blind 100
*** HOLE CARDS ***
s70n3fac3: calls 50
FDIBA2009: checks 
*** FLOP *** [9h 5h Qd]
FDIBA2009: bets 189
s70n3fac3: folds 
Uncalled bet (189) returned to FDIBA2009
FDIBA2009 collected 189 from pot
FDIBA2009: doesn't show hand 
*** SUMMARY ***
Total pot 200 | Rake 11 
Board [9h 5h Qd]
Seat 1: s70n3fac3 (button) (small blind) folded on the Flop
Seat 2: FDIBA2009 (big blind) collected (189)



PokerStars Home Game Hand #227559344976: {Club #4781089}  Hold'em No Limit (50/100) - 2021/06/13 23:46:22 EET [2021/06/13 16:46:22 ET]
Table 'VTTP 1306' 2-max (Play Money) Seat #2 is the button
Seat 1: s70n3fac3 (22673 in chips) 
Seat 2: FDIBA2009 (9480 in chips) 
FDIBA2009: posts small blind 50
s70n3fac3: posts big blind 100
*** HOLE CARDS ***
FDIBA2009: raises 100 to 200
s70n3fac3: raises 600 to 800
FDIBA2009: calls 600
*** FLOP *** [Th 6c 7s]
s70n3fac3: checks 
FDIBA2009: bets 800
s70n3fac3: calls 800
*** TURN *** [Th 6c 7s] [Kd]
s70n3fac3: checks 
FDIBA2009: checks 
*** RIVER *** [Th 6c 7s Kd] [9h]
s70n3fac3: checks 
FDIBA2009: bets 2300
s70n3fac3: calls 2300
*** SHOW DOWN ***
FDIBA2009: shows [8d 7d] (a straight, Six to Ten)
s70n3fac3: mucks hand 
FDIBA2009 collected 7371 from pot
*** SUMMARY ***
Total pot 7800 | Rake 429 
Board [Th 6c 7s Kd 9h]
Seat 1: s70n3fac3 (big blind) mucked [Kc Qh]
Seat 2: FDIBA2009 (button) (small blind) showed [8d 7d] and won (7371) with a straight, Six to Ten



PokerStars Home Game Hand #227559367388: {Club #4781089}  Hold'em No Limit (50/100) - 2021/06/13 23:47:07 EET [2021/06/13 16:47:07 ET]
Table 'VTTP 1306' 2-max (Play Money) Seat #1 is the button
Seat 1: s70n3fac3 (18773 in chips) 
Seat 2: FDIBA2009 (12951 in chips) 
s70n3fac3: posts small blind 50
FDIBA2009: posts big blind 100
*** HOLE CARDS ***
s70n3fac3: folds 
Uncalled bet (50) returned to FDIBA2009
FDIBA2009 collected 100 from pot
FDIBA2009: doesn't show hand 
*** SUMMARY ***
Total pot 100 | Rake 0 
Seat 1: s70n3fac3 (button) (small blind) folded before Flop
Seat 2: FDIBA2009 (big blind) collected (100)



PokerStars Home Game Hand #227559370003: {Club #4781089}  Hold'em No Limit (50/100) - 2021/06/13 23:47:12 EET [2021/06/13 16:47:12 ET]
Table 'VTTP 1306' 2-max (Play Money) Seat #2 is the button
Seat 1: s70n3fac3 (18723 in chips) 
Seat 2: FDIBA2009 (13001 in chips) 
FDIBA2009: posts small blind 50
s70n3fac3: posts big blind 100
*** HOLE CARDS ***
FDIBA2009: raises 100 to 200
s70n3fac3: folds 
Uncalled bet (100) returned to FDIBA2009
FDIBA2009 collected 200 from pot
FDIBA2009: doesn't show hand 
*** SUMMARY ***
Total pot 200 | Rake 0 
Seat 1: s70n3fac3 (big blind) folded before Flop
Seat 2: FDIBA2009 (button) (small blind) collected (200)



PokerStars Home Game Hand #227559373523: {Club #4781089}  Hold'em No Limit (50/100) - 2021/06/13 23:47:19 EET [2021/06/13 16:47:19 ET]
Table 'VTTP 1306' 2-max (Play Money) Seat #1 is the button
Seat 1: s70n3fac3 (18623 in chips) 
Seat 2: FDIBA2009 (13101 in chips) 
s70n3fac3: posts small blind 50
FDIBA2009: posts big blind 100
*** HOLE CARDS ***
s70n3fac3: calls 50
FDIBA2009: checks 
*** FLOP *** [6c 9c 9d]
FDIBA2009: checks 
s70n3fac3: checks 
*** TURN *** [6c 9c 9d] [4h]
FDIBA2009: checks 
s70n3fac3: checks 
*** RIVER *** [6c 9c 9d 4h] [As]
FDIBA2009: checks 
s70n3fac3: checks 
*** SHOW DOWN ***
FDIBA2009: shows [Ks 3s] (a pair of Nines)
s70n3fac3: mucks hand 
FDIBA2009 collected 189 from pot
*** SUMMARY ***
Total pot 200 | Rake 11 
Board [6c 9c 9d 4h As]
Seat 1: s70n3fac3 (button) (small blind) mucked [Jd 2s]
Seat 2: FDIBA2009 (big blind) showed [Ks 3s] and won (189) with a pair of Nines



PokerStars Home Game Hand #227559382029: {Club #4781089}  Hold'em No Limit (50/100) - 2021/06/13 23:47:36 EET [2021/06/13 16:47:36 ET]
Table 'VTTP 1306' 2-max (Play Money) Seat #2 is the button
Seat 1: s70n3fac3 (18523 in chips) 
Seat 2: FDIBA2009 (13190 in chips) 
FDIBA2009: posts small blind 50
s70n3fac3: posts big blind 100
*** HOLE CARDS ***
FDIBA2009: raises 100 to 200
s70n3fac3: raises 700 to 900
FDIBA2009: calls 700
*** FLOP *** [8h Kc 5c]
s70n3fac3: bets 1800
FDIBA2009: folds 
Uncalled bet (1800) returned to s70n3fac3
s70n3fac3 collected 1701 from pot
s70n3fac3: doesn't show hand 
*** SUMMARY ***
Total pot 1800 | Rake 99 
Board [8h Kc 5c]
Seat 1: s70n3fac3 (big blind) collected (1701)
Seat 2: FDIBA2009 (button) (small blind) folded on the Flop



PokerStars Home Game Hand #227559392355: {Club #4781089}  Hold'em No Limit (50/100) - 2021/06/13 23:47:56 EET [2021/06/13 16:47:56 ET]
Table 'VTTP 1306' 2-max (Play Money) Seat #1 is the button
Seat 1: s70n3fac3 (19324 in chips) 
Seat 2: FDIBA2009 (12290 in chips) 
s70n3fac3: posts small blind 50
FDIBA2009: posts big blind 100
*** HOLE CARDS ***
s70n3fac3: calls 50
FDIBA2009: checks 
*** FLOP *** [7h 9s Td]
FDIBA2009: checks 
s70n3fac3: bets 200
FDIBA2009: folds 
Uncalled bet (200) returned to s70n3fac3
s70n3fac3 collected 189 from pot
s70n3fac3: doesn't show hand 
*** SUMMARY ***
Total pot 200 | Rake 11 
Board [7h 9s Td]
Seat 1: s70n3fac3 (button) (small blind) collected (189)
Seat 2: FDIBA2009 (big blind) folded on the Flop



PokerStars Home Game Hand #227559398064: {Club #4781089}  Hold'em No Limit (50/100) - 2021/06/13 23:48:08 EET [2021/06/13 16:48:08 ET]
Table 'VTTP 1306' 2-max (Play Money) Seat #2 is the button
Seat 1: s70n3fac3 (19413 in chips) 
Seat 2: FDIBA2009 (12190 in chips) 
FDIBA2009: posts small blind 50
s70n3fac3: posts big blind 100
*** HOLE CARDS ***
FDIBA2009: raises 150 to 250
s70n3fac3: folds 
Uncalled bet (150) returned to FDIBA2009
FDIBA2009 collected 200 from pot
FDIBA2009: doesn't show hand 
*** SUMMARY ***
Total pot 200 | Rake 0 
Seat 1: s70n3fac3 (big blind) folded before Flop
Seat 2: FDIBA2009 (button) (small blind) collected (200)



PokerStars Home Game Hand #227559402503: {Club #4781089}  Hold'em No Limit (50/100) - 2021/06/13 23:48:17 EET [2021/06/13 16:48:17 ET]
Table 'VTTP 1306' 2-max (Play Money) Seat #1 is the button
Seat 1: s70n3fac3 (19313 in chips) 
Seat 2: FDIBA2009 (12290 in chips) 
s70n3fac3: posts small blind 50
FDIBA2009: posts big blind 100
*** HOLE CARDS ***
s70n3fac3: calls 50
FDIBA2009: checks 
*** FLOP *** [6s 9d 2s]
FDIBA2009: checks 
s70n3fac3: checks 
*** TURN *** [6s 9d 2s] [Ac]
FDIBA2009: bets 189
s70n3fac3: folds 
Uncalled bet (189) returned to FDIBA2009
FDIBA2009 collected 189 from pot
FDIBA2009: doesn't show hand 
*** SUMMARY ***
Total pot 200 | Rake 11 
Board [6s 9d 2s Ac]
Seat 1: s70n3fac3 (button) (small blind) folded on the Turn
Seat 2: FDIBA2009 (big blind) collected (189)



PokerStars Home Game Hand #227559411489: {Club #4781089}  Hold'em No Limit (50/100) - 2021/06/13 23:48:34 EET [2021/06/13 16:48:34 ET]
Table 'VTTP 1306' 2-max (Play Money) Seat #2 is the button
Seat 1: s70n3fac3 (19213 in chips) 
Seat 2: FDIBA2009 (12379 in chips) 
FDIBA2009: posts small blind 50
s70n3fac3: posts big blind 100
*** HOLE CARDS ***
FDIBA2009: raises 100 to 200
s70n3fac3: calls 100
*** FLOP *** [Kc 9s Th]
s70n3fac3: checks 
FDIBA2009: bets 100
s70n3fac3: calls 100
*** TURN *** [Kc 9s Th] [Td]
s70n3fac3: checks 
FDIBA2009: checks 
*** RIVER *** [Kc 9s Th Td] [7h]
s70n3fac3: checks 
FDIBA2009: bets 150
s70n3fac3: folds 
Uncalled bet (150) returned to FDIBA2009
FDIBA2009 collected 567 from pot
FDIBA2009: doesn't show hand 
*** SUMMARY ***
Total pot 600 | Rake 33 
Board [Kc 9s Th Td 7h]
Seat 1: s70n3fac3 (big blind) folded on the River
Seat 2: FDIBA2009 (button) (small blind) collected (567)



PokerStars Home Game Hand #227559420835: {Club #4781089}  Hold'em No Limit (50/100) - 2021/06/13 23:48:54 EET [2021/06/13 16:48:54 ET]
Table 'VTTP 1306' 2-max (Play Money) Seat #1 is the button
Seat 1: s70n3fac3 (18913 in chips) 
Seat 2: FDIBA2009 (12646 in chips) 
s70n3fac3: posts small blind 50
FDIBA2009: posts big blind 100
*** HOLE CARDS ***
s70n3fac3: raises 300 to 400
FDIBA2009: folds 
Uncalled bet (300) returned to s70n3fac3
s70n3fac3 collected 200 from pot
s70n3fac3: doesn't show hand 
*** SUMMARY ***
Total pot 200 | Rake 0 
Seat 1: s70n3fac3 (button) (small blind) collected (200)
Seat 2: FDIBA2009 (big blind) folded before Flop



PokerStars Home Game Hand #227559423923: {Club #4781089}  Hold'em No Limit (50/100) - 2021/06/13 23:49:00 EET [2021/06/13 16:49:00 ET]
Table 'VTTP 1306' 2-max (Play Money) Seat #2 is the button
Seat 1: s70n3fac3 (19013 in chips) 
Seat 2: FDIBA2009 (12546 in chips) 
FDIBA2009: posts small blind 50
s70n3fac3: posts big blind 100
*** HOLE CARDS ***
FDIBA2009: raises 100 to 200
s70n3fac3: folds 
Uncalled bet (100) returned to FDIBA2009
FDIBA2009 collected 200 from pot
FDIBA2009: doesn't show hand 
*** SUMMARY ***
Total pot 200 | Rake 0 
Seat 1: s70n3fac3 (big blind) folded before Flop
Seat 2: FDIBA2009 (button) (small blind) collected (200)



PokerStars Home Game Hand #227559427190: {Club #4781089}  Hold'em No Limit (50/100) - 2021/06/13 23:49:07 EET [2021/06/13 16:49:07 ET]
Table 'VTTP 1306' 2-max (Play Money) Seat #1 is the button
Seat 1: s70n3fac3 (18913 in chips) 
Seat 2: FDIBA2009 (12646 in chips) 
s70n3fac3: posts small blind 50
FDIBA2009: posts big blind 100
*** HOLE CARDS ***
s70n3fac3: folds 
Uncalled bet (50) returned to FDIBA2009
FDIBA2009 collected 100 from pot
FDIBA2009: doesn't show hand 
*** SUMMARY ***
Total pot 100 | Rake 0 
Seat 1: s70n3fac3 (button) (small blind) folded before Flop
Seat 2: FDIBA2009 (big blind) collected (100)



PokerStars Home Game Hand #227559429386: {Club #4781089}  Hold'em No Limit (50/100) - 2021/06/13 23:49:11 EET [2021/06/13 16:49:11 ET]
Table 'VTTP 1306' 2-max (Play Money) Seat #2 is the button
Seat 1: s70n3fac3 (18863 in chips) 
Seat 2: FDIBA2009 (12696 in chips) 
FDIBA2009: posts small blind 50
s70n3fac3: posts big blind 100
*** HOLE CARDS ***
FDIBA2009: raises 100 to 200
s70n3fac3: calls 100
*** FLOP *** [8s 2c 3h]
s70n3fac3: checks 
FDIBA2009: checks 
*** TURN *** [8s 2c 3h] [Jh]
s70n3fac3: checks 
FDIBA2009: checks 
*** RIVER *** [8s 2c 3h Jh] [2h]
s70n3fac3: bets 300
FDIBA2009: folds 
Uncalled bet (300) returned to s70n3fac3
s70n3fac3 collected 378 from pot
s70n3fac3: doesn't show hand 
*** SUMMARY ***
Total pot 400 | Rake 22 
Board [8s 2c 3h Jh 2h]
Seat 1: s70n3fac3 (big blind) collected (378)
Seat 2: FDIBA2009 (button) (small blind) folded on the River



PokerStars Home Game Hand #227559438891: {Club #4781089}  Hold'em No Limit (50/100) - 2021/06/13 23:49:30 EET [2021/06/13 16:49:30 ET]
Table 'VTTP 1306' 2-max (Play Money) Seat #1 is the button
Seat 1: s70n3fac3 (19041 in chips) 
Seat 2: FDIBA2009 (12496 in chips) 
s70n3fac3: posts small blind 50
FDIBA2009: posts big blind 100
*** HOLE CARDS ***
s70n3fac3: raises 300 to 400
FDIBA2009: raises 300 to 700
s70n3fac3: calls 300
*** FLOP *** [Ah 9s 8d]
FDIBA2009: bets 900
s70n3fac3: calls 900
*** TURN *** [Ah 9s 8d] [8c]
FDIBA2009: checks 
s70n3fac3: bets 1600
FDIBA2009: folds 
Uncalled bet (1600) returned to s70n3fac3
s70n3fac3 collected 3024 from pot
s70n3fac3: doesn't show hand 
*** SUMMARY ***
Total pot 3200 | Rake 176 
Board [Ah 9s 8d 8c]
Seat 1: s70n3fac3 (button) (small blind) collected (3024)
Seat 2: FDIBA2009 (big blind) folded on the Turn



PokerStars Home Game Hand #227559454314: {Club #4781089}  Hold'em No Limit (50/100) - 2021/06/13 23:50:01 EET [2021/06/13 16:50:01 ET]
Table 'VTTP 1306' 2-max (Play Money) Seat #2 is the button
Seat 1: s70n3fac3 (20465 in chips) 
Seat 2: FDIBA2009 (10896 in chips) 
FDIBA2009: posts small blind 50
s70n3fac3: posts big blind 100
*** HOLE CARDS ***
FDIBA2009: folds 
Uncalled bet (50) returned to s70n3fac3
s70n3fac3 collected 100 from pot
s70n3fac3: doesn't show hand 
*** SUMMARY ***
Total pot 100 | Rake 0 
Seat 1: s70n3fac3 (big blind) collected (100)
Seat 2: FDIBA2009 (button) (small blind) folded before Flop



PokerStars Home Game Hand #227559456866: {Club #4781089}  Hold'em No Limit (50/100) - 2021/06/13 23:50:06 EET [2021/06/13 16:50:06 ET]
Table 'VTTP 1306' 2-max (Play Money) Seat #1 is the button
Seat 1: s70n3fac3 (20515 in chips) 
Seat 2: FDIBA2009 (10846 in chips) 
s70n3fac3: posts small blind 50
FDIBA2009: posts big blind 100
*** HOLE CARDS ***
s70n3fac3: raises 300 to 400
FDIBA2009: folds 
Uncalled bet (300) returned to s70n3fac3
s70n3fac3 collected 200 from pot
s70n3fac3: doesn't show hand 
*** SUMMARY ***
Total pot 200 | Rake 0 
Seat 1: s70n3fac3 (button) (small blind) collected (200)
Seat 2: FDIBA2009 (big blind) folded before Flop



PokerStars Home Game Hand #227559460235: {Club #4781089}  Hold'em No Limit (50/100) - 2021/06/13 23:50:13 EET [2021/06/13 16:50:13 ET]
Table 'VTTP 1306' 2-max (Play Money) Seat #2 is the button
Seat 1: s70n3fac3 (20615 in chips) 
Seat 2: FDIBA2009 (10746 in chips) 
FDIBA2009: posts small blind 50
s70n3fac3: posts big blind 100
*** HOLE CARDS ***
FDIBA2009: folds 
Uncalled bet (50) returned to s70n3fac3
s70n3fac3 collected 100 from pot
s70n3fac3: doesn't show hand 
*** SUMMARY ***
Total pot 100 | Rake 0 
Seat 1: s70n3fac3 (big blind) collected (100)
Seat 2: FDIBA2009 (button) (small blind) folded before Flop



PokerStars Home Game Hand #227559462976: {Club #4781089}  Hold'em No Limit (50/100) - 2021/06/13 23:50:18 EET [2021/06/13 16:50:18 ET]
Table 'VTTP 1306' 2-max (Play Money) Seat #1 is the button
Seat 1: s70n3fac3 (20665 in chips) 
Seat 2: FDIBA2009 (10696 in chips) 
s70n3fac3: posts small blind 50
FDIBA2009: posts big blind 100
*** HOLE CARDS ***
s70n3fac3: calls 50
FDIBA2009: checks 
*** FLOP *** [4d 5s 6s]
FDIBA2009: checks 
s70n3fac3: checks 
*** TURN *** [4d 5s 6s] [9s]
FDIBA2009: bets 100
s70n3fac3: folds 
Uncalled bet (100) returned to FDIBA2009
FDIBA2009 collected 189 from pot
FDIBA2009: doesn't show hand 
*** SUMMARY ***
Total pot 200 | Rake 11 
Board [4d 5s 6s 9s]
Seat 1: s70n3fac3 (button) (small blind) folded on the Turn
Seat 2: FDIBA2009 (big blind) collected (189)



PokerStars Home Game Hand #227559470002: {Club #4781089}  Hold'em No Limit (50/100) - 2021/06/13 23:50:32 EET [2021/06/13 16:50:32 ET]
Table 'VTTP 1306' 2-max (Play Money) Seat #2 is the button
Seat 1: s70n3fac3 (20565 in chips) 
Seat 2: FDIBA2009 (10785 in chips) 
FDIBA2009: posts small blind 50
s70n3fac3: posts big blind 100
*** HOLE CARDS ***
FDIBA2009: raises 100 to 200
s70n3fac3: calls 100
*** FLOP *** [7c Qd Ah]
s70n3fac3: checks 
FDIBA2009: checks 
*** TURN *** [7c Qd Ah] [Th]
s70n3fac3: checks 
FDIBA2009: checks 
*** RIVER *** [7c Qd Ah Th] [4d]
s70n3fac3: checks 
FDIBA2009: bets 378
s70n3fac3: calls 378
*** SHOW DOWN ***
FDIBA2009: shows [Js Jd] (a pair of Jacks)
s70n3fac3: mucks hand 
FDIBA2009 collected 1092 from pot
*** SUMMARY ***
Total pot 1156 | Rake 64 
Board [7c Qd Ah Th 4d]
Seat 1: s70n3fac3 (big blind) mucked [6c 7h]
Seat 2: FDIBA2009 (button) (small blind) showed [Js Jd] and won (1092) with a pair of Jacks



PokerStars Home Game Hand #227559478409: {Club #4781089}  Hold'em No Limit (50/100) - 2021/06/13 23:50:49 EET [2021/06/13 16:50:49 ET]
Table 'VTTP 1306' 2-max (Play Money) Seat #1 is the button
Seat 1: s70n3fac3 (19987 in chips) 
Seat 2: FDIBA2009 (11299 in chips) 
s70n3fac3: posts small blind 50
FDIBA2009: posts big blind 100
*** HOLE CARDS ***
s70n3fac3: calls 50
FDIBA2009: raises 100 to 200
s70n3fac3: calls 100
*** FLOP *** [Jh Kd 5d]
FDIBA2009: bets 200
s70n3fac3: folds 
Uncalled bet (200) returned to FDIBA2009
FDIBA2009 collected 378 from pot
FDIBA2009: doesn't show hand 
*** SUMMARY ***
Total pot 400 | Rake 22 
Board [Jh Kd 5d]
Seat 1: s70n3fac3 (button) (small blind) folded on the Flop
Seat 2: FDIBA2009 (big blind) collected (378)



PokerStars Home Game Hand #227559486267: {Club #4781089}  Hold'em No Limit (50/100) - 2021/06/13 23:51:04 EET [2021/06/13 16:51:04 ET]
Table 'VTTP 1306' 2-max (Play Money) Seat #2 is the button
Seat 1: s70n3fac3 (19787 in chips) 
Seat 2: FDIBA2009 (11477 in chips) 
FDIBA2009: posts small blind 50
s70n3fac3: posts big blind 100
*** HOLE CARDS ***
FDIBA2009: raises 100 to 200
s70n3fac3: folds 
Uncalled bet (100) returned to FDIBA2009
FDIBA2009 collected 200 from pot
FDIBA2009: doesn't show hand 
*** SUMMARY ***
Total pot 200 | Rake 0 
Seat 1: s70n3fac3 (big blind) folded before Flop
Seat 2: FDIBA2009 (button) (small blind) collected (200)



PokerStars Home Game Hand #227559493152: {Club #4781089}  Hold'em No Limit (50/100) - 2021/06/13 23:51:18 EET [2021/06/13 16:51:18 ET]
Table 'VTTP 1306' 2-max (Play Money) Seat #1 is the button
Seat 1: s70n3fac3 (19687 in chips) 
Seat 2: FDIBA2009 (11577 in chips) 
s70n3fac3: posts small blind 50
FDIBA2009: posts big blind 100
*** HOLE CARDS ***
s70n3fac3: calls 50
FDIBA2009: checks 
*** FLOP *** [6s 3c 9c]
FDIBA2009: checks 
s70n3fac3: bets 200
FDIBA2009: folds 
Uncalled bet (200) returned to s70n3fac3
s70n3fac3 collected 189 from pot
s70n3fac3: doesn't show hand 
*** SUMMARY ***
Total pot 200 | Rake 11 
Board [6s 3c 9c]
Seat 1: s70n3fac3 (button) (small blind) collected (189)
Seat 2: FDIBA2009 (big blind) folded on the Flop



PokerStars Home Game Hand #227559499102: {Club #4781089}  Hold'em No Limit (50/100) - 2021/06/13 23:51:30 EET [2021/06/13 16:51:30 ET]
Table 'VTTP 1306' 2-max (Play Money) Seat #2 is the button
Seat 1: s70n3fac3 (19776 in chips) 
Seat 2: FDIBA2009 (11477 in chips) 
FDIBA2009: posts small blind 50
s70n3fac3: posts big blind 100
*** HOLE CARDS ***
FDIBA2009: calls 50
s70n3fac3: checks 
*** FLOP *** [9s Td Js]
s70n3fac3: checks 
FDIBA2009: bets 189
s70n3fac3: calls 189
*** TURN *** [9s Td Js] [8c]
s70n3fac3: checks 
FDIBA2009: checks 
*** RIVER *** [9s Td Js 8c] [Kc]
s70n3fac3: checks 
FDIBA2009: checks 
*** SHOW DOWN ***
s70n3fac3: shows [4h 8s] (a pair of Eights)
FDIBA2009: shows [7s 8d] (a straight, Seven to Jack)
FDIBA2009 collected 546 from pot
*** SUMMARY ***
Total pot 578 | Rake 32 
Board [9s Td Js 8c Kc]
Seat 1: s70n3fac3 (big blind) showed [4h 8s] and lost with a pair of Eights
Seat 2: FDIBA2009 (button) (small blind) showed [7s 8d] and won (546) with a straight, Seven to Jack



PokerStars Home Game Hand #227559508483: {Club #4781089}  Hold'em No Limit (50/100) - 2021/06/13 23:51:49 EET [2021/06/13 16:51:49 ET]
Table 'VTTP 1306' 2-max (Play Money) Seat #1 is the button
Seat 1: s70n3fac3 (19487 in chips) 
Seat 2: FDIBA2009 (11734 in chips) 
s70n3fac3: posts small blind 50
FDIBA2009: posts big blind 100
*** HOLE CARDS ***
s70n3fac3: raises 300 to 400
FDIBA2009: calls 300
*** FLOP *** [Kh 2d 2c]
FDIBA2009: checks 
s70n3fac3: bets 600
FDIBA2009: folds 
Uncalled bet (600) returned to s70n3fac3
s70n3fac3 collected 756 from pot
s70n3fac3: doesn't show hand 
*** SUMMARY ***
Total pot 800 | Rake 44 
Board [Kh 2d 2c]
Seat 1: s70n3fac3 (button) (small blind) collected (756)
Seat 2: FDIBA2009 (big blind) folded on the Flop



PokerStars Home Game Hand #227559515945: {Club #4781089}  Hold'em No Limit (50/100) - 2021/06/13 23:52:05 EET [2021/06/13 16:52:05 ET]
Table 'VTTP 1306' 2-max (Play Money) Seat #2 is the button
Seat 1: s70n3fac3 (19843 in chips) 
Seat 2: FDIBA2009 (11334 in chips) 
FDIBA2009: posts small blind 50
s70n3fac3: posts big blind 100
*** HOLE CARDS ***
FDIBA2009: raises 100 to 200
s70n3fac3: folds 
Uncalled bet (100) returned to FDIBA2009
FDIBA2009 collected 200 from pot
FDIBA2009: doesn't show hand 
*** SUMMARY ***
Total pot 200 | Rake 0 
Seat 1: s70n3fac3 (big blind) folded before Flop
Seat 2: FDIBA2009 (button) (small blind) collected (200)



PokerStars Home Game Hand #227559518960: {Club #4781089}  Hold'em No Limit (50/100) - 2021/06/13 23:52:11 EET [2021/06/13 16:52:11 ET]
Table 'VTTP 1306' 2-max (Play Money) Seat #1 is the button
Seat 1: s70n3fac3 (19743 in chips) 
Seat 2: FDIBA2009 (11434 in chips) 
s70n3fac3: posts small blind 50
FDIBA2009: posts big blind 100
*** HOLE CARDS ***
s70n3fac3: calls 50
FDIBA2009: checks 
*** FLOP *** [Qd Td Qc]
FDIBA2009: checks 
s70n3fac3: bets 200
FDIBA2009: folds 
Uncalled bet (200) returned to s70n3fac3
s70n3fac3 collected 189 from pot
s70n3fac3: doesn't show hand 
*** SUMMARY ***
Total pot 200 | Rake 11 
Board [Qd Td Qc]
Seat 1: s70n3fac3 (button) (small blind) collected (189)
Seat 2: FDIBA2009 (big blind) folded on the Flop



PokerStars Home Game Hand #227559524356: {Club #4781089}  Hold'em No Limit (50/100) - 2021/06/13 23:52:22 EET [2021/06/13 16:52:22 ET]
Table 'VTTP 1306' 2-max (Play Money) Seat #2 is the button
Seat 1: s70n3fac3 (19832 in chips) 
Seat 2: FDIBA2009 (11334 in chips) 
FDIBA2009: posts small blind 50
s70n3fac3: posts big blind 100
*** HOLE CARDS ***
FDIBA2009: raises 100 to 200
s70n3fac3: folds 
Uncalled bet (100) returned to FDIBA2009
FDIBA2009 collected 200 from pot
FDIBA2009: doesn't show hand 
*** SUMMARY ***
Total pot 200 | Rake 0 
Seat 1: s70n3fac3 (big blind) folded before Flop
Seat 2: FDIBA2009 (button) (small blind) collected (200)



PokerStars Home Game Hand #227559528042: {Club #4781089}  Hold'em No Limit (50/100) - 2021/06/13 23:52:29 EET [2021/06/13 16:52:29 ET]
Table 'VTTP 1306' 2-max (Play Money) Seat #1 is the button
Seat 1: s70n3fac3 (19732 in chips) 
Seat 2: FDIBA2009 (11434 in chips) 
s70n3fac3: posts small blind 50
FDIBA2009: posts big blind 100
*** HOLE CARDS ***
s70n3fac3: raises 300 to 400
FDIBA2009: folds 
Uncalled bet (300) returned to s70n3fac3
s70n3fac3 collected 200 from pot
s70n3fac3: doesn't show hand 
*** SUMMARY ***
Total pot 200 | Rake 0 
Seat 1: s70n3fac3 (button) (small blind) collected (200)
Seat 2: FDIBA2009 (big blind) folded before Flop



PokerStars Home Game Hand #227559531028: {Club #4781089}  Hold'em No Limit (50/100) - 2021/06/13 23:52:36 EET [2021/06/13 16:52:36 ET]
Table 'VTTP 1306' 2-max (Play Money) Seat #2 is the button
Seat 1: s70n3fac3 (19832 in chips) 
Seat 2: FDIBA2009 (11334 in chips) 
FDIBA2009: posts small blind 50
s70n3fac3: posts big blind 100
*** HOLE CARDS ***
FDIBA2009: raises 100 to 200
s70n3fac3: raises 600 to 800
FDIBA2009: calls 600
*** FLOP *** [Kh 8s Jh]
s70n3fac3: checks 
FDIBA2009: checks 
*** TURN *** [Kh 8s Jh] [2d]
s70n3fac3: checks 
FDIBA2009: bets 800
s70n3fac3: calls 800
*** RIVER *** [Kh 8s Jh 2d] [Th]
s70n3fac3: checks 
FDIBA2009: checks 
*** SHOW DOWN ***
s70n3fac3: shows [Qc As] (a straight, Ten to Ace)
FDIBA2009: mucks hand 
s70n3fac3 collected 3024 from pot
*** SUMMARY ***
Total pot 3200 | Rake 176 
Board [Kh 8s Jh 2d Th]
Seat 1: s70n3fac3 (big blind) showed [Qc As] and won (3024) with a straight, Ten to Ace
Seat 2: FDIBA2009 (button) (small blind) mucked [Jd Qh]



PokerStars Home Game Hand #227559545971: {Club #4781089}  Hold'em No Limit (50/100) - 2021/06/13 23:53:06 EET [2021/06/13 16:53:06 ET]
Table 'VTTP 1306' 2-max (Play Money) Seat #1 is the button
Seat 1: s70n3fac3 (21256 in chips) 
Seat 2: FDIBA2009 (9734 in chips) 
s70n3fac3: posts small blind 50
FDIBA2009: posts big blind 100
*** HOLE CARDS ***
s70n3fac3: calls 50
FDIBA2009: raises 200 to 300
s70n3fac3: calls 200
*** FLOP *** [3h 8s 6c]
FDIBA2009: checks 
s70n3fac3: checks 
*** TURN *** [3h 8s 6c] [7s]
FDIBA2009: checks 
s70n3fac3: checks 
*** RIVER *** [3h 8s 6c 7s] [Jc]
FDIBA2009: bets 567
s70n3fac3: folds 
Uncalled bet (567) returned to FDIBA2009
FDIBA2009 collected 567 from pot
FDIBA2009: doesn't show hand 
*** SUMMARY ***
Total pot 600 | Rake 33 
Board [3h 8s 6c 7s Jc]
Seat 1: s70n3fac3 (button) (small blind) folded on the River
Seat 2: FDIBA2009 (big blind) collected (567)



PokerStars Home Game Hand #227559557751: {Club #4781089}  Hold'em No Limit (50/100) - 2021/06/13 23:53:31 EET [2021/06/13 16:53:31 ET]
Table 'VTTP 1306' 2-max (Play Money) Seat #2 is the button
Seat 1: s70n3fac3 (20956 in chips) 
Seat 2: FDIBA2009 (10001 in chips) 
FDIBA2009: posts small blind 50
s70n3fac3: posts big blind 100
*** HOLE CARDS ***
FDIBA2009: folds 
Uncalled bet (50) returned to s70n3fac3
s70n3fac3 collected 100 from pot
s70n3fac3: doesn't show hand 
*** SUMMARY ***
Total pot 100 | Rake 0 
Seat 1: s70n3fac3 (big blind) collected (100)
Seat 2: FDIBA2009 (button) (small blind) folded before Flop



PokerStars Home Game Hand #227559560755: {Club #4781089}  Hold'em No Limit (50/100) - 2021/06/13 23:53:37 EET [2021/06/13 16:53:37 ET]
Table 'VTTP 1306' 2-max (Play Money) Seat #1 is the button
Seat 1: s70n3fac3 (21006 in chips) 
Seat 2: FDIBA2009 (9951 in chips) 
s70n3fac3: posts small blind 50
FDIBA2009: posts big blind 100
*** HOLE CARDS ***
s70n3fac3: calls 50
FDIBA2009: checks 
*** FLOP *** [7c Js 7h]
FDIBA2009: checks 
s70n3fac3: checks 
*** TURN *** [7c Js 7h] [Jc]
FDIBA2009: checks 
s70n3fac3: bets 200
FDIBA2009: folds 
Uncalled bet (200) returned to s70n3fac3
s70n3fac3 collected 189 from pot
s70n3fac3: doesn't show hand 
*** SUMMARY ***
Total pot 200 | Rake 11 
Board [7c Js 7h Jc]
Seat 1: s70n3fac3 (button) (small blind) collected (189)
Seat 2: FDIBA2009 (big blind) folded on the Turn



PokerStars Home Game Hand #227559650879: {Club #4781089}  Hold'em No Limit (50/100) - 2021/06/13 23:57:27 EET [2021/06/13 16:57:27 ET]
Table 'VTTP 1306' 2-max (Play Money) Seat #2 is the button
Seat 1: s70n3fac3 (21095 in chips) 
Seat 2: FDIBA2009 (10000 in chips) 
FDIBA2009: posts small blind 50
s70n3fac3: posts big blind 100
*** HOLE CARDS ***
FDIBA2009: raises 100 to 200
s70n3fac3: calls 100
*** FLOP *** [4d Jd Qh]
s70n3fac3: checks 
FDIBA2009: checks 
*** TURN *** [4d Jd Qh] [2s]
s70n3fac3: checks 
FDIBA2009: bets 378
s70n3fac3: calls 378
*** RIVER *** [4d Jd Qh 2s] [Ad]
s70n3fac3: checks 
FDIBA2009: checks 
*** SHOW DOWN ***
s70n3fac3: shows [5c 4c] (a pair of Fours)
FDIBA2009: mucks hand 
s70n3fac3 collected 1092 from pot
*** SUMMARY ***
Total pot 1156 | Rake 64 
Board [4d Jd Qh 2s Ad]
Seat 1: s70n3fac3 (big blind) showed [5c 4c] and won (1092) with a pair of Fours
Seat 2: FDIBA2009 (button) (small blind) mucked [Kc 9h]



PokerStars Home Game Hand #227559663082: {Club #4781089}  Hold'em No Limit (50/100) - 2021/06/13 23:58:05 EET [2021/06/13 16:58:05 ET]
Table 'VTTP 1306' 2-max (Play Money) Seat #1 is the button
Seat 1: s70n3fac3 (21609 in chips) 
Seat 2: FDIBA2009 (9422 in chips) 
s70n3fac3: posts small blind 50
FDIBA2009: posts big blind 100
*** HOLE CARDS ***
s70n3fac3: calls 50
FDIBA2009: checks 
*** FLOP *** [Kd Qs 6s]
FDIBA2009: checks 
s70n3fac3: checks 
*** TURN *** [Kd Qs 6s] [6d]
FDIBA2009: checks 
s70n3fac3: checks 
*** RIVER *** [Kd Qs 6s 6d] [5h]
FDIBA2009: bets 100
s70n3fac3: folds 
Uncalled bet (100) returned to FDIBA2009
FDIBA2009 collected 189 from pot
FDIBA2009: doesn't show hand 
*** SUMMARY ***
Total pot 200 | Rake 11 
Board [Kd Qs 6s 6d 5h]
Seat 1: s70n3fac3 (button) (small blind) folded on the River
Seat 2: FDIBA2009 (big blind) collected (189)



PokerStars Home Game Hand #227559673619: {Club #4781089}  Hold'em No Limit (50/100) - 2021/06/13 23:58:38 EET [2021/06/13 16:58:38 ET]
Table 'VTTP 1306' 2-max (Play Money) Seat #2 is the button
Seat 1: s70n3fac3 (21509 in chips) 
Seat 2: FDIBA2009 (9511 in chips) 
FDIBA2009: posts small blind 50
s70n3fac3: posts big blind 100
*** HOLE CARDS ***
FDIBA2009: raises 200 to 300
s70n3fac3: folds 
Uncalled bet (200) returned to FDIBA2009
FDIBA2009 collected 200 from pot
FDIBA2009: doesn't show hand 
*** SUMMARY ***
Total pot 200 | Rake 0 
Seat 1: s70n3fac3 (big blind) folded before Flop
Seat 2: FDIBA2009 (button) (small blind) collected (200)



PokerStars Home Game Hand #227559676564: {Club #4781089}  Hold'em No Limit (50/100) - 2021/06/13 23:58:47 EET [2021/06/13 16:58:47 ET]
Table 'VTTP 1306' 2-max (Play Money) Seat #1 is the button
Seat 1: s70n3fac3 (21409 in chips) 
Seat 2: FDIBA2009 (9611 in chips) 
s70n3fac3: posts small blind 50
FDIBA2009: posts big blind 100
*** HOLE CARDS ***
s70n3fac3: raises 150 to 250
FDIBA2009: calls 150
*** FLOP *** [6c 7d 6d]
FDIBA2009: checks 
s70n3fac3: bets 300
FDIBA2009: folds 
Uncalled bet (300) returned to s70n3fac3
s70n3fac3 collected 472 from pot
s70n3fac3: doesn't show hand 
*** SUMMARY ***
Total pot 500 | Rake 28 
Board [6c 7d 6d]
Seat 1: s70n3fac3 (button) (small blind) collected (472)
Seat 2: FDIBA2009 (big blind) folded on the Flop



PokerStars Home Game Hand #227559680909: {Club #4781089}  Hold'em No Limit (50/100) - 2021/06/13 23:59:00 EET [2021/06/13 16:59:00 ET]
Table 'VTTP 1306' 2-max (Play Money) Seat #2 is the button
Seat 1: s70n3fac3 (21631 in chips) 
Seat 2: FDIBA2009 (9361 in chips) 
FDIBA2009: posts small blind 50
s70n3fac3: posts big blind 100
*** HOLE CARDS ***
FDIBA2009: folds 
Uncalled bet (50) returned to s70n3fac3
s70n3fac3 collected 100 from pot
s70n3fac3: doesn't show hand 
*** SUMMARY ***
Total pot 100 | Rake 0 
Seat 1: s70n3fac3 (big blind) collected (100)
Seat 2: FDIBA2009 (button) (small blind) folded before Flop



PokerStars Home Game Hand #227559682498: {Club #4781089}  Hold'em No Limit (50/100) - 2021/06/13 23:59:05 EET [2021/06/13 16:59:05 ET]
Table 'VTTP 1306' 2-max (Play Money) Seat #1 is the button
Seat 1: s70n3fac3 (21681 in chips) 
Seat 2: FDIBA2009 (9311 in chips) 
s70n3fac3: posts small blind 50
FDIBA2009: posts big blind 100
*** HOLE CARDS ***
s70n3fac3: calls 50
FDIBA2009: checks 
*** FLOP *** [Qd 8c Ad]
FDIBA2009: checks 
s70n3fac3: checks 
*** TURN *** [Qd 8c Ad] [3d]
FDIBA2009: bets 100
s70n3fac3: folds 
Uncalled bet (100) returned to FDIBA2009
FDIBA2009 collected 189 from pot
FDIBA2009: doesn't show hand 
*** SUMMARY ***
Total pot 200 | Rake 11 
Board [Qd 8c Ad 3d]
Seat 1: s70n3fac3 (button) (small blind) folded on the Turn
Seat 2: FDIBA2009 (big blind) collected (189)



PokerStars Home Game Hand #227559686348: {Club #4781089}  Hold'em No Limit (50/100) - 2021/06/13 23:59:17 EET [2021/06/13 16:59:17 ET]
Table 'VTTP 1306' 2-max (Play Money) Seat #2 is the button
Seat 1: s70n3fac3 (21581 in chips) 
Seat 2: FDIBA2009 (9400 in chips) 
FDIBA2009: posts small blind 50
s70n3fac3: posts big blind 100
*** HOLE CARDS ***
FDIBA2009: raises 100 to 200
s70n3fac3: folds 
Uncalled bet (100) returned to FDIBA2009
FDIBA2009 collected 200 from pot
FDIBA2009: doesn't show hand 
*** SUMMARY ***
Total pot 200 | Rake 0 
Seat 1: s70n3fac3 (big blind) folded before Flop
Seat 2: FDIBA2009 (button) (small blind) collected (200)



PokerStars Home Game Hand #227559688983: {Club #4781089}  Hold'em No Limit (50/100) - 2021/06/13 23:59:25 EET [2021/06/13 16:59:25 ET]
Table 'VTTP 1306' 2-max (Play Money) Seat #1 is the button
Seat 1: s70n3fac3 (21481 in chips) 
Seat 2: FDIBA2009 (9500 in chips) 
s70n3fac3: posts small blind 50
FDIBA2009: posts big blind 100
*** HOLE CARDS ***
s70n3fac3: calls 50
FDIBA2009: raises 100 to 200
s70n3fac3: calls 100
*** FLOP *** [Js Ah 9c]
FDIBA2009: checks 
s70n3fac3: checks 
*** TURN *** [Js Ah 9c] [6s]
FDIBA2009: bets 378
s70n3fac3: calls 378
*** RIVER *** [Js Ah 9c 6s] [Qh]
FDIBA2009: bets 1300
s70n3fac3: folds 
Uncalled bet (1300) returned to FDIBA2009
FDIBA2009 collected 1092 from pot
FDIBA2009: doesn't show hand 
*** SUMMARY ***
Total pot 1156 | Rake 64 
Board [Js Ah 9c 6s Qh]
Seat 1: s70n3fac3 (button) (small blind) folded on the River
Seat 2: FDIBA2009 (big blind) collected (1092)



PokerStars Home Game Hand #227559697257: {Club #4781089}  Hold'em No Limit (50/100) - 2021/06/13 23:59:51 EET [2021/06/13 16:59:51 ET]
Table 'VTTP 1306' 2-max (Play Money) Seat #2 is the button
Seat 1: s70n3fac3 (20903 in chips) 
Seat 2: FDIBA2009 (10014 in chips) 
FDIBA2009: posts small blind 50
s70n3fac3: posts big blind 100
*** HOLE CARDS ***
FDIBA2009: raises 100 to 200
s70n3fac3: raises 600 to 800
FDIBA2009: calls 600
*** FLOP *** [7d 6d Kd]
s70n3fac3: bets 1000
FDIBA2009: folds 
Uncalled bet (1000) returned to s70n3fac3
s70n3fac3 collected 1512 from pot
s70n3fac3: doesn't show hand 
*** SUMMARY ***
Total pot 1600 | Rake 88 
Board [7d 6d Kd]
Seat 1: s70n3fac3 (big blind) collected (1512)
Seat 2: FDIBA2009 (button) (small blind) folded on the Flop



PokerStars Home Game Hand #227559704663: {Club #4781089}  Hold'em No Limit (50/100) - 2021/06/14 0:00:12 EET [2021/06/13 17:00:12 ET]
Table 'VTTP 1306' 2-max (Play Money) Seat #1 is the button
Seat 1: s70n3fac3 (21615 in chips) 
Seat 2: FDIBA2009 (9214 in chips) 
s70n3fac3: posts small blind 50
FDIBA2009: posts big blind 100
*** HOLE CARDS ***
s70n3fac3: calls 50
FDIBA2009: checks 
*** FLOP *** [3c 6d 7h]
FDIBA2009: checks 
s70n3fac3: checks 
*** TURN *** [3c 6d 7h] [8d]
FDIBA2009: checks 
s70n3fac3: bets 300
FDIBA2009: folds 
Uncalled bet (300) returned to s70n3fac3
s70n3fac3 collected 189 from pot
s70n3fac3: doesn't show hand 
*** SUMMARY ***
Total pot 200 | Rake 11 
Board [3c 6d 7h 8d]
Seat 1: s70n3fac3 (button) (small blind) collected (189)
Seat 2: FDIBA2009 (big blind) folded on the Turn



PokerStars Home Game Hand #227559710633: {Club #4781089}  Hold'em No Limit (50/100) - 2021/06/14 0:00:29 EET [2021/06/13 17:00:29 ET]
Table 'VTTP 1306' 2-max (Play Money) Seat #2 is the button
Seat 1: s70n3fac3 (21704 in chips) 
Seat 2: FDIBA2009 (9114 in chips) 
FDIBA2009: posts small blind 50
s70n3fac3: posts big blind 100
*** HOLE CARDS ***
FDIBA2009: raises 200 to 300
s70n3fac3: calls 200
*** FLOP *** [Ks 2d 5c]
s70n3fac3: checks 
FDIBA2009: bets 567
s70n3fac3: folds 
Uncalled bet (567) returned to FDIBA2009
FDIBA2009 collected 567 from pot
FDIBA2009: doesn't show hand 
*** SUMMARY ***
Total pot 600 | Rake 33 
Board [Ks 2d 5c]
Seat 1: s70n3fac3 (big blind) folded on the Flop
Seat 2: FDIBA2009 (button) (small blind) collected (567)



PokerStars Home Game Hand #227559715279: {Club #4781089}  Hold'em No Limit (50/100) - 2021/06/14 0:00:42 EET [2021/06/13 17:00:42 ET]
Table 'VTTP 1306' 2-max (Play Money) Seat #1 is the button
Seat 1: s70n3fac3 (21404 in chips) 
Seat 2: FDIBA2009 (9381 in chips) 
s70n3fac3: posts small blind 50
FDIBA2009: posts big blind 100
*** HOLE CARDS ***
s70n3fac3: raises 300 to 400
FDIBA2009: calls 300
*** FLOP *** [Qc 5d Jh]
FDIBA2009: checks 
s70n3fac3: checks 
*** TURN *** [Qc 5d Jh] [4c]
FDIBA2009: bets 756
s70n3fac3: calls 756
*** RIVER *** [Qc 5d Jh 4c] [Ts]
FDIBA2009: bets 2185
s70n3fac3: folds 
Uncalled bet (2185) returned to FDIBA2009
FDIBA2009 collected 2185 from pot
FDIBA2009: doesn't show hand 
*** SUMMARY ***
Total pot 2312 | Rake 127 
Board [Qc 5d Jh 4c Ts]
Seat 1: s70n3fac3 (button) (small blind) folded on the River
Seat 2: FDIBA2009 (big blind) collected (2185)



PokerStars Home Game Hand #227559728677: {Club #4781089}  Hold'em No Limit (50/100) - 2021/06/14 0:01:17 EET [2021/06/13 17:01:17 ET]
Table 'VTTP 1306' 2-max (Play Money) Seat #2 is the button
Seat 1: s70n3fac3 (20248 in chips) 
Seat 2: FDIBA2009 (10410 in chips) 
FDIBA2009: posts small blind 50
s70n3fac3: posts big blind 100
*** HOLE CARDS ***
FDIBA2009: raises 100 to 200
s70n3fac3: calls 100
*** FLOP *** [5c Jd Ts]
s70n3fac3: checks 
FDIBA2009: bets 200
s70n3fac3: folds 
Uncalled bet (200) returned to FDIBA2009
FDIBA2009 collected 378 from pot
FDIBA2009: doesn't show hand 
*** SUMMARY ***
Total pot 400 | Rake 22 
Board [5c Jd Ts]
Seat 1: s70n3fac3 (big blind) folded on the Flop
Seat 2: FDIBA2009 (button) (small blind) collected (378)



PokerStars Home Game Hand #227559741704: {Club #4781089}  Hold'em No Limit (50/100) - 2021/06/14 0:01:28 EET [2021/06/13 17:01:28 ET]
Table 'VTTP 1306' 2-max (Play Money) Seat #1 is the button
Seat 1: s70n3fac3 (20048 in chips) 
Seat 2: FDIBA2009 (10588 in chips) 
s70n3fac3: posts small blind 50
FDIBA2009: posts big blind 100
*** HOLE CARDS ***
s70n3fac3: folds 
Uncalled bet (50) returned to FDIBA2009
FDIBA2009 collected 100 from pot
FDIBA2009: doesn't show hand 
*** SUMMARY ***
Total pot 100 | Rake 0 
Seat 1: s70n3fac3 (button) (small blind) folded before Flop
Seat 2: FDIBA2009 (big blind) collected (100)



PokerStars Home Game Hand #227559743308: {Club #4781089}  Hold'em No Limit (50/100) - 2021/06/14 0:01:32 EET [2021/06/13 17:01:32 ET]
Table 'VTTP 1306' 2-max (Play Money) Seat #2 is the button
Seat 1: s70n3fac3 (19998 in chips) 
Seat 2: FDIBA2009 (10638 in chips) 
FDIBA2009: posts small blind 50
s70n3fac3: posts big blind 100
*** HOLE CARDS ***
FDIBA2009: raises 200 to 300
s70n3fac3: calls 200
*** FLOP *** [3c 2s Jd]
s70n3fac3: checks 
FDIBA2009: bets 300
s70n3fac3: calls 300
*** TURN *** [3c 2s Jd] [Jc]
s70n3fac3: checks 
FDIBA2009: checks 
*** RIVER *** [3c 2s Jd Jc] [6c]
s70n3fac3: checks 
FDIBA2009: checks 
*** SHOW DOWN ***
s70n3fac3: shows [5s Ad] (a pair of Jacks)
FDIBA2009: shows [Qd Ac] (a pair of Jacks - Ace+Queen kicker)
FDIBA2009 collected 1134 from pot
*** SUMMARY ***
Total pot 1200 | Rake 66 
Board [3c 2s Jd Jc 6c]
Seat 1: s70n3fac3 (big blind) showed [5s Ad] and lost with a pair of Jacks
Seat 2: FDIBA2009 (button) (small blind) showed [Qd Ac] and won (1134) with a pair of Jacks



PokerStars Home Game Hand #227559751958: {Club #4781089}  Hold'em No Limit (50/100) - 2021/06/14 0:01:51 EET [2021/06/13 17:01:51 ET]
Table 'VTTP 1306' 2-max (Play Money) Seat #1 is the button
Seat 1: s70n3fac3 (19398 in chips) 
Seat 2: FDIBA2009 (11172 in chips) 
s70n3fac3: posts small blind 50
FDIBA2009: posts big blind 100
*** HOLE CARDS ***
s70n3fac3: raises 300 to 400
FDIBA2009: folds 
Uncalled bet (300) returned to s70n3fac3
s70n3fac3 collected 200 from pot
s70n3fac3: doesn't show hand 
*** SUMMARY ***
Total pot 200 | Rake 0 
Seat 1: s70n3fac3 (button) (small blind) collected (200)
Seat 2: FDIBA2009 (big blind) folded before Flop



PokerStars Home Game Hand #227559754644: {Club #4781089}  Hold'em No Limit (50/100) - 2021/06/14 0:01:57 EET [2021/06/13 17:01:57 ET]
Table 'VTTP 1306' 2-max (Play Money) Seat #2 is the button
Seat 1: s70n3fac3 (19498 in chips) 
Seat 2: FDIBA2009 (11072 in chips) 
FDIBA2009: posts small blind 50
s70n3fac3: posts big blind 100
*** HOLE CARDS ***
FDIBA2009: raises 200 to 300
s70n3fac3: folds 
Uncalled bet (200) returned to FDIBA2009
FDIBA2009 collected 200 from pot
FDIBA2009: doesn't show hand 
*** SUMMARY ***
Total pot 200 | Rake 0 
Seat 1: s70n3fac3 (big blind) folded before Flop
Seat 2: FDIBA2009 (button) (small blind) collected (200)



PokerStars Home Game Hand #227559757621: {Club #4781089}  Hold'em No Limit (50/100) - 2021/06/14 0:02:04 EET [2021/06/13 17:02:04 ET]
Table 'VTTP 1306' 2-max (Play Money) Seat #1 is the button
Seat 1: s70n3fac3 (19398 in chips) 
Seat 2: FDIBA2009 (11172 in chips) 
s70n3fac3: posts small blind 50
FDIBA2009: posts big blind 100
*** HOLE CARDS ***
s70n3fac3: calls 50
FDIBA2009: checks 
*** FLOP *** [Kd 7d Ad]
FDIBA2009: checks 
s70n3fac3: checks 
*** TURN *** [Kd 7d Ad] [7h]
FDIBA2009: bets 189
s70n3fac3: folds 
Uncalled bet (189) returned to FDIBA2009
FDIBA2009 collected 189 from pot
FDIBA2009: doesn't show hand 
*** SUMMARY ***
Total pot 200 | Rake 11 
Board [Kd 7d Ad 7h]
Seat 1: s70n3fac3 (button) (small blind) folded on the Turn
Seat 2: FDIBA2009 (big blind) collected (189)



PokerStars Home Game Hand #227559763301: {Club #4781089}  Hold'em No Limit (50/100) - 2021/06/14 0:02:16 EET [2021/06/13 17:02:16 ET]
Table 'VTTP 1306' 2-max (Play Money) Seat #2 is the button
Seat 1: s70n3fac3 (19298 in chips) 
Seat 2: FDIBA2009 (11261 in chips) 
FDIBA2009: posts small blind 50
s70n3fac3: posts big blind 100
*** HOLE CARDS ***
FDIBA2009: raises 200 to 300
s70n3fac3: calls 200
*** FLOP *** [Kd 2s 9s]
s70n3fac3: checks 
FDIBA2009: bets 567
s70n3fac3: folds 
Uncalled bet (567) returned to FDIBA2009
FDIBA2009 collected 567 from pot
FDIBA2009: doesn't show hand 
*** SUMMARY ***
Total pot 600 | Rake 33 
Board [Kd 2s 9s]
Seat 1: s70n3fac3 (big blind) folded on the Flop
Seat 2: FDIBA2009 (button) (small blind) collected (567)



PokerStars Home Game Hand #227559768593: {Club #4781089}  Hold'em No Limit (50/100) - 2021/06/14 0:02:27 EET [2021/06/13 17:02:27 ET]
Table 'VTTP 1306' 2-max (Play Money) Seat #1 is the button
Seat 1: s70n3fac3 (18998 in chips) 
Seat 2: FDIBA2009 (11528 in chips) 
s70n3fac3: posts small blind 50
FDIBA2009: posts big blind 100
*** HOLE CARDS ***
s70n3fac3: raises 200 to 300
FDIBA2009: folds 
Uncalled bet (200) returned to s70n3fac3
s70n3fac3 collected 200 from pot
s70n3fac3: doesn't show hand 
*** SUMMARY ***
Total pot 200 | Rake 0 
Seat 1: s70n3fac3 (button) (small blind) collected (200)
Seat 2: FDIBA2009 (big blind) folded before Flop



PokerStars Home Game Hand #227559771405: {Club #4781089}  Hold'em No Limit (50/100) - 2021/06/14 0:02:32 EET [2021/06/13 17:02:32 ET]
Table 'VTTP 1306' 2-max (Play Money) Seat #2 is the button
Seat 1: s70n3fac3 (19098 in chips) 
Seat 2: FDIBA2009 (11428 in chips) 
FDIBA2009: posts small blind 50
s70n3fac3: posts big blind 100
*** HOLE CARDS ***
FDIBA2009: raises 100 to 200
s70n3fac3: raises 600 to 800
FDIBA2009: folds 
Uncalled bet (600) returned to s70n3fac3
s70n3fac3 collected 400 from pot
s70n3fac3: doesn't show hand 
*** SUMMARY ***
Total pot 400 | Rake 0 
Seat 1: s70n3fac3 (big blind) collected (400)
Seat 2: FDIBA2009 (button) (small blind) folded before Flop



PokerStars Home Game Hand #227559775663: {Club #4781089}  Hold'em No Limit (50/100) - 2021/06/14 0:02:41 EET [2021/06/13 17:02:41 ET]
Table 'VTTP 1306' 2-max (Play Money) Seat #1 is the button
Seat 1: s70n3fac3 (19298 in chips) 
Seat 2: FDIBA2009 (11228 in chips) 
s70n3fac3: posts small blind 50
FDIBA2009: posts big blind 100
*** HOLE CARDS ***
s70n3fac3: calls 50
FDIBA2009: raises 200 to 300
s70n3fac3: calls 200
*** FLOP *** [6h Ac Td]
FDIBA2009: checks 
s70n3fac3: checks 
*** TURN *** [6h Ac Td] [2h]
FDIBA2009: checks 
s70n3fac3: checks 
*** RIVER *** [6h Ac Td 2h] [4s]
FDIBA2009: checks 
s70n3fac3: checks 
*** SHOW DOWN ***
FDIBA2009: shows [7h 9s] (high card Ace)
s70n3fac3: mucks hand 
FDIBA2009 collected 567 from pot
*** SUMMARY ***
Total pot 600 | Rake 33 
Board [6h Ac Td 2h 4s]
Seat 1: s70n3fac3 (button) (small blind) mucked [5s 7c]
Seat 2: FDIBA2009 (big blind) showed [7h 9s] and won (567) with high card Ace



PokerStars Home Game Hand #227559784442: {Club #4781089}  Hold'em No Limit (50/100) - 2021/06/14 0:02:59 EET [2021/06/13 17:02:59 ET]
Table 'VTTP 1306' 2-max (Play Money) Seat #2 is the button
Seat 1: s70n3fac3 (18998 in chips) 
Seat 2: FDIBA2009 (11495 in chips) 
FDIBA2009: posts small blind 50
s70n3fac3: posts big blind 100
*** HOLE CARDS ***
FDIBA2009: raises 100 to 200
s70n3fac3: calls 100
*** FLOP *** [Js Ac Jc]
s70n3fac3: checks 
FDIBA2009: checks 
*** TURN *** [Js Ac Jc] [5h]
s70n3fac3: checks 
FDIBA2009: bets 378
s70n3fac3: folds 
Uncalled bet (378) returned to FDIBA2009
FDIBA2009 collected 378 from pot
FDIBA2009: doesn't show hand 
*** SUMMARY ***
Total pot 400 | Rake 22 
Board [Js Ac Jc 5h]
Seat 1: s70n3fac3 (big blind) folded on the Turn
Seat 2: FDIBA2009 (button) (small blind) collected (378)



PokerStars Home Game Hand #227559792565: {Club #4781089}  Hold'em No Limit (50/100) - 2021/06/14 0:03:16 EET [2021/06/13 17:03:16 ET]
Table 'VTTP 1306' 2-max (Play Money) Seat #1 is the button
Seat 1: s70n3fac3 (18798 in chips) 
Seat 2: FDIBA2009 (11673 in chips) 
s70n3fac3: posts small blind 50
FDIBA2009: posts big blind 100
*** HOLE CARDS ***
s70n3fac3: calls 50
FDIBA2009: checks 
*** FLOP *** [Qh 4s Kh]
FDIBA2009: checks 
s70n3fac3: checks 
*** TURN *** [Qh 4s Kh] [4h]
FDIBA2009: checks 
s70n3fac3: checks 
*** RIVER *** [Qh 4s Kh 4h] [5s]
FDIBA2009: bets 250
s70n3fac3: folds 
Uncalled bet (250) returned to FDIBA2009
FDIBA2009 collected 189 from pot
FDIBA2009: doesn't show hand 
*** SUMMARY ***
Total pot 200 | Rake 11 
Board [Qh 4s Kh 4h 5s]
Seat 1: s70n3fac3 (button) (small blind) folded on the River
Seat 2: FDIBA2009 (big blind) collected (189)



PokerStars Home Game Hand #227559800544: {Club #4781089}  Hold'em No Limit (50/100) - 2021/06/14 0:03:33 EET [2021/06/13 17:03:33 ET]
Table 'VTTP 1306' 2-max (Play Money) Seat #2 is the button
Seat 1: s70n3fac3 (18698 in chips) 
Seat 2: FDIBA2009 (11762 in chips) 
FDIBA2009: posts small blind 50
s70n3fac3: posts big blind 100
*** HOLE CARDS ***
FDIBA2009: raises 100 to 200
s70n3fac3: calls 100
*** FLOP *** [5s 7c Ah]
s70n3fac3: checks 
FDIBA2009: checks 
*** TURN *** [5s 7c Ah] [Ad]
s70n3fac3: bets 200
FDIBA2009: folds 
Uncalled bet (200) returned to s70n3fac3
s70n3fac3 collected 378 from pot
s70n3fac3: doesn't show hand 
*** SUMMARY ***
Total pot 400 | Rake 22 
Board [5s 7c Ah Ad]
Seat 1: s70n3fac3 (big blind) collected (378)
Seat 2: FDIBA2009 (button) (small blind) folded on the Turn



PokerStars Home Game Hand #227559806855: {Club #4781089}  Hold'em No Limit (50/100) - 2021/06/14 0:03:46 EET [2021/06/13 17:03:46 ET]
Table 'VTTP 1306' 2-max (Play Money) Seat #1 is the button
Seat 1: s70n3fac3 (18876 in chips) 
Seat 2: FDIBA2009 (11562 in chips) 
s70n3fac3: posts small blind 50
FDIBA2009: posts big blind 100
*** HOLE CARDS ***
s70n3fac3: raises 200 to 300
FDIBA2009: calls 200
*** FLOP *** [Ac 8h 3d]
FDIBA2009: checks 
s70n3fac3: bets 400
FDIBA2009: folds 
Uncalled bet (400) returned to s70n3fac3
s70n3fac3 collected 567 from pot
s70n3fac3: doesn't show hand 
*** SUMMARY ***
Total pot 600 | Rake 33 
Board [Ac 8h 3d]
Seat 1: s70n3fac3 (button) (small blind) collected (567)
Seat 2: FDIBA2009 (big blind) folded on the Flop



PokerStars Home Game Hand #227559812253: {Club #4781089}  Hold'em No Limit (50/100) - 2021/06/14 0:03:57 EET [2021/06/13 17:03:57 ET]
Table 'VTTP 1306' 2-max (Play Money) Seat #2 is the button
Seat 1: s70n3fac3 (19143 in chips) 
Seat 2: FDIBA2009 (11262 in chips) 
FDIBA2009: posts small blind 50
s70n3fac3: posts big blind 100
*** HOLE CARDS ***
FDIBA2009: folds 
Uncalled bet (50) returned to s70n3fac3
s70n3fac3 collected 100 from pot
s70n3fac3: doesn't show hand 
*** SUMMARY ***
Total pot 100 | Rake 0 
Seat 1: s70n3fac3 (big blind) collected (100)
Seat 2: FDIBA2009 (button) (small blind) folded before Flop



PokerStars Home Game Hand #227559814712: {Club #4781089}  Hold'em No Limit (50/100) - 2021/06/14 0:04:02 EET [2021/06/13 17:04:02 ET]
Table 'VTTP 1306' 2-max (Play Money) Seat #1 is the button
Seat 1: s70n3fac3 (19193 in chips) 
Seat 2: FDIBA2009 (11212 in chips) 
s70n3fac3: posts small blind 50
FDIBA2009: posts big blind 100
*** HOLE CARDS ***
s70n3fac3: raises 100 to 200
FDIBA2009: folds 
Uncalled bet (100) returned to s70n3fac3
s70n3fac3 collected 200 from pot
s70n3fac3: doesn't show hand 
*** SUMMARY ***
Total pot 200 | Rake 0 
Seat 1: s70n3fac3 (button) (small blind) collected (200)
Seat 2: FDIBA2009 (big blind) folded before Flop



PokerStars Home Game Hand #227559817436: {Club #4781089}  Hold'em No Limit (50/100) - 2021/06/14 0:04:07 EET [2021/06/13 17:04:07 ET]
Table 'VTTP 1306' 2-max (Play Money) Seat #2 is the button
Seat 1: s70n3fac3 (19293 in chips) 
Seat 2: FDIBA2009 (11112 in chips) 
FDIBA2009: posts small blind 50
s70n3fac3: posts big blind 100
*** HOLE CARDS ***
FDIBA2009: raises 200 to 300
s70n3fac3: calls 200
*** FLOP *** [5c 4h Td]
s70n3fac3: checks 
FDIBA2009: bets 300
s70n3fac3: calls 300
*** TURN *** [5c 4h Td] [2d]
s70n3fac3: checks 
FDIBA2009: checks 
*** RIVER *** [5c 4h Td 2d] [Jc]
s70n3fac3: checks 
FDIBA2009: checks 
*** SHOW DOWN ***
s70n3fac3: shows [5h 7d] (a pair of Fives)
FDIBA2009: shows [Tc 9h] (a pair of Tens)
FDIBA2009 collected 1134 from pot
*** SUMMARY ***
Total pot 1200 | Rake 66 
Board [5c 4h Td 2d Jc]
Seat 1: s70n3fac3 (big blind) showed [5h 7d] and lost with a pair of Fives
Seat 2: FDIBA2009 (button) (small blind) showed [Tc 9h] and won (1134) with a pair of Tens



PokerStars Home Game Hand #227559826329: {Club #4781089}  Hold'em No Limit (50/100) - 2021/06/14 0:04:24 EET [2021/06/13 17:04:24 ET]
Table 'VTTP 1306' 2-max (Play Money) Seat #1 is the button
Seat 1: s70n3fac3 (18693 in chips) 
Seat 2: FDIBA2009 (11646 in chips) 
s70n3fac3: posts small blind 50
FDIBA2009: posts big blind 100
*** HOLE CARDS ***
s70n3fac3: folds 
Uncalled bet (50) returned to FDIBA2009
FDIBA2009 collected 100 from pot
FDIBA2009: doesn't show hand 
*** SUMMARY ***
Total pot 100 | Rake 0 
Seat 1: s70n3fac3 (button) (small blind) folded before Flop
Seat 2: FDIBA2009 (big blind) collected (100)



PokerStars Home Game Hand #227559828235: {Club #4781089}  Hold'em No Limit (50/100) - 2021/06/14 0:04:28 EET [2021/06/13 17:04:28 ET]
Table 'VTTP 1306' 2-max (Play Money) Seat #2 is the button
Seat 1: s70n3fac3 (18643 in chips) 
Seat 2: FDIBA2009 (11696 in chips) 
FDIBA2009: posts small blind 50
s70n3fac3: posts big blind 100
*** HOLE CARDS ***
FDIBA2009: raises 100 to 200
s70n3fac3: calls 100
*** FLOP *** [Js Ks 7c]
s70n3fac3: checks 
FDIBA2009: checks 
*** TURN *** [Js Ks 7c] [8d]
s70n3fac3: checks 
FDIBA2009: checks 
*** RIVER *** [Js Ks 7c 8d] [Ad]
s70n3fac3: checks 
FDIBA2009: bets 100
s70n3fac3: folds 
Uncalled bet (100) returned to FDIBA2009
FDIBA2009 collected 378 from pot
FDIBA2009: doesn't show hand 
*** SUMMARY ***
Total pot 400 | Rake 22 
Board [Js Ks 7c 8d Ad]
Seat 1: s70n3fac3 (big blind) folded on the River
Seat 2: FDIBA2009 (button) (small blind) collected (378)



PokerStars Home Game Hand #227559835803: {Club #4781089}  Hold'em No Limit (50/100) - 2021/06/14 0:04:44 EET [2021/06/13 17:04:44 ET]
Table 'VTTP 1306' 2-max (Play Money) Seat #1 is the button
Seat 1: s70n3fac3 (18443 in chips) 
Seat 2: FDIBA2009 (11874 in chips) 
s70n3fac3: posts small blind 50
FDIBA2009: posts big blind 100
*** HOLE CARDS ***
s70n3fac3: calls 50
FDIBA2009: checks 
*** FLOP *** [5c 5d 9c]
FDIBA2009: checks 
s70n3fac3: checks 
*** TURN *** [5c 5d 9c] [3s]
FDIBA2009: bets 189
s70n3fac3: folds 
Uncalled bet (189) returned to FDIBA2009
FDIBA2009 collected 189 from pot
FDIBA2009: doesn't show hand 
*** SUMMARY ***
Total pot 200 | Rake 11 
Board [5c 5d 9c 3s]
Seat 1: s70n3fac3 (button) (small blind) folded on the Turn
Seat 2: FDIBA2009 (big blind) collected (189)



PokerStars Home Game Hand #227559841709: {Club #4781089}  Hold'em No Limit (50/100) - 2021/06/14 0:04:56 EET [2021/06/13 17:04:56 ET]
Table 'VTTP 1306' 2-max (Play Money) Seat #2 is the button
Seat 1: s70n3fac3 (18343 in chips) 
Seat 2: FDIBA2009 (11963 in chips) 
FDIBA2009: posts small blind 50
s70n3fac3: posts big blind 100
*** HOLE CARDS ***
FDIBA2009: raises 100 to 200
s70n3fac3: calls 100
*** FLOP *** [Qs Ts Kh]
s70n3fac3: checks 
FDIBA2009: bets 378
s70n3fac3: folds 
Uncalled bet (378) returned to FDIBA2009
FDIBA2009 collected 378 from pot
FDIBA2009: doesn't show hand 
*** SUMMARY ***
Total pot 400 | Rake 22 
Board [Qs Ts Kh]
Seat 1: s70n3fac3 (big blind) folded on the Flop
Seat 2: FDIBA2009 (button) (small blind) collected (378)



PokerStars Home Game Hand #227559847409: {Club #4781089}  Hold'em No Limit (50/100) - 2021/06/14 0:05:07 EET [2021/06/13 17:05:07 ET]
Table 'VTTP 1306' 2-max (Play Money) Seat #1 is the button
Seat 1: s70n3fac3 (18143 in chips) 
Seat 2: FDIBA2009 (12141 in chips) 
s70n3fac3: posts small blind 50
FDIBA2009: posts big blind 100
*** HOLE CARDS ***
s70n3fac3: calls 50
FDIBA2009: checks 
*** FLOP *** [8s Kd Qs]
FDIBA2009: checks 
s70n3fac3: bets 200
FDIBA2009: folds 
Uncalled bet (200) returned to s70n3fac3
s70n3fac3 collected 189 from pot
s70n3fac3: doesn't show hand 
*** SUMMARY ***
Total pot 200 | Rake 11 
Board [8s Kd Qs]
Seat 1: s70n3fac3 (button) (small blind) collected (189)
Seat 2: FDIBA2009 (big blind) folded on the Flop



PokerStars Home Game Hand #227559853272: {Club #4781089}  Hold'em No Limit (50/100) - 2021/06/14 0:05:19 EET [2021/06/13 17:05:19 ET]
Table 'VTTP 1306' 2-max (Play Money) Seat #2 is the button
Seat 1: s70n3fac3 (18232 in chips) 
Seat 2: FDIBA2009 (12041 in chips) 
FDIBA2009: posts small blind 50
s70n3fac3: posts big blind 100
*** HOLE CARDS ***
FDIBA2009: raises 100 to 200
s70n3fac3: raises 600 to 800
FDIBA2009: folds 
Uncalled bet (600) returned to s70n3fac3
s70n3fac3 collected 400 from pot
s70n3fac3: doesn't show hand 
*** SUMMARY ***
Total pot 400 | Rake 0 
Seat 1: s70n3fac3 (big blind) collected (400)
Seat 2: FDIBA2009 (button) (small blind) folded before Flop



PokerStars Home Game Hand #227559858170: {Club #4781089}  Hold'em No Limit (50/100) - 2021/06/14 0:05:28 EET [2021/06/13 17:05:28 ET]
Table 'VTTP 1306' 2-max (Play Money) Seat #1 is the button
Seat 1: s70n3fac3 (18432 in chips) 
Seat 2: FDIBA2009 (11841 in chips) 
s70n3fac3: posts small blind 50
FDIBA2009: posts big blind 100
*** HOLE CARDS ***
s70n3fac3: calls 50
FDIBA2009: raises 200 to 300
s70n3fac3: folds 
Uncalled bet (200) returned to FDIBA2009
FDIBA2009 collected 200 from pot
FDIBA2009: doesn't show hand 
*** SUMMARY ***
Total pot 200 | Rake 0 
Seat 1: s70n3fac3 (button) (small blind) folded before Flop
Seat 2: FDIBA2009 (big blind) collected (200)



PokerStars Home Game Hand #227559862355: {Club #4781089}  Hold'em No Limit (50/100) - 2021/06/14 0:05:37 EET [2021/06/13 17:05:37 ET]
Table 'VTTP 1306' 2-max (Play Money) Seat #2 is the button
Seat 1: s70n3fac3 (18332 in chips) 
Seat 2: FDIBA2009 (11941 in chips) 
FDIBA2009: posts small blind 50
s70n3fac3: posts big blind 100
*** HOLE CARDS ***
FDIBA2009: raises 200 to 300
s70n3fac3: calls 200
*** FLOP *** [8d 5c Qh]
s70n3fac3: checks 
FDIBA2009: checks 
*** TURN *** [8d 5c Qh] [9d]
s70n3fac3: checks 
FDIBA2009: checks 
*** RIVER *** [8d 5c Qh 9d] [Jd]
s70n3fac3: checks 
FDIBA2009: checks 
*** SHOW DOWN ***
s70n3fac3: shows [Ah 4c] (high card Ace)
FDIBA2009: mucks hand 
s70n3fac3 collected 567 from pot
*** SUMMARY ***
Total pot 600 | Rake 33 
Board [8d 5c Qh 9d Jd]
Seat 1: s70n3fac3 (big blind) showed [Ah 4c] and won (567) with high card Ace
Seat 2: FDIBA2009 (button) (small blind) mucked [Kh 3d]



PokerStars Home Game Hand #227559869757: {Club #4781089}  Hold'em No Limit (50/100) - 2021/06/14 0:05:51 EET [2021/06/13 17:05:51 ET]
Table 'VTTP 1306' 2-max (Play Money) Seat #1 is the button
Seat 1: s70n3fac3 (18599 in chips) 
Seat 2: FDIBA2009 (11641 in chips) 
s70n3fac3: posts small blind 50
FDIBA2009: posts big blind 100
*** HOLE CARDS ***
s70n3fac3: folds 
Uncalled bet (50) returned to FDIBA2009
FDIBA2009 collected 100 from pot
FDIBA2009: doesn't show hand 
*** SUMMARY ***
Total pot 100 | Rake 0 
Seat 1: s70n3fac3 (button) (small blind) folded before Flop
Seat 2: FDIBA2009 (big blind) collected (100)



PokerStars Home Game Hand #227559871688: {Club #4781089}  Hold'em No Limit (50/100) - 2021/06/14 0:05:55 EET [2021/06/13 17:05:55 ET]
Table 'VTTP 1306' 2-max (Play Money) Seat #2 is the button
Seat 1: s70n3fac3 (18549 in chips) 
Seat 2: FDIBA2009 (11691 in chips) 
FDIBA2009: posts small blind 50
s70n3fac3: posts big blind 100
*** HOLE CARDS ***
FDIBA2009: raises 100 to 200
s70n3fac3: calls 100
*** FLOP *** [4s 3c 4h]
s70n3fac3: checks 
FDIBA2009: checks 
*** TURN *** [4s 3c 4h] [As]
s70n3fac3: checks 
FDIBA2009: checks 
*** RIVER *** [4s 3c 4h As] [8c]
s70n3fac3: checks 
FDIBA2009: checks 
*** SHOW DOWN ***
s70n3fac3: shows [2d 2c] (two pair, Fours and Deuces)
FDIBA2009: mucks hand 
s70n3fac3 collected 378 from pot
*** SUMMARY ***
Total pot 400 | Rake 22 
Board [4s 3c 4h As 8c]
Seat 1: s70n3fac3 (big blind) showed [2d 2c] and won (378) with two pair, Fours and Deuces
Seat 2: FDIBA2009 (button) (small blind) mucked [2s Kd]



PokerStars Home Game Hand #227559879266: {Club #4781089}  Hold'em No Limit (50/100) - 2021/06/14 0:06:10 EET [2021/06/13 17:06:10 ET]
Table 'VTTP 1306' 2-max (Play Money) Seat #1 is the button
Seat 1: s70n3fac3 (18727 in chips) 
Seat 2: FDIBA2009 (11491 in chips) 
s70n3fac3: posts small blind 50
FDIBA2009: posts big blind 100
*** HOLE CARDS ***
s70n3fac3: calls 50
FDIBA2009: checks 
*** FLOP *** [4s 7c Td]
FDIBA2009: checks 
s70n3fac3: bets 200
FDIBA2009: calls 200
*** TURN *** [4s 7c Td] [Ah]
FDIBA2009: checks 
s70n3fac3: checks 
*** RIVER *** [4s 7c Td Ah] [Tc]
FDIBA2009: checks 
s70n3fac3: checks 
*** SHOW DOWN ***
FDIBA2009: shows [5s 4d] (two pair, Tens and Fours)
s70n3fac3: shows [4h Ks] (two pair, Tens and Fours)
FDIBA2009 collected 284 from pot
s70n3fac3 collected 283 from pot
*** SUMMARY ***
Total pot 600 | Rake 33 
Board [4s 7c Td Ah Tc]
Seat 1: s70n3fac3 (button) (small blind) showed [4h Ks] and won (283) with two pair, Tens and Fours
Seat 2: FDIBA2009 (big blind) showed [5s 4d] and won (284) with two pair, Tens and Fours



PokerStars Home Game Hand #227559887811: {Club #4781089}  Hold'em No Limit (50/100) - 2021/06/14 0:06:28 EET [2021/06/13 17:06:28 ET]
Table 'VTTP 1306' 2-max (Play Money) Seat #2 is the button
Seat 1: s70n3fac3 (18710 in chips) 
Seat 2: FDIBA2009 (11475 in chips) 
FDIBA2009: posts small blind 50
s70n3fac3: posts big blind 100
*** HOLE CARDS ***
FDIBA2009: raises 100 to 200
s70n3fac3: calls 100
*** FLOP *** [2h 4s 6h]
s70n3fac3: checks 
FDIBA2009: bets 378
s70n3fac3: calls 378
*** TURN *** [2h 4s 6h] [7d]
s70n3fac3: checks 
FDIBA2009: checks 
*** RIVER *** [2h 4s 6h 7d] [3h]
s70n3fac3: checks 
FDIBA2009: bets 1100
s70n3fac3: folds 
Uncalled bet (1100) returned to FDIBA2009
FDIBA2009 collected 1092 from pot
FDIBA2009: doesn't show hand 
*** SUMMARY ***
Total pot 1156 | Rake 64 
Board [2h 4s 6h 7d 3h]
Seat 1: s70n3fac3 (big blind) folded on the River
Seat 2: FDIBA2009 (button) (small blind) collected (1092)



PokerStars Home Game Hand #227559901269: {Club #4781089}  Hold'em No Limit (50/100) - 2021/06/14 0:06:55 EET [2021/06/13 17:06:55 ET]
Table 'VTTP 1306' 2-max (Play Money) Seat #1 is the button
Seat 1: s70n3fac3 (18132 in chips) 
Seat 2: FDIBA2009 (11989 in chips) 
s70n3fac3: posts small blind 50
FDIBA2009: posts big blind 100
*** HOLE CARDS ***
s70n3fac3: calls 50
FDIBA2009: raises 100 to 200
s70n3fac3: calls 100
*** FLOP *** [Th 9c Qd]
FDIBA2009: checks 
s70n3fac3: checks 
*** TURN *** [Th 9c Qd] [6s]
FDIBA2009: checks 
s70n3fac3: checks 
*** RIVER *** [Th 9c Qd 6s] [2d]
FDIBA2009: checks 
s70n3fac3: checks 
*** SHOW DOWN ***
FDIBA2009: shows [2s Ks] (a pair of Deuces)
s70n3fac3: mucks hand 
FDIBA2009 collected 378 from pot
*** SUMMARY ***
Total pot 400 | Rake 22 
Board [Th 9c Qd 6s 2d]
Seat 1: s70n3fac3 (button) (small blind) mucked [3c Jc]
Seat 2: FDIBA2009 (big blind) showed [2s Ks] and won (378) with a pair of Deuces



PokerStars Home Game Hand #227559909689: {Club #4781089}  Hold'em No Limit (50/100) - 2021/06/14 0:07:12 EET [2021/06/13 17:07:12 ET]
Table 'VTTP 1306' 2-max (Play Money) Seat #2 is the button
Seat 1: s70n3fac3 (17932 in chips) 
Seat 2: FDIBA2009 (12167 in chips) 
FDIBA2009: posts small blind 50
s70n3fac3: posts big blind 100
*** HOLE CARDS ***
FDIBA2009: raises 100 to 200
s70n3fac3: folds 
Uncalled bet (100) returned to FDIBA2009
FDIBA2009 collected 200 from pot
FDIBA2009: doesn't show hand 
*** SUMMARY ***
Total pot 200 | Rake 0 
Seat 1: s70n3fac3 (big blind) folded before Flop
Seat 2: FDIBA2009 (button) (small blind) collected (200)



PokerStars Home Game Hand #227559913400: {Club #4781089}  Hold'em No Limit (50/100) - 2021/06/14 0:07:19 EET [2021/06/13 17:07:19 ET]
Table 'VTTP 1306' 2-max (Play Money) Seat #1 is the button
Seat 1: s70n3fac3 (17832 in chips) 
Seat 2: FDIBA2009 (12267 in chips) 
s70n3fac3: posts small blind 50
FDIBA2009: posts big blind 100
*** HOLE CARDS ***
s70n3fac3: calls 50
FDIBA2009: checks 
*** FLOP *** [Tc Ah Ks]
FDIBA2009: checks 
s70n3fac3: bets 200
FDIBA2009: folds 
Uncalled bet (200) returned to s70n3fac3
s70n3fac3 collected 189 from pot
s70n3fac3: doesn't show hand 
*** SUMMARY ***
Total pot 200 | Rake 11 
Board [Tc Ah Ks]
Seat 1: s70n3fac3 (button) (small blind) collected (189)
Seat 2: FDIBA2009 (big blind) folded on the Flop



PokerStars Home Game Hand #227559919453: {Club #4781089}  Hold'em No Limit (50/100) - 2021/06/14 0:07:32 EET [2021/06/13 17:07:32 ET]
Table 'VTTP 1306' 2-max (Play Money) Seat #2 is the button
Seat 1: s70n3fac3 (17921 in chips) 
Seat 2: FDIBA2009 (12167 in chips) 
FDIBA2009: posts small blind 50
s70n3fac3: posts big blind 100
*** HOLE CARDS ***
FDIBA2009: raises 200 to 300
s70n3fac3: folds 
Uncalled bet (200) returned to FDIBA2009
FDIBA2009 collected 200 from pot
FDIBA2009: doesn't show hand 
*** SUMMARY ***
Total pot 200 | Rake 0 
Seat 1: s70n3fac3 (big blind) folded before Flop
Seat 2: FDIBA2009 (button) (small blind) collected (200)



PokerStars Home Game Hand #227559922840: {Club #4781089}  Hold'em No Limit (50/100) - 2021/06/14 0:07:38 EET [2021/06/13 17:07:38 ET]
Table 'VTTP 1306' 2-max (Play Money) Seat #1 is the button
Seat 1: s70n3fac3 (17821 in chips) 
Seat 2: FDIBA2009 (12267 in chips) 
s70n3fac3: posts small blind 50
FDIBA2009: posts big blind 100
*** HOLE CARDS ***
s70n3fac3: calls 50
FDIBA2009: checks 
*** FLOP *** [3c Ks 2h]
FDIBA2009: bets 100
s70n3fac3: calls 100
*** TURN *** [3c Ks 2h] [9c]
FDIBA2009: checks 
s70n3fac3: checks 
*** RIVER *** [3c Ks 2h 9c] [4s]
FDIBA2009: checks 
s70n3fac3: bets 378
FDIBA2009: folds 
Uncalled bet (378) returned to s70n3fac3
s70n3fac3 collected 378 from pot
s70n3fac3: doesn't show hand 
*** SUMMARY ***
Total pot 400 | Rake 22 
Board [3c Ks 2h 9c 4s]
Seat 1: s70n3fac3 (button) (small blind) collected (378)
Seat 2: FDIBA2009 (big blind) folded on the River



PokerStars Home Game Hand #227559931508: {Club #4781089}  Hold'em No Limit (50/100) - 2021/06/14 0:07:56 EET [2021/06/13 17:07:56 ET]
Table 'VTTP 1306' 2-max (Play Money) Seat #2 is the button
Seat 1: s70n3fac3 (17999 in chips) 
Seat 2: FDIBA2009 (12067 in chips) 
FDIBA2009: posts small blind 50
s70n3fac3: posts big blind 100
*** HOLE CARDS ***
FDIBA2009: raises 200 to 300
s70n3fac3: calls 200
*** FLOP *** [7c Ah 3s]
s70n3fac3: checks 
FDIBA2009: checks 
*** TURN *** [7c Ah 3s] [Ac]
s70n3fac3: checks 
FDIBA2009: checks 
*** RIVER *** [7c Ah 3s Ac] [Kc]
s70n3fac3: checks 
FDIBA2009: bets 567
s70n3fac3: calls 567
*** SHOW DOWN ***
FDIBA2009: shows [5h Kh] (two pair, Aces and Kings)
s70n3fac3: shows [Ks 5s] (two pair, Aces and Kings)
s70n3fac3 collected 820 from pot
FDIBA2009 collected 819 from pot
*** SUMMARY ***
Total pot 1734 | Rake 95 
Board [7c Ah 3s Ac Kc]
Seat 1: s70n3fac3 (big blind) showed [Ks 5s] and won (820) with two pair, Aces and Kings
Seat 2: FDIBA2009 (button) (small blind) showed [5h Kh] and won (819) with two pair, Aces and Kings



PokerStars Home Game Hand #227559943417: {Club #4781089}  Hold'em No Limit (50/100) - 2021/06/14 0:08:13 EET [2021/06/13 17:08:13 ET]
Table 'VTTP 1306' 2-max (Play Money) Seat #1 is the button
Seat 1: s70n3fac3 (17952 in chips) 
Seat 2: FDIBA2009 (12019 in chips) 
s70n3fac3: posts small blind 50
FDIBA2009: posts big blind 100
*** HOLE CARDS ***
s70n3fac3: folds 
Uncalled bet (50) returned to FDIBA2009
FDIBA2009 collected 100 from pot
FDIBA2009: doesn't show hand 
*** SUMMARY ***
Total pot 100 | Rake 0 
Seat 1: s70n3fac3 (button) (small blind) folded before Flop
Seat 2: FDIBA2009 (big blind) collected (100)



PokerStars Home Game Hand #227559945316: {Club #4781089}  Hold'em No Limit (50/100) - 2021/06/14 0:08:17 EET [2021/06/13 17:08:17 ET]
Table 'VTTP 1306' 2-max (Play Money) Seat #2 is the button
Seat 1: s70n3fac3 (17902 in chips) 
Seat 2: FDIBA2009 (12069 in chips) 
FDIBA2009: posts small blind 50
s70n3fac3: posts big blind 100
*** HOLE CARDS ***
FDIBA2009: raises 100 to 200
s70n3fac3: calls 100
*** FLOP *** [7c 9c Tc]
s70n3fac3: checks 
FDIBA2009: checks 
*** TURN *** [7c 9c Tc] [Ad]
s70n3fac3: checks 
FDIBA2009: bets 100
s70n3fac3: folds 
Uncalled bet (100) returned to FDIBA2009
FDIBA2009 collected 378 from pot
FDIBA2009: doesn't show hand 
*** SUMMARY ***
Total pot 400 | Rake 22 
Board [7c 9c Tc Ad]
Seat 1: s70n3fac3 (big blind) folded on the Turn
Seat 2: FDIBA2009 (button) (small blind) collected (378)



PokerStars Home Game Hand #227559952461: {Club #4781089}  Hold'em No Limit (50/100) - 2021/06/14 0:08:31 EET [2021/06/13 17:08:31 ET]
Table 'VTTP 1306' 2-max (Play Money) Seat #1 is the button
Seat 1: s70n3fac3 (17702 in chips) 
Seat 2: FDIBA2009 (12247 in chips) 
s70n3fac3: posts small blind 50
FDIBA2009: posts big blind 100
*** HOLE CARDS ***
s70n3fac3: calls 50
FDIBA2009: raises 200 to 300
s70n3fac3: calls 200
*** FLOP *** [Kd 5h 8s]
FDIBA2009: checks 
s70n3fac3: bets 400
FDIBA2009: folds 
Uncalled bet (400) returned to s70n3fac3
s70n3fac3 collected 567 from pot
s70n3fac3: doesn't show hand 
*** SUMMARY ***
Total pot 600 | Rake 33 
Board [Kd 5h 8s]
Seat 1: s70n3fac3 (button) (small blind) collected (567)
Seat 2: FDIBA2009 (big blind) folded on the Flop



PokerStars Home Game Hand #227559959202: {Club #4781089}  Hold'em No Limit (50/100) - 2021/06/14 0:08:45 EET [2021/06/13 17:08:45 ET]
Table 'VTTP 1306' 2-max (Play Money) Seat #2 is the button
Seat 1: s70n3fac3 (17969 in chips) 
Seat 2: FDIBA2009 (11947 in chips) 
FDIBA2009: posts small blind 50
s70n3fac3: posts big blind 100
*** HOLE CARDS ***
FDIBA2009: raises 100 to 200
s70n3fac3: calls 100
*** FLOP *** [7s 6h Td]
s70n3fac3: checks 
FDIBA2009: checks 
*** TURN *** [7s 6h Td] [3h]
s70n3fac3: bets 300
FDIBA2009: calls 300
*** RIVER *** [7s 6h Td 3h] [2c]
s70n3fac3: checks 
FDIBA2009: checks 
*** SHOW DOWN ***
s70n3fac3: shows [7d 9d] (a pair of Sevens)
FDIBA2009: mucks hand 
s70n3fac3 collected 945 from pot
*** SUMMARY ***
Total pot 1000 | Rake 55 
Board [7s 6h Td 3h 2c]
Seat 1: s70n3fac3 (big blind) showed [7d 9d] and won (945) with a pair of Sevens
Seat 2: FDIBA2009 (button) (small blind) mucked [Kc 3s]



PokerStars Home Game Hand #227559966824: {Club #4781089}  Hold'em No Limit (50/100) - 2021/06/14 0:09:00 EET [2021/06/13 17:09:00 ET]
Table 'VTTP 1306' 2-max (Play Money) Seat #1 is the button
Seat 1: s70n3fac3 (18414 in chips) 
Seat 2: FDIBA2009 (11447 in chips) 
s70n3fac3: posts small blind 50
FDIBA2009: posts big blind 100
*** HOLE CARDS ***
s70n3fac3: calls 50
FDIBA2009: raises 200 to 300
s70n3fac3: calls 200
*** FLOP *** [9h 6h 3d]
FDIBA2009: bets 350
s70n3fac3: calls 350
*** TURN *** [9h 6h 3d] [3s]
FDIBA2009: bets 900
s70n3fac3: calls 900
*** RIVER *** [9h 6h 3d 3s] [Th]
FDIBA2009: checks 
s70n3fac3: checks 
*** SHOW DOWN ***
FDIBA2009: shows [7s Ac] (a pair of Threes)
s70n3fac3: shows [Jd 9s] (two pair, Nines and Threes)
s70n3fac3 collected 2929 from pot
*** SUMMARY ***
Total pot 3100 | Rake 171 
Board [9h 6h 3d 3s Th]
Seat 1: s70n3fac3 (button) (small blind) showed [Jd 9s] and won (2929) with two pair, Nines and Threes
Seat 2: FDIBA2009 (big blind) showed [7s Ac] and lost with a pair of Threes



PokerStars Home Game Hand #227559979354: {Club #4781089}  Hold'em No Limit (50/100) - 2021/06/14 0:09:25 EET [2021/06/13 17:09:25 ET]
Table 'VTTP 1306' 2-max (Play Money) Seat #2 is the button
Seat 1: s70n3fac3 (19793 in chips) 
Seat 2: FDIBA2009 (9897 in chips) 
FDIBA2009: posts small blind 50
s70n3fac3: posts big blind 100
*** HOLE CARDS ***
FDIBA2009: calls 50
s70n3fac3: checks 
*** FLOP *** [7c Kh Js]
s70n3fac3: checks 
FDIBA2009: checks 
*** TURN *** [7c Kh Js] [Kc]
s70n3fac3: checks 
FDIBA2009: checks 
*** RIVER *** [7c Kh Js Kc] [Ks]
s70n3fac3: bets 200
FDIBA2009: folds 
Uncalled bet (200) returned to s70n3fac3
s70n3fac3 collected 189 from pot
s70n3fac3: doesn't show hand 
*** SUMMARY ***
Total pot 200 | Rake 11 
Board [7c Kh Js Kc Ks]
Seat 1: s70n3fac3 (big blind) collected (189)
Seat 2: FDIBA2009 (button) (small blind) folded on the River



PokerStars Home Game Hand #227559986797: {Club #4781089}  Hold'em No Limit (50/100) - 2021/06/14 0:09:40 EET [2021/06/13 17:09:40 ET]
Table 'VTTP 1306' 2-max (Play Money) Seat #1 is the button
Seat 1: s70n3fac3 (19882 in chips) 
Seat 2: FDIBA2009 (9797 in chips) 
s70n3fac3: posts small blind 50
FDIBA2009: posts big blind 100
*** HOLE CARDS ***
s70n3fac3: raises 200 to 300
FDIBA2009: calls 200
*** FLOP *** [8c Jd 3d]
FDIBA2009: checks 
s70n3fac3: bets 300
FDIBA2009: calls 300
*** TURN *** [8c Jd 3d] [Kc]
FDIBA2009: checks 
s70n3fac3: checks 
*** RIVER *** [8c Jd 3d Kc] [Ts]
FDIBA2009: checks 
s70n3fac3: checks 
*** SHOW DOWN ***
FDIBA2009: shows [3c 6c] (a pair of Threes)
s70n3fac3: shows [As 8d] (a pair of Eights)
s70n3fac3 collected 1134 from pot
*** SUMMARY ***
Total pot 1200 | Rake 66 
Board [8c Jd 3d Kc Ts]
Seat 1: s70n3fac3 (button) (small blind) showed [As 8d] and won (1134) with a pair of Eights
Seat 2: FDIBA2009 (big blind) showed [3c 6c] and lost with a pair of Threes



PokerStars Home Game Hand #227559998738: {Club #4781089}  Hold'em No Limit (50/100) - 2021/06/14 0:10:04 EET [2021/06/13 17:10:04 ET]
Table 'VTTP 1306' 2-max (Play Money) Seat #2 is the button
Seat 1: s70n3fac3 (20416 in chips) 
Seat 2: FDIBA2009 (9197 in chips) 
FDIBA2009: posts small blind 50
s70n3fac3: posts big blind 100
*** HOLE CARDS ***
FDIBA2009: raises 100 to 200
s70n3fac3: folds 
Uncalled bet (100) returned to FDIBA2009
FDIBA2009 collected 200 from pot
FDIBA2009: doesn't show hand 
*** SUMMARY ***
Total pot 200 | Rake 0 
Seat 1: s70n3fac3 (big blind) folded before Flop
Seat 2: FDIBA2009 (button) (small blind) collected (200)



PokerStars Home Game Hand #227560002819: {Club #4781089}  Hold'em No Limit (50/100) - 2021/06/14 0:10:10 EET [2021/06/13 17:10:10 ET]
Table 'VTTP 1306' 2-max (Play Money) Seat #1 is the button
Seat 1: s70n3fac3 (20316 in chips) 
Seat 2: FDIBA2009 (9297 in chips) 
s70n3fac3: posts small blind 50
FDIBA2009: posts big blind 100
*** HOLE CARDS ***
s70n3fac3: calls 50
FDIBA2009: checks 
*** FLOP *** [Td 2c 7d]
FDIBA2009: bets 189
s70n3fac3: folds 
Uncalled bet (189) returned to FDIBA2009
FDIBA2009 collected 189 from pot
FDIBA2009: doesn't show hand 
*** SUMMARY ***
Total pot 200 | Rake 11 
Board [Td 2c 7d]
Seat 1: s70n3fac3 (button) (small blind) folded on the Flop
Seat 2: FDIBA2009 (big blind) collected (189)



PokerStars Home Game Hand #227560007492: {Club #4781089}  Hold'em No Limit (50/100) - 2021/06/14 0:10:20 EET [2021/06/13 17:10:20 ET]
Table 'VTTP 1306' 2-max (Play Money) Seat #2 is the button
Seat 1: s70n3fac3 (20216 in chips) 
Seat 2: FDIBA2009 (9386 in chips) 
FDIBA2009: posts small blind 50
s70n3fac3: posts big blind 100
*** HOLE CARDS ***
FDIBA2009: raises 200 to 300
s70n3fac3: folds 
Uncalled bet (200) returned to FDIBA2009
FDIBA2009 collected 200 from pot
FDIBA2009: doesn't show hand 
*** SUMMARY ***
Total pot 200 | Rake 0 
Seat 1: s70n3fac3 (big blind) folded before Flop
Seat 2: FDIBA2009 (button) (small blind) collected (200)



PokerStars Home Game Hand #227560011279: {Club #4781089}  Hold'em No Limit (50/100) - 2021/06/14 0:10:27 EET [2021/06/13 17:10:27 ET]
Table 'VTTP 1306' 2-max (Play Money) Seat #1 is the button
Seat 1: s70n3fac3 (20116 in chips) 
Seat 2: FDIBA2009 (9486 in chips) 
s70n3fac3: posts small blind 50
FDIBA2009: posts big blind 100
*** HOLE CARDS ***
s70n3fac3: folds 
Uncalled bet (50) returned to FDIBA2009
FDIBA2009 collected 100 from pot
FDIBA2009: doesn't show hand 
*** SUMMARY ***
Total pot 100 | Rake 0 
Seat 1: s70n3fac3 (button) (small blind) folded before Flop
Seat 2: FDIBA2009 (big blind) collected (100)



PokerStars Home Game Hand #227560013232: {Club #4781089}  Hold'em No Limit (50/100) - 2021/06/14 0:10:31 EET [2021/06/13 17:10:31 ET]
Table 'VTTP 1306' 2-max (Play Money) Seat #2 is the button
Seat 1: s70n3fac3 (20066 in chips) 
Seat 2: FDIBA2009 (9536 in chips) 
FDIBA2009: posts small blind 50
s70n3fac3: posts big blind 100
*** HOLE CARDS ***
FDIBA2009: raises 200 to 300
s70n3fac3: calls 200
*** FLOP *** [7h Jh As]
s70n3fac3: checks 
FDIBA2009: bets 300
s70n3fac3: folds 
Uncalled bet (300) returned to FDIBA2009
FDIBA2009 collected 567 from pot
FDIBA2009: doesn't show hand 
*** SUMMARY ***
Total pot 600 | Rake 33 
Board [7h Jh As]
Seat 1: s70n3fac3 (big blind) folded on the Flop
Seat 2: FDIBA2009 (button) (small blind) collected (567)



PokerStars Home Game Hand #227560020038: {Club #4781089}  Hold'em No Limit (50/100) - 2021/06/14 0:10:45 EET [2021/06/13 17:10:45 ET]
Table 'VTTP 1306' 2-max (Play Money) Seat #1 is the button
Seat 1: s70n3fac3 (19766 in chips) 
Seat 2: FDIBA2009 (9803 in chips) 
s70n3fac3: posts small blind 50
FDIBA2009: posts big blind 100
*** HOLE CARDS ***
s70n3fac3: raises 300 to 400
FDIBA2009: calls 300
*** FLOP *** [6h As 7d]
FDIBA2009: checks 
s70n3fac3: bets 600
FDIBA2009: folds 
Uncalled bet (600) returned to s70n3fac3
s70n3fac3 collected 756 from pot
s70n3fac3: doesn't show hand 
*** SUMMARY ***
Total pot 800 | Rake 44 
Board [6h As 7d]
Seat 1: s70n3fac3 (button) (small blind) collected (756)
Seat 2: FDIBA2009 (big blind) folded on the Flop



PokerStars Home Game Hand #227560026203: {Club #4781089}  Hold'em No Limit (50/100) - 2021/06/14 0:10:57 EET [2021/06/13 17:10:57 ET]
Table 'VTTP 1306' 2-max (Play Money) Seat #2 is the button
Seat 1: s70n3fac3 (20122 in chips) 
Seat 2: FDIBA2009 (9403 in chips) 
FDIBA2009: posts small blind 50
s70n3fac3: posts big blind 100
*** HOLE CARDS ***
FDIBA2009: calls 50
s70n3fac3: checks 
*** FLOP *** [4d Jc 6c]
s70n3fac3: checks 
FDIBA2009: bets 189
s70n3fac3: calls 189
*** TURN *** [4d Jc 6c] [Ah]
s70n3fac3: checks 
FDIBA2009: checks 
*** RIVER *** [4d Jc 6c Ah] [9d]
s70n3fac3: checks 
FDIBA2009: bets 546
s70n3fac3: folds 
Uncalled bet (546) returned to FDIBA2009
FDIBA2009 collected 546 from pot
FDIBA2009: doesn't show hand 
*** SUMMARY ***
Total pot 578 | Rake 32 
Board [4d Jc 6c Ah 9d]
Seat 1: s70n3fac3 (big blind) folded on the River
Seat 2: FDIBA2009 (button) (small blind) collected (546)



PokerStars Home Game Hand #227560036122: {Club #4781089}  Hold'em No Limit (50/100) - 2021/06/14 0:11:17 EET [2021/06/13 17:11:17 ET]
Table 'VTTP 1306' 2-max (Play Money) Seat #1 is the button
Seat 1: s70n3fac3 (19833 in chips) 
Seat 2: FDIBA2009 (9660 in chips) 
s70n3fac3: posts small blind 50
FDIBA2009: posts big blind 100
*** HOLE CARDS ***
s70n3fac3: raises 200 to 300
FDIBA2009: folds 
Uncalled bet (200) returned to s70n3fac3
s70n3fac3 collected 200 from pot
s70n3fac3: doesn't show hand 
*** SUMMARY ***
Total pot 200 | Rake 0 
Seat 1: s70n3fac3 (button) (small blind) collected (200)
Seat 2: FDIBA2009 (big blind) folded before Flop



PokerStars Home Game Hand #227560039097: {Club #4781089}  Hold'em No Limit (50/100) - 2021/06/14 0:11:23 EET [2021/06/13 17:11:23 ET]
Table 'VTTP 1306' 2-max (Play Money) Seat #2 is the button
Seat 1: s70n3fac3 (19933 in chips) 
Seat 2: FDIBA2009 (9560 in chips) 
FDIBA2009: posts small blind 50
s70n3fac3: posts big blind 100
*** HOLE CARDS ***
FDIBA2009: raises 100 to 200
s70n3fac3: calls 100
*** FLOP *** [Ah 3c 3s]
s70n3fac3: checks 
FDIBA2009: bets 200
s70n3fac3: folds 
Uncalled bet (200) returned to FDIBA2009
FDIBA2009 collected 378 from pot
FDIBA2009: doesn't show hand 
*** SUMMARY ***
Total pot 400 | Rake 22 
Board [Ah 3c 3s]
Seat 1: s70n3fac3 (big blind) folded on the Flop
Seat 2: FDIBA2009 (button) (small blind) collected (378)



PokerStars Home Game Hand #227560045407: {Club #4781089}  Hold'em No Limit (50/100) - 2021/06/14 0:11:35 EET [2021/06/13 17:11:35 ET]
Table 'VTTP 1306' 2-max (Play Money) Seat #1 is the button
Seat 1: s70n3fac3 (19733 in chips) 
Seat 2: FDIBA2009 (9738 in chips) 
s70n3fac3: posts small blind 50
FDIBA2009: posts big blind 100
*** HOLE CARDS ***
s70n3fac3: raises 200 to 300
FDIBA2009: calls 200
*** FLOP *** [4h Jd 8h]
FDIBA2009: checks 
s70n3fac3: checks 
*** TURN *** [4h Jd 8h] [4c]
FDIBA2009: checks 
s70n3fac3: checks 
*** RIVER *** [4h Jd 8h 4c] [2h]
FDIBA2009: checks 
s70n3fac3: checks 
*** SHOW DOWN ***
FDIBA2009: shows [Ad 7h] (a pair of Fours)
s70n3fac3: mucks hand 
FDIBA2009 collected 567 from pot
*** SUMMARY ***
Total pot 600 | Rake 33 
Board [4h Jd 8h 4c 2h]
Seat 1: s70n3fac3 (button) (small blind) mucked [Kh 9s]
Seat 2: FDIBA2009 (big blind) showed [Ad 7h] and won (567) with a pair of Fours



