PokerStars Home Game Hand #227249178291: {Club #4781089}  Hold'em No Limit (50/100) - 2021/06/01 23:01:49 EET [2021/06/01 16:01:49 ET]
Table 'VTPP NLHE 0106' 2-max (Play Money) Seat #2 is the button
Seat 1: s70n3fac3 (10000 in chips) 
Seat 2: FDIBA2009 (10000 in chips) 
FDIBA2009: posts small blind 50
s70n3fac3: posts big blind 100
*** HOLE CARDS ***
FDIBA2009: raises 100 to 200
s70n3fac3: calls 100
*** FLOP *** [2c Th Tc]
s70n3fac3: checks 
FDIBA2009: bets 200
s70n3fac3: folds 
Uncalled bet (200) returned to FDIBA2009
FDIBA2009 collected 378 from pot
FDIBA2009: doesn't show hand 
*** SUMMARY ***
Total pot 400 | Rake 22 
Board [2c Th Tc]
Seat 1: s70n3fac3 (big blind) folded on the Flop
Seat 2: FDIBA2009 (button) (small blind) collected (378)



PokerStars Home Game Hand #227249190226: {Club #4781089}  Hold'em No Limit (50/100) - 2021/06/01 23:02:13 EET [2021/06/01 16:02:13 ET]
Table 'VTPP NLHE 0106' 2-max (Play Money) Seat #1 is the button
Seat 1: s70n3fac3 (9800 in chips) 
Seat 2: FDIBA2009 (10178 in chips) 
s70n3fac3: posts small blind 50
FDIBA2009: posts big blind 100
*** HOLE CARDS ***
s70n3fac3: folds 
Uncalled bet (50) returned to FDIBA2009
FDIBA2009 collected 100 from pot
FDIBA2009: doesn't show hand 
*** SUMMARY ***
Total pot 100 | Rake 0 
Seat 1: s70n3fac3 (button) (small blind) folded before Flop
Seat 2: FDIBA2009 (big blind) collected (100)



PokerStars Home Game Hand #227249192496: {Club #4781089}  Hold'em No Limit (50/100) - 2021/06/01 23:02:17 EET [2021/06/01 16:02:17 ET]
Table 'VTPP NLHE 0106' 2-max (Play Money) Seat #2 is the button
Seat 1: s70n3fac3 (9750 in chips) 
Seat 2: FDIBA2009 (10228 in chips) 
FDIBA2009: posts small blind 50
s70n3fac3: posts big blind 100
*** HOLE CARDS ***
FDIBA2009: raises 100 to 200
s70n3fac3: calls 100
*** FLOP *** [Qd 9h Kc]
s70n3fac3: checks 
FDIBA2009: bets 200
s70n3fac3: folds 
Uncalled bet (200) returned to FDIBA2009
FDIBA2009 collected 378 from pot
FDIBA2009: doesn't show hand 
*** SUMMARY ***
Total pot 400 | Rake 22 
Board [Qd 9h Kc]
Seat 1: s70n3fac3 (big blind) folded on the Flop
Seat 2: FDIBA2009 (button) (small blind) collected (378)



PokerStars Home Game Hand #227249200189: {Club #4781089}  Hold'em No Limit (50/100) - 2021/06/01 23:02:32 EET [2021/06/01 16:02:32 ET]
Table 'VTPP NLHE 0106' 2-max (Play Money) Seat #1 is the button
Seat 1: s70n3fac3 (9550 in chips) 
Seat 2: FDIBA2009 (10406 in chips) 
s70n3fac3: posts small blind 50
FDIBA2009: posts big blind 100
*** HOLE CARDS ***
s70n3fac3: raises 150 to 250
FDIBA2009: folds 
Uncalled bet (150) returned to s70n3fac3
s70n3fac3 collected 200 from pot
s70n3fac3: doesn't show hand 
*** SUMMARY ***
Total pot 200 | Rake 0 
Seat 1: s70n3fac3 (button) (small blind) collected (200)
Seat 2: FDIBA2009 (big blind) folded before Flop



PokerStars Home Game Hand #227249202739: {Club #4781089}  Hold'em No Limit (50/100) - 2021/06/01 23:02:37 EET [2021/06/01 16:02:37 ET]
Table 'VTPP NLHE 0106' 2-max (Play Money) Seat #2 is the button
Seat 1: s70n3fac3 (9650 in chips) 
Seat 2: FDIBA2009 (10306 in chips) 
FDIBA2009: posts small blind 50
s70n3fac3: posts big blind 100
*** HOLE CARDS ***
FDIBA2009: raises 100 to 200
s70n3fac3: raises 450 to 650
FDIBA2009: folds 
Uncalled bet (450) returned to s70n3fac3
s70n3fac3 collected 400 from pot
s70n3fac3: doesn't show hand 
*** SUMMARY ***
Total pot 400 | Rake 0 
Seat 1: s70n3fac3 (big blind) collected (400)
Seat 2: FDIBA2009 (button) (small blind) folded before Flop



PokerStars Home Game Hand #227249210740: {Club #4781089}  Hold'em No Limit (50/100) - 2021/06/01 23:02:53 EET [2021/06/01 16:02:53 ET]
Table 'VTPP NLHE 0106' 2-max (Play Money) Seat #1 is the button
Seat 1: s70n3fac3 (9850 in chips) 
Seat 2: FDIBA2009 (10106 in chips) 
s70n3fac3: posts small blind 50
FDIBA2009: posts big blind 100
*** HOLE CARDS ***
s70n3fac3: calls 50
FDIBA2009: checks 
*** FLOP *** [Ad 7h Qh]
FDIBA2009: checks 
s70n3fac3: checks 
*** TURN *** [Ad 7h Qh] [Js]
FDIBA2009: checks 
s70n3fac3: bets 200
FDIBA2009: calls 200
*** RIVER *** [Ad 7h Qh Js] [Th]
FDIBA2009: checks 
s70n3fac3: checks 
*** SHOW DOWN ***
FDIBA2009: shows [4h 7c] (a pair of Sevens)
s70n3fac3: mucks hand 
FDIBA2009 collected 567 from pot
*** SUMMARY ***
Total pot 600 | Rake 33 
Board [Ad 7h Qh Js Th]
Seat 1: s70n3fac3 (button) (small blind) mucked [4d 5c]
Seat 2: FDIBA2009 (big blind) showed [4h 7c] and won (567) with a pair of Sevens



PokerStars Home Game Hand #227249224392: {Club #4781089}  Hold'em No Limit (50/100) - 2021/06/01 23:03:19 EET [2021/06/01 16:03:19 ET]
Table 'VTPP NLHE 0106' 2-max (Play Money) Seat #2 is the button
Seat 1: s70n3fac3 (9550 in chips) 
Seat 2: FDIBA2009 (10373 in chips) 
FDIBA2009: posts small blind 50
s70n3fac3: posts big blind 100
*** HOLE CARDS ***
FDIBA2009: raises 100 to 200
s70n3fac3: raises 400 to 600
FDIBA2009: calls 400
*** FLOP *** [5c 4d 2c]
s70n3fac3: bets 660
FDIBA2009: calls 660
*** TURN *** [5c 4d 2c] [2h]
s70n3fac3: bets 1100
FDIBA2009: calls 1100
*** RIVER *** [5c 4d 2c 2h] [3s]
s70n3fac3: bets 2000
FDIBA2009: calls 2000
*** SHOW DOWN ***
s70n3fac3: shows [8s 8d] (two pair, Eights and Deuces)
FDIBA2009: shows [Ac 9h] (a straight, Ace to Five)
FDIBA2009 collected 8240 from pot
*** SUMMARY ***
Total pot 8720 | Rake 480 
Board [5c 4d 2c 2h 3s]
Seat 1: s70n3fac3 (big blind) showed [8s 8d] and lost with two pair, Eights and Deuces
Seat 2: FDIBA2009 (button) (small blind) showed [Ac 9h] and won (8240) with a straight, Ace to Five



PokerStars Home Game Hand #227249247047: {Club #4781089}  Hold'em No Limit (50/100) - 2021/06/01 23:04:03 EET [2021/06/01 16:04:03 ET]
Table 'VTPP NLHE 0106' 2-max (Play Money) Seat #1 is the button
Seat 1: s70n3fac3 (5190 in chips) 
Seat 2: FDIBA2009 (14253 in chips) 
s70n3fac3: posts small blind 50
FDIBA2009: posts big blind 100
*** HOLE CARDS ***
s70n3fac3: folds 
Uncalled bet (50) returned to FDIBA2009
FDIBA2009 collected 100 from pot
FDIBA2009: doesn't show hand 
*** SUMMARY ***
Total pot 100 | Rake 0 
Seat 1: s70n3fac3 (button) (small blind) folded before Flop
Seat 2: FDIBA2009 (big blind) collected (100)



PokerStars Home Game Hand #227249249255: {Club #4781089}  Hold'em No Limit (50/100) - 2021/06/01 23:04:07 EET [2021/06/01 16:04:07 ET]
Table 'VTPP NLHE 0106' 2-max (Play Money) Seat #2 is the button
Seat 1: s70n3fac3 (5140 in chips) 
Seat 2: FDIBA2009 (14303 in chips) 
FDIBA2009: posts small blind 50
s70n3fac3: posts big blind 100
*** HOLE CARDS ***
FDIBA2009: raises 100 to 200
s70n3fac3: calls 100
*** FLOP *** [Ah Ac Kh]
s70n3fac3: checks 
FDIBA2009: bets 189
s70n3fac3: calls 189
*** TURN *** [Ah Ac Kh] [Qc]
s70n3fac3: checks 
FDIBA2009: checks 
*** RIVER *** [Ah Ac Kh Qc] [3c]
s70n3fac3: bets 200
FDIBA2009: folds 
Uncalled bet (200) returned to s70n3fac3
s70n3fac3 collected 735 from pot
s70n3fac3: doesn't show hand 
*** SUMMARY ***
Total pot 778 | Rake 43 
Board [Ah Ac Kh Qc 3c]
Seat 1: s70n3fac3 (big blind) collected (735)
Seat 2: FDIBA2009 (button) (small blind) folded on the River



PokerStars Home Game Hand #227249265917: {Club #4781089}  Hold'em No Limit (50/100) - 2021/06/01 23:04:39 EET [2021/06/01 16:04:39 ET]
Table 'VTPP NLHE 0106' 2-max (Play Money) Seat #1 is the button
Seat 1: s70n3fac3 (5486 in chips) 
Seat 2: FDIBA2009 (13914 in chips) 
s70n3fac3: posts small blind 50
FDIBA2009: posts big blind 100
*** HOLE CARDS ***
s70n3fac3: folds 
Uncalled bet (50) returned to FDIBA2009
FDIBA2009 collected 100 from pot
FDIBA2009: doesn't show hand 
*** SUMMARY ***
Total pot 100 | Rake 0 
Seat 1: s70n3fac3 (button) (small blind) folded before Flop
Seat 2: FDIBA2009 (big blind) collected (100)



PokerStars Home Game Hand #227249268287: {Club #4781089}  Hold'em No Limit (50/100) - 2021/06/01 23:04:43 EET [2021/06/01 16:04:43 ET]
Table 'VTPP NLHE 0106' 2-max (Play Money) Seat #2 is the button
Seat 1: s70n3fac3 (5436 in chips) 
Seat 2: FDIBA2009 (13964 in chips) 
FDIBA2009: posts small blind 50
s70n3fac3: posts big blind 100
*** HOLE CARDS ***
FDIBA2009: raises 100 to 200
s70n3fac3: folds 
Uncalled bet (100) returned to FDIBA2009
FDIBA2009 collected 200 from pot
FDIBA2009: doesn't show hand 
*** SUMMARY ***
Total pot 200 | Rake 0 
Seat 1: s70n3fac3 (big blind) folded before Flop
Seat 2: FDIBA2009 (button) (small blind) collected (200)



PokerStars Home Game Hand #227249272184: {Club #4781089}  Hold'em No Limit (50/100) - 2021/06/01 23:04:51 EET [2021/06/01 16:04:51 ET]
Table 'VTPP NLHE 0106' 2-max (Play Money) Seat #1 is the button
Seat 1: s70n3fac3 (5336 in chips) 
Seat 2: FDIBA2009 (14064 in chips) 
s70n3fac3: posts small blind 50
FDIBA2009: posts big blind 100
*** HOLE CARDS ***
s70n3fac3: calls 50
FDIBA2009: checks 
*** FLOP *** [Td Ts 6s]
FDIBA2009: checks 
s70n3fac3: checks 
*** TURN *** [Td Ts 6s] [7d]
FDIBA2009: bets 100
s70n3fac3: calls 100
*** RIVER *** [Td Ts 6s 7d] [2s]
FDIBA2009: bets 250
s70n3fac3: folds 
Uncalled bet (250) returned to FDIBA2009
FDIBA2009 collected 378 from pot
FDIBA2009: doesn't show hand 
*** SUMMARY ***
Total pot 400 | Rake 22 
Board [Td Ts 6s 7d 2s]
Seat 1: s70n3fac3 (button) (small blind) folded on the River
Seat 2: FDIBA2009 (big blind) collected (378)



PokerStars Home Game Hand #227249284771: {Club #4781089}  Hold'em No Limit (50/100) - 2021/06/01 23:05:14 EET [2021/06/01 16:05:14 ET]
Table 'VTPP NLHE 0106' 2-max (Play Money) Seat #2 is the button
Seat 1: s70n3fac3 (5136 in chips) 
Seat 2: FDIBA2009 (14242 in chips) 
FDIBA2009: posts small blind 50
s70n3fac3: posts big blind 100
*** HOLE CARDS ***
FDIBA2009: raises 100 to 200
s70n3fac3: raises 400 to 600
FDIBA2009: folds 
Uncalled bet (400) returned to s70n3fac3
s70n3fac3 collected 400 from pot
s70n3fac3: doesn't show hand 
*** SUMMARY ***
Total pot 400 | Rake 0 
Seat 1: s70n3fac3 (big blind) collected (400)
Seat 2: FDIBA2009 (button) (small blind) folded before Flop



PokerStars Home Game Hand #227249292997: {Club #4781089}  Hold'em No Limit (50/100) - 2021/06/01 23:05:30 EET [2021/06/01 16:05:30 ET]
Table 'VTPP NLHE 0106' 2-max (Play Money) Seat #1 is the button
Seat 1: s70n3fac3 (5336 in chips) 
Seat 2: FDIBA2009 (14042 in chips) 
s70n3fac3: posts small blind 50
FDIBA2009: posts big blind 100
*** HOLE CARDS ***
s70n3fac3: folds 
Uncalled bet (50) returned to FDIBA2009
FDIBA2009 collected 100 from pot
FDIBA2009: doesn't show hand 
*** SUMMARY ***
Total pot 100 | Rake 0 
Seat 1: s70n3fac3 (button) (small blind) folded before Flop
Seat 2: FDIBA2009 (big blind) collected (100)



PokerStars Home Game Hand #227249295028: {Club #4781089}  Hold'em No Limit (50/100) - 2021/06/01 23:05:34 EET [2021/06/01 16:05:34 ET]
Table 'VTPP NLHE 0106' 2-max (Play Money) Seat #2 is the button
Seat 1: s70n3fac3 (5286 in chips) 
Seat 2: FDIBA2009 (14092 in chips) 
FDIBA2009: posts small blind 50
s70n3fac3: posts big blind 100
*** HOLE CARDS ***
FDIBA2009: raises 100 to 200
s70n3fac3: folds 
Uncalled bet (100) returned to FDIBA2009
FDIBA2009 collected 200 from pot
FDIBA2009: doesn't show hand 
*** SUMMARY ***
Total pot 200 | Rake 0 
Seat 1: s70n3fac3 (big blind) folded before Flop
Seat 2: FDIBA2009 (button) (small blind) collected (200)



PokerStars Home Game Hand #227249299978: {Club #4781089}  Hold'em No Limit (50/100) - 2021/06/01 23:05:43 EET [2021/06/01 16:05:43 ET]
Table 'VTPP NLHE 0106' 2-max (Play Money) Seat #1 is the button
Seat 1: s70n3fac3 (5186 in chips) 
Seat 2: FDIBA2009 (14192 in chips) 
s70n3fac3: posts small blind 50
FDIBA2009: posts big blind 100
*** HOLE CARDS ***
s70n3fac3: folds 
Uncalled bet (50) returned to FDIBA2009
FDIBA2009 collected 100 from pot
FDIBA2009: doesn't show hand 
*** SUMMARY ***
Total pot 100 | Rake 0 
Seat 1: s70n3fac3 (button) (small blind) folded before Flop
Seat 2: FDIBA2009 (big blind) collected (100)



PokerStars Home Game Hand #227249301969: {Club #4781089}  Hold'em No Limit (50/100) - 2021/06/01 23:05:47 EET [2021/06/01 16:05:47 ET]
Table 'VTPP NLHE 0106' 2-max (Play Money) Seat #2 is the button
Seat 1: s70n3fac3 (5136 in chips) 
Seat 2: FDIBA2009 (14242 in chips) 
FDIBA2009: posts small blind 50
s70n3fac3: posts big blind 100
*** HOLE CARDS ***
FDIBA2009: raises 100 to 200
s70n3fac3: folds 
Uncalled bet (100) returned to FDIBA2009
FDIBA2009 collected 200 from pot
FDIBA2009: doesn't show hand 
*** SUMMARY ***
Total pot 200 | Rake 0 
Seat 1: s70n3fac3 (big blind) folded before Flop
Seat 2: FDIBA2009 (button) (small blind) collected (200)



PokerStars Home Game Hand #227249308586: {Club #4781089}  Hold'em No Limit (50/100) - 2021/06/01 23:06:00 EET [2021/06/01 16:06:00 ET]
Table 'VTPP NLHE 0106' 2-max (Play Money) Seat #1 is the button
Seat 1: s70n3fac3 (5036 in chips) 
Seat 2: FDIBA2009 (14342 in chips) 
s70n3fac3: posts small blind 50
FDIBA2009: posts big blind 100
*** HOLE CARDS ***
s70n3fac3: calls 50
FDIBA2009: checks 
*** FLOP *** [9h 8d Ks]
FDIBA2009: checks 
s70n3fac3: checks 
*** TURN *** [9h 8d Ks] [7s]
FDIBA2009: bets 189
s70n3fac3: calls 189
*** RIVER *** [9h 8d Ks 7s] [7h]
FDIBA2009: checks 
s70n3fac3: checks 
*** SHOW DOWN ***
FDIBA2009: shows [8h 5d] (two pair, Eights and Sevens)
s70n3fac3: mucks hand 
FDIBA2009 collected 546 from pot
*** SUMMARY ***
Total pot 578 | Rake 32 
Board [9h 8d Ks 7s 7h]
Seat 1: s70n3fac3 (button) (small blind) mucked [5c Ah]
Seat 2: FDIBA2009 (big blind) showed [8h 5d] and won (546) with two pair, Eights and Sevens



PokerStars Home Game Hand #227249318546: {Club #4781089}  Hold'em No Limit (50/100) - 2021/06/01 23:06:19 EET [2021/06/01 16:06:19 ET]
Table 'VTPP NLHE 0106' 2-max (Play Money) Seat #2 is the button
Seat 1: s70n3fac3 (4747 in chips) 
Seat 2: FDIBA2009 (14599 in chips) 
FDIBA2009: posts small blind 50
s70n3fac3: posts big blind 100
*** HOLE CARDS ***
FDIBA2009: raises 100 to 200
s70n3fac3: calls 100
*** FLOP *** [Th 5c 9d]
s70n3fac3: checks 
FDIBA2009: bets 200
s70n3fac3: calls 200
*** TURN *** [Th 5c 9d] [7d]
s70n3fac3: checks 
FDIBA2009: checks 
*** RIVER *** [Th 5c 9d 7d] [7s]
s70n3fac3: checks 
FDIBA2009: checks 
*** SHOW DOWN ***
s70n3fac3: shows [Ac 6c] (a pair of Sevens)
FDIBA2009: mucks hand 
s70n3fac3 collected 756 from pot
*** SUMMARY ***
Total pot 800 | Rake 44 
Board [Th 5c 9d 7d 7s]
Seat 1: s70n3fac3 (big blind) showed [Ac 6c] and won (756) with a pair of Sevens
Seat 2: FDIBA2009 (button) (small blind) mucked [Qs 3h]



PokerStars Home Game Hand #227249330979: {Club #4781089}  Hold'em No Limit (50/100) - 2021/06/01 23:06:42 EET [2021/06/01 16:06:42 ET]
Table 'VTPP NLHE 0106' 2-max (Play Money) Seat #1 is the button
Seat 1: s70n3fac3 (5103 in chips) 
Seat 2: FDIBA2009 (14199 in chips) 
s70n3fac3: posts small blind 50
FDIBA2009: posts big blind 100
*** HOLE CARDS ***
s70n3fac3: calls 50
FDIBA2009: checks 
*** FLOP *** [8c Kh 8s]
FDIBA2009: checks 
s70n3fac3: checks 
*** TURN *** [8c Kh 8s] [4h]
FDIBA2009: checks 
s70n3fac3: checks 
*** RIVER *** [8c Kh 8s 4h] [Qh]
FDIBA2009: checks 
s70n3fac3: checks 
*** SHOW DOWN ***
FDIBA2009: shows [4c 9d] (two pair, Eights and Fours)
s70n3fac3: mucks hand 
FDIBA2009 collected 189 from pot
*** SUMMARY ***
Total pot 200 | Rake 11 
Board [8c Kh 8s 4h Qh]
Seat 1: s70n3fac3 (button) (small blind) mucked [Tc 7s]
Seat 2: FDIBA2009 (big blind) showed [4c 9d] and won (189) with two pair, Eights and Fours



PokerStars Home Game Hand #227249338923: {Club #4781089}  Hold'em No Limit (50/100) - 2021/06/01 23:06:58 EET [2021/06/01 16:06:58 ET]
Table 'VTPP NLHE 0106' 2-max (Play Money) Seat #2 is the button
Seat 1: s70n3fac3 (5003 in chips) 
Seat 2: FDIBA2009 (14288 in chips) 
FDIBA2009: posts small blind 50
s70n3fac3: posts big blind 100
*** HOLE CARDS ***
FDIBA2009: raises 100 to 200
s70n3fac3: raises 400 to 600
FDIBA2009: calls 400
*** FLOP *** [2h Js 7c]
s70n3fac3: checks 
FDIBA2009: bets 650
s70n3fac3: calls 650
*** TURN *** [2h Js 7c] [8h]
s70n3fac3: checks 
FDIBA2009: bets 1250
s70n3fac3: raises 2503 to 3753 and is all-in
FDIBA2009: calls 2503
*** RIVER *** [2h Js 7c 8h] [4c]
*** SHOW DOWN ***
s70n3fac3: shows [Ah 7h] (a pair of Sevens)
FDIBA2009: shows [As 7d] (a pair of Sevens)
s70n3fac3 collected 4728 from pot
FDIBA2009 collected 4728 from pot
*** SUMMARY ***
Total pot 10006 | Rake 550 
Board [2h Js 7c 8h 4c]
Seat 1: s70n3fac3 (big blind) showed [Ah 7h] and won (4728) with a pair of Sevens
Seat 2: FDIBA2009 (button) (small blind) showed [As 7d] and won (4728) with a pair of Sevens



PokerStars Home Game Hand #227249356419: {Club #4781089}  Hold'em No Limit (50/100) - 2021/06/01 23:07:31 EET [2021/06/01 16:07:31 ET]
Table 'VTPP NLHE 0106' 2-max (Play Money) Seat #1 is the button
Seat 1: s70n3fac3 (4728 in chips) 
Seat 2: FDIBA2009 (14013 in chips) 
s70n3fac3: posts small blind 50
FDIBA2009: posts big blind 100
*** HOLE CARDS ***
s70n3fac3: raises 150 to 250
FDIBA2009: raises 250 to 500
s70n3fac3: calls 250
*** FLOP *** [8d 3h 8s]
FDIBA2009: checks 
s70n3fac3: bets 1250
FDIBA2009: calls 1250
*** TURN *** [8d 3h 8s] [2d]
FDIBA2009: checks 
s70n3fac3: bets 2978 and is all-in
FDIBA2009: calls 2978
*** RIVER *** [8d 3h 8s 2d] [Qd]
*** SHOW DOWN ***
FDIBA2009: shows [Kd Kh] (two pair, Kings and Eights)
s70n3fac3: shows [Ah 3c] (two pair, Eights and Threes)
FDIBA2009 collected 8936 from pot
*** SUMMARY ***
Total pot 9456 | Rake 520 
Board [8d 3h 8s 2d Qd]
Seat 1: s70n3fac3 (button) (small blind) showed [Ah 3c] and lost with two pair, Eights and Threes
Seat 2: FDIBA2009 (big blind) showed [Kd Kh] and won (8936) with two pair, Kings and Eights



PokerStars Home Game Hand #227249384100: {Club #4781089}  Hold'em No Limit (50/100) - 2021/06/01 23:08:24 EET [2021/06/01 16:08:24 ET]
Table 'VTPP NLHE 0106' 2-max (Play Money) Seat #2 is the button
Seat 1: s70n3fac3 (10000 in chips) 
Seat 2: FDIBA2009 (18221 in chips) 
FDIBA2009: posts small blind 50
s70n3fac3: posts big blind 100
*** HOLE CARDS ***
FDIBA2009: calls 50
s70n3fac3: raises 200 to 300
FDIBA2009: calls 200
*** FLOP *** [Jh 5h Ah]
s70n3fac3: checks 
FDIBA2009: checks 
*** TURN *** [Jh 5h Ah] [3s]
s70n3fac3: bets 300
FDIBA2009: folds 
Uncalled bet (300) returned to s70n3fac3
s70n3fac3 collected 567 from pot
s70n3fac3: doesn't show hand 
*** SUMMARY ***
Total pot 600 | Rake 33 
Board [Jh 5h Ah 3s]
Seat 1: s70n3fac3 (big blind) collected (567)
Seat 2: FDIBA2009 (button) (small blind) folded on the Turn



PokerStars Home Game Hand #227249392996: {Club #4781089}  Hold'em No Limit (50/100) - 2021/06/01 23:08:41 EET [2021/06/01 16:08:41 ET]
Table 'VTPP NLHE 0106' 2-max (Play Money) Seat #1 is the button
Seat 1: s70n3fac3 (10267 in chips) 
Seat 2: FDIBA2009 (17921 in chips) 
s70n3fac3: posts small blind 50
FDIBA2009: posts big blind 100
*** HOLE CARDS ***
s70n3fac3: calls 50
FDIBA2009: raises 150 to 250
s70n3fac3: calls 150
*** FLOP *** [3s Th 9d]
FDIBA2009: bets 250
s70n3fac3: calls 250
*** TURN *** [3s Th 9d] [Kc]
FDIBA2009: bets 550
s70n3fac3: folds 
Uncalled bet (550) returned to FDIBA2009
FDIBA2009 collected 945 from pot
FDIBA2009: doesn't show hand 
*** SUMMARY ***
Total pot 1000 | Rake 55 
Board [3s Th 9d Kc]
Seat 1: s70n3fac3 (button) (small blind) folded on the Turn
Seat 2: FDIBA2009 (big blind) collected (945)



PokerStars Home Game Hand #227249405862: {Club #4781089}  Hold'em No Limit (50/100) - 2021/06/01 23:09:05 EET [2021/06/01 16:09:05 ET]
Table 'VTPP NLHE 0106' 2-max (Play Money) Seat #2 is the button
Seat 1: s70n3fac3 (9767 in chips) 
Seat 2: FDIBA2009 (18366 in chips) 
FDIBA2009: posts small blind 50
s70n3fac3: posts big blind 100
*** HOLE CARDS ***
FDIBA2009: raises 100 to 200
s70n3fac3: raises 450 to 650
FDIBA2009: calls 450
*** FLOP *** [Qs 7d 9d]
s70n3fac3: bets 750
FDIBA2009: raises 950 to 1700
s70n3fac3: calls 950
*** TURN *** [Qs 7d 9d] [Qc]
s70n3fac3: checks 
FDIBA2009: checks 
*** RIVER *** [Qs 7d 9d Qc] [9c]
s70n3fac3: bets 2450
FDIBA2009: calls 2450
*** SHOW DOWN ***
s70n3fac3: shows [Jd Th] (two pair, Queens and Nines)
FDIBA2009: shows [7s 9s] (a full house, Nines full of Queens)
FDIBA2009 collected 9072 from pot
*** SUMMARY ***
Total pot 9600 | Rake 528 
Board [Qs 7d 9d Qc 9c]
Seat 1: s70n3fac3 (big blind) showed [Jd Th] and lost with two pair, Queens and Nines
Seat 2: FDIBA2009 (button) (small blind) showed [7s 9s] and won (9072) with a full house, Nines full of Queens



PokerStars Home Game Hand #227249433699: {Club #4781089}  Hold'em No Limit (50/100) - 2021/06/01 23:09:53 EET [2021/06/01 16:09:53 ET]
Table 'VTPP NLHE 0106' 2-max (Play Money) Seat #1 is the button
Seat 1: s70n3fac3 (4967 in chips) 
Seat 2: FDIBA2009 (22638 in chips) 
s70n3fac3: posts small blind 50
FDIBA2009: posts big blind 100
*** HOLE CARDS ***
s70n3fac3: raises 200 to 300
FDIBA2009: folds 
Uncalled bet (200) returned to s70n3fac3
s70n3fac3 collected 200 from pot
s70n3fac3: doesn't show hand 
*** SUMMARY ***
Total pot 200 | Rake 0 
Seat 1: s70n3fac3 (button) (small blind) collected (200)
Seat 2: FDIBA2009 (big blind) folded before Flop



PokerStars Home Game Hand #227249437063: {Club #4781089}  Hold'em No Limit (50/100) - 2021/06/01 23:10:00 EET [2021/06/01 16:10:00 ET]
Table 'VTPP NLHE 0106' 2-max (Play Money) Seat #2 is the button
Seat 1: s70n3fac3 (5067 in chips) 
Seat 2: FDIBA2009 (22538 in chips) 
FDIBA2009: posts small blind 50
s70n3fac3: posts big blind 100
*** HOLE CARDS ***
FDIBA2009: raises 100 to 200
s70n3fac3: calls 100
*** FLOP *** [Qs Ts 5d]
s70n3fac3: checks 
FDIBA2009: checks 
*** TURN *** [Qs Ts 5d] [2c]
s70n3fac3: checks 
FDIBA2009: bets 100
s70n3fac3: raises 300 to 400
FDIBA2009: calls 300
*** RIVER *** [Qs Ts 5d 2c] [7d]
s70n3fac3: bets 1400
FDIBA2009: folds 
Uncalled bet (1400) returned to s70n3fac3
s70n3fac3 collected 1134 from pot
s70n3fac3: doesn't show hand 
*** SUMMARY ***
Total pot 1200 | Rake 66 
Board [Qs Ts 5d 2c 7d]
Seat 1: s70n3fac3 (big blind) collected (1134)
Seat 2: FDIBA2009 (button) (small blind) folded on the River



PokerStars Home Game Hand #227249453621: {Club #4781089}  Hold'em No Limit (50/100) - 2021/06/01 23:10:31 EET [2021/06/01 16:10:31 ET]
Table 'VTPP NLHE 0106' 2-max (Play Money) Seat #1 is the button
Seat 1: s70n3fac3 (5601 in chips) 
Seat 2: FDIBA2009 (21938 in chips) 
s70n3fac3: posts small blind 50
FDIBA2009: posts big blind 100
*** HOLE CARDS ***
s70n3fac3: raises 200 to 300
FDIBA2009: folds 
Uncalled bet (200) returned to s70n3fac3
s70n3fac3 collected 200 from pot
s70n3fac3: doesn't show hand 
*** SUMMARY ***
Total pot 200 | Rake 0 
Seat 1: s70n3fac3 (button) (small blind) collected (200)
Seat 2: FDIBA2009 (big blind) folded before Flop



PokerStars Home Game Hand #227249456658: {Club #4781089}  Hold'em No Limit (50/100) - 2021/06/01 23:10:37 EET [2021/06/01 16:10:37 ET]
Table 'VTPP NLHE 0106' 2-max (Play Money) Seat #2 is the button
Seat 1: s70n3fac3 (5701 in chips) 
Seat 2: FDIBA2009 (21838 in chips) 
FDIBA2009: posts small blind 50
s70n3fac3: posts big blind 100
*** HOLE CARDS ***
FDIBA2009: folds 
Uncalled bet (50) returned to s70n3fac3
s70n3fac3 collected 100 from pot
s70n3fac3: doesn't show hand 
*** SUMMARY ***
Total pot 100 | Rake 0 
Seat 1: s70n3fac3 (big blind) collected (100)
Seat 2: FDIBA2009 (button) (small blind) folded before Flop



PokerStars Home Game Hand #227249459411: {Club #4781089}  Hold'em No Limit (50/100) - 2021/06/01 23:10:42 EET [2021/06/01 16:10:42 ET]
Table 'VTPP NLHE 0106' 2-max (Play Money) Seat #1 is the button
Seat 1: s70n3fac3 (5751 in chips) 
Seat 2: FDIBA2009 (21788 in chips) 
s70n3fac3: posts small blind 50
FDIBA2009: posts big blind 100
*** HOLE CARDS ***
s70n3fac3: raises 150 to 250
FDIBA2009: folds 
Uncalled bet (150) returned to s70n3fac3
s70n3fac3 collected 200 from pot
s70n3fac3: doesn't show hand 
*** SUMMARY ***
Total pot 200 | Rake 0 
Seat 1: s70n3fac3 (button) (small blind) collected (200)
Seat 2: FDIBA2009 (big blind) folded before Flop



PokerStars Home Game Hand #227249462262: {Club #4781089}  Hold'em No Limit (50/100) - 2021/06/01 23:10:48 EET [2021/06/01 16:10:48 ET]
Table 'VTPP NLHE 0106' 2-max (Play Money) Seat #2 is the button
Seat 1: s70n3fac3 (5851 in chips) 
Seat 2: FDIBA2009 (21688 in chips) 
FDIBA2009: posts small blind 50
s70n3fac3: posts big blind 100
*** HOLE CARDS ***
FDIBA2009: raises 100 to 200
s70n3fac3: calls 100
*** FLOP *** [6h Qd Ad]
s70n3fac3: checks 
FDIBA2009: bets 200
s70n3fac3: folds 
Uncalled bet (200) returned to FDIBA2009
FDIBA2009 collected 378 from pot
*** SUMMARY ***
Total pot 400 | Rake 22 
Board [6h Qd Ad]
Seat 1: s70n3fac3 (big blind) folded on the Flop
Seat 2: FDIBA2009 (button) (small blind) collected (378)



PokerStars Home Game Hand #227249471062: {Club #4781089}  Hold'em No Limit (50/100) - 2021/06/01 23:11:05 EET [2021/06/01 16:11:05 ET]
Table 'VTPP NLHE 0106' 2-max (Play Money) Seat #1 is the button
Seat 1: s70n3fac3 (5651 in chips) 
Seat 2: FDIBA2009 (21866 in chips) 
s70n3fac3: posts small blind 50
FDIBA2009: posts big blind 100
*** HOLE CARDS ***
s70n3fac3: folds 
Uncalled bet (50) returned to FDIBA2009
FDIBA2009 collected 100 from pot
FDIBA2009: doesn't show hand 
*** SUMMARY ***
Total pot 100 | Rake 0 
Seat 1: s70n3fac3 (button) (small blind) folded before Flop
Seat 2: FDIBA2009 (big blind) collected (100)



PokerStars Home Game Hand #227249473019: {Club #4781089}  Hold'em No Limit (50/100) - 2021/06/01 23:11:08 EET [2021/06/01 16:11:08 ET]
Table 'VTPP NLHE 0106' 2-max (Play Money) Seat #2 is the button
Seat 1: s70n3fac3 (5601 in chips) 
Seat 2: FDIBA2009 (21916 in chips) 
FDIBA2009: posts small blind 50
s70n3fac3: posts big blind 100
*** HOLE CARDS ***
FDIBA2009: raises 100 to 200
s70n3fac3: calls 100
*** FLOP *** [Jd Th 7h]
s70n3fac3: checks 
FDIBA2009: checks 
*** TURN *** [Jd Th 7h] [As]
s70n3fac3: checks 
FDIBA2009: bets 200
s70n3fac3: calls 200
*** RIVER *** [Jd Th 7h As] [2h]
s70n3fac3: checks 
FDIBA2009: bets 756
s70n3fac3: folds 
Uncalled bet (756) returned to FDIBA2009
FDIBA2009 collected 756 from pot
FDIBA2009: doesn't show hand 
*** SUMMARY ***
Total pot 800 | Rake 44 
Board [Jd Th 7h As 2h]
Seat 1: s70n3fac3 (big blind) folded on the River
Seat 2: FDIBA2009 (button) (small blind) collected (756)



PokerStars Home Game Hand #227249488210: {Club #4781089}  Hold'em No Limit (50/100) - 2021/06/01 23:11:38 EET [2021/06/01 16:11:38 ET]
Table 'VTPP NLHE 0106' 2-max (Play Money) Seat #1 is the button
Seat 1: s70n3fac3 (5201 in chips) 
Seat 2: FDIBA2009 (22272 in chips) 
s70n3fac3: posts small blind 50
FDIBA2009: posts big blind 100
*** HOLE CARDS ***
s70n3fac3: raises 200 to 300
FDIBA2009: folds 
Uncalled bet (200) returned to s70n3fac3
s70n3fac3 collected 200 from pot
s70n3fac3: doesn't show hand 
*** SUMMARY ***
Total pot 200 | Rake 0 
Seat 1: s70n3fac3 (button) (small blind) collected (200)
Seat 2: FDIBA2009 (big blind) folded before Flop



PokerStars Home Game Hand #227249490857: {Club #4781089}  Hold'em No Limit (50/100) - 2021/06/01 23:11:42 EET [2021/06/01 16:11:42 ET]
Table 'VTPP NLHE 0106' 2-max (Play Money) Seat #2 is the button
Seat 1: s70n3fac3 (5301 in chips) 
Seat 2: FDIBA2009 (22172 in chips) 
FDIBA2009: posts small blind 50
s70n3fac3: posts big blind 100
*** HOLE CARDS ***
FDIBA2009: raises 100 to 200
s70n3fac3: calls 100
*** FLOP *** [7h Ah 6h]
s70n3fac3: checks 
FDIBA2009: checks 
*** TURN *** [7h Ah 6h] [Ac]
s70n3fac3: checks 
FDIBA2009: checks 
*** RIVER *** [7h Ah 6h Ac] [Ks]
s70n3fac3: checks 
FDIBA2009: bets 378
s70n3fac3: folds 
Uncalled bet (378) returned to FDIBA2009
FDIBA2009 collected 378 from pot
FDIBA2009: doesn't show hand 
*** SUMMARY ***
Total pot 400 | Rake 22 
Board [7h Ah 6h Ac Ks]
Seat 1: s70n3fac3 (big blind) folded on the River
Seat 2: FDIBA2009 (button) (small blind) collected (378)



PokerStars Home Game Hand #227249499785: {Club #4781089}  Hold'em No Limit (50/100) - 2021/06/01 23:12:00 EET [2021/06/01 16:12:00 ET]
Table 'VTPP NLHE 0106' 2-max (Play Money) Seat #1 is the button
Seat 1: s70n3fac3 (5101 in chips) 
Seat 2: FDIBA2009 (22350 in chips) 
s70n3fac3: posts small blind 50
FDIBA2009: posts big blind 100
*** HOLE CARDS ***
s70n3fac3: raises 200 to 300
FDIBA2009: raises 200 to 500
s70n3fac3: raises 700 to 1200
FDIBA2009: folds 
Uncalled bet (700) returned to s70n3fac3
s70n3fac3 collected 1000 from pot
s70n3fac3: doesn't show hand 
*** SUMMARY ***
Total pot 1000 | Rake 0 
Seat 1: s70n3fac3 (button) (small blind) collected (1000)
Seat 2: FDIBA2009 (big blind) folded before Flop



PokerStars Home Game Hand #227249505109: {Club #4781089}  Hold'em No Limit (50/100) - 2021/06/01 23:12:10 EET [2021/06/01 16:12:10 ET]
Table 'VTPP NLHE 0106' 2-max (Play Money) Seat #2 is the button
Seat 1: s70n3fac3 (5601 in chips) 
Seat 2: FDIBA2009 (21850 in chips) 
FDIBA2009: posts small blind 50
s70n3fac3: posts big blind 100
*** HOLE CARDS ***
FDIBA2009: raises 100 to 200
s70n3fac3: raises 400 to 600
FDIBA2009: calls 400
*** FLOP *** [5c 3h 2s]
s70n3fac3: checks 
FDIBA2009: bets 650
s70n3fac3: raises 4351 to 5001 and is all-in
FDIBA2009: calls 4351
*** TURN *** [5c 3h 2s] [5s]
*** RIVER *** [5c 3h 2s 5s] [9s]
*** SHOW DOWN ***
s70n3fac3: shows [As Jd] (a pair of Fives)
FDIBA2009: shows [7d 7c] (two pair, Sevens and Fives)
FDIBA2009 collected 10586 from pot
*** SUMMARY ***
Total pot 11202 | Rake 616 
Board [5c 3h 2s 5s 9s]
Seat 1: s70n3fac3 (big blind) showed [As Jd] and lost with a pair of Fives
Seat 2: FDIBA2009 (button) (small blind) showed [7d 7c] and won (10586) with two pair, Sevens and Fives



PokerStars Home Game Hand #227249522978: {Club #4781089}  Hold'em No Limit (50/100) - 2021/06/01 23:12:44 EET [2021/06/01 16:12:44 ET]
Table 'VTPP NLHE 0106' 2-max (Play Money) Seat #1 is the button
Seat 1: s70n3fac3 (10000 in chips) 
Seat 2: FDIBA2009 (26835 in chips) 
s70n3fac3: posts small blind 50
FDIBA2009: posts big blind 100
*** HOLE CARDS ***
s70n3fac3: raises 150 to 250
FDIBA2009: calls 150
*** FLOP *** [Js 5h 3h]
FDIBA2009: checks 
s70n3fac3: bets 300
FDIBA2009: folds 
Uncalled bet (300) returned to s70n3fac3
s70n3fac3 collected 472 from pot
s70n3fac3: doesn't show hand 
*** SUMMARY ***
Total pot 500 | Rake 28 
Board [Js 5h 3h]
Seat 1: s70n3fac3 (button) (small blind) collected (472)
Seat 2: FDIBA2009 (big blind) folded on the Flop



PokerStars Home Game Hand #227249528707: {Club #4781089}  Hold'em No Limit (50/100) - 2021/06/01 23:12:55 EET [2021/06/01 16:12:55 ET]
Table 'VTPP NLHE 0106' 2-max (Play Money) Seat #2 is the button
Seat 1: s70n3fac3 (10222 in chips) 
Seat 2: FDIBA2009 (26585 in chips) 
FDIBA2009: posts small blind 50
s70n3fac3: posts big blind 100
*** HOLE CARDS ***
FDIBA2009: raises 100 to 200
s70n3fac3: raises 400 to 600
FDIBA2009: calls 400
*** FLOP *** [3s 7c Jd]
s70n3fac3: checks 
FDIBA2009: checks 
*** TURN *** [3s 7c Jd] [Qs]
s70n3fac3: checks 
FDIBA2009: checks 
*** RIVER *** [3s 7c Jd Qs] [7d]
s70n3fac3: checks 
FDIBA2009: bets 900
s70n3fac3: calls 900
*** SHOW DOWN ***
FDIBA2009: shows [9h 8c] (a pair of Sevens)
s70n3fac3: shows [8h Ac] (a pair of Sevens - Ace kicker)
s70n3fac3 collected 2835 from pot
*** SUMMARY ***
Total pot 3000 | Rake 165 
Board [3s 7c Jd Qs 7d]
Seat 1: s70n3fac3 (big blind) showed [8h Ac] and won (2835) with a pair of Sevens
Seat 2: FDIBA2009 (button) (small blind) showed [9h 8c] and lost with a pair of Sevens



PokerStars Home Game Hand #227249541339: {Club #4781089}  Hold'em No Limit (50/100) - 2021/06/01 23:13:20 EET [2021/06/01 16:13:20 ET]
Table 'VTPP NLHE 0106' 2-max (Play Money) Seat #1 is the button
Seat 1: s70n3fac3 (11557 in chips) 
Seat 2: FDIBA2009 (25085 in chips) 
s70n3fac3: posts small blind 50
FDIBA2009: posts big blind 100
*** HOLE CARDS ***
s70n3fac3: calls 50
FDIBA2009: checks 
*** FLOP *** [5d 3h 8c]
FDIBA2009: checks 
s70n3fac3: bets 200
FDIBA2009: calls 200
*** TURN *** [5d 3h 8c] [7s]
FDIBA2009: checks 
s70n3fac3: checks 
*** RIVER *** [5d 3h 8c 7s] [8d]
FDIBA2009: checks 
s70n3fac3: checks 
*** SHOW DOWN ***
FDIBA2009: shows [As 9d] (a pair of Eights)
s70n3fac3: shows [5h Kc] (two pair, Eights and Fives)
s70n3fac3 collected 567 from pot
*** SUMMARY ***
Total pot 600 | Rake 33 
Board [5d 3h 8c 7s 8d]
Seat 1: s70n3fac3 (button) (small blind) showed [5h Kc] and won (567) with two pair, Eights and Fives
Seat 2: FDIBA2009 (big blind) showed [As 9d] and lost with a pair of Eights



PokerStars Home Game Hand #227249551950: {Club #4781089}  Hold'em No Limit (50/100) - 2021/06/01 23:13:39 EET [2021/06/01 16:13:39 ET]
Table 'VTPP NLHE 0106' 2-max (Play Money) Seat #2 is the button
Seat 1: s70n3fac3 (11824 in chips) 
Seat 2: FDIBA2009 (24785 in chips) 
FDIBA2009: posts small blind 50
s70n3fac3: posts big blind 100
*** HOLE CARDS ***
FDIBA2009: raises 100 to 200
s70n3fac3: calls 100
*** FLOP *** [5c 3h Jh]
s70n3fac3: checks 
FDIBA2009: bets 378
s70n3fac3: calls 378
*** TURN *** [5c 3h Jh] [Ac]
s70n3fac3: checks 
FDIBA2009: bets 1092
s70n3fac3: folds 
Uncalled bet (1092) returned to FDIBA2009
FDIBA2009 collected 1092 from pot
FDIBA2009: doesn't show hand 
*** SUMMARY ***
Total pot 1156 | Rake 64 
Board [5c 3h Jh Ac]
Seat 1: s70n3fac3 (big blind) folded on the Turn
Seat 2: FDIBA2009 (button) (small blind) collected (1092)



PokerStars Home Game Hand #227249563330: {Club #4781089}  Hold'em No Limit (50/100) - 2021/06/01 23:14:01 EET [2021/06/01 16:14:01 ET]
Table 'VTPP NLHE 0106' 2-max (Play Money) Seat #1 is the button
Seat 1: s70n3fac3 (11246 in chips) 
Seat 2: FDIBA2009 (25299 in chips) 
s70n3fac3: posts small blind 50
FDIBA2009: posts big blind 100
*** HOLE CARDS ***
s70n3fac3: raises 150 to 250
FDIBA2009: calls 150
*** FLOP *** [2d Ks 5s]
FDIBA2009: checks 
s70n3fac3: bets 300
FDIBA2009: calls 300
*** TURN *** [2d Ks 5s] [8d]
FDIBA2009: checks 
s70n3fac3: bets 600
FDIBA2009: folds 
Uncalled bet (600) returned to s70n3fac3
s70n3fac3 collected 1039 from pot
s70n3fac3: doesn't show hand 
*** SUMMARY ***
Total pot 1100 | Rake 61 
Board [2d Ks 5s 8d]
Seat 1: s70n3fac3 (button) (small blind) collected (1039)
Seat 2: FDIBA2009 (big blind) folded on the Turn



PokerStars Home Game Hand #227249573381: {Club #4781089}  Hold'em No Limit (50/100) - 2021/06/01 23:14:21 EET [2021/06/01 16:14:21 ET]
Table 'VTPP NLHE 0106' 2-max (Play Money) Seat #2 is the button
Seat 1: s70n3fac3 (11735 in chips) 
Seat 2: FDIBA2009 (24749 in chips) 
FDIBA2009: posts small blind 50
s70n3fac3: posts big blind 100
*** HOLE CARDS ***
FDIBA2009: raises 100 to 200
s70n3fac3: calls 100
*** FLOP *** [5s 4s 3d]
s70n3fac3: checks 
FDIBA2009: bets 378
s70n3fac3: calls 378
*** TURN *** [5s 4s 3d] [6h]
s70n3fac3: checks 
FDIBA2009: checks 
*** RIVER *** [5s 4s 3d 6h] [7s]
s70n3fac3: checks 
FDIBA2009: bets 1092
s70n3fac3: calls 1092
*** SHOW DOWN ***
FDIBA2009: shows [4d 3s] (a straight, Three to Seven)
s70n3fac3: shows [2d 2s] (a straight, Three to Seven)
s70n3fac3 collected 1578 from pot
FDIBA2009 collected 1578 from pot
*** SUMMARY ***
Total pot 3340 | Rake 184 
Board [5s 4s 3d 6h 7s]
Seat 1: s70n3fac3 (big blind) showed [2d 2s] and won (1578) with a straight, Three to Seven
Seat 2: FDIBA2009 (button) (small blind) showed [4d 3s] and won (1578) with a straight, Three to Seven



PokerStars Home Game Hand #227249586339: {Club #4781089}  Hold'em No Limit (50/100) - 2021/06/01 23:14:46 EET [2021/06/01 16:14:46 ET]
Table 'VTPP NLHE 0106' 2-max (Play Money) Seat #1 is the button
Seat 1: s70n3fac3 (11643 in chips) 
Seat 2: FDIBA2009 (24657 in chips) 
s70n3fac3: posts small blind 50
FDIBA2009: posts big blind 100
*** HOLE CARDS ***
s70n3fac3: calls 50
FDIBA2009: raises 100 to 200
s70n3fac3: calls 100
*** FLOP *** [7c 2h 5s]
FDIBA2009: checks 
s70n3fac3: bets 300
FDIBA2009: calls 300
*** TURN *** [7c 2h 5s] [Ad]
FDIBA2009: checks 
s70n3fac3: bets 600
FDIBA2009: folds 
Uncalled bet (600) returned to s70n3fac3
s70n3fac3 collected 945 from pot
s70n3fac3: doesn't show hand 
*** SUMMARY ***
Total pot 1000 | Rake 55 
Board [7c 2h 5s Ad]
Seat 1: s70n3fac3 (button) (small blind) collected (945)
Seat 2: FDIBA2009 (big blind) folded on the Turn



PokerStars Home Game Hand #227249599507: {Club #4781089}  Hold'em No Limit (50/100) - 2021/06/01 23:15:11 EET [2021/06/01 16:15:11 ET]
Table 'VTPP NLHE 0106' 2-max (Play Money) Seat #2 is the button
Seat 1: s70n3fac3 (12088 in chips) 
Seat 2: FDIBA2009 (24157 in chips) 
FDIBA2009: posts small blind 50
s70n3fac3: posts big blind 100
*** HOLE CARDS ***
FDIBA2009: raises 100 to 200
s70n3fac3: raises 400 to 600
FDIBA2009: calls 400
*** FLOP *** [7s Kc Th]
s70n3fac3: bets 600
FDIBA2009: calls 600
*** TURN *** [7s Kc Th] [Ac]
s70n3fac3: checks 
FDIBA2009: checks 
*** RIVER *** [7s Kc Th Ac] [2c]
s70n3fac3: bets 1400
FDIBA2009: folds 
Uncalled bet (1400) returned to s70n3fac3
s70n3fac3 collected 2268 from pot
s70n3fac3: doesn't show hand 
*** SUMMARY ***
Total pot 2400 | Rake 132 
Board [7s Kc Th Ac 2c]
Seat 1: s70n3fac3 (big blind) collected (2268)
Seat 2: FDIBA2009 (button) (small blind) folded on the River



PokerStars Home Game Hand #227249620236: {Club #4781089}  Hold'em No Limit (50/100) - 2021/06/01 23:15:50 EET [2021/06/01 16:15:50 ET]
Table 'VTPP NLHE 0106' 2-max (Play Money) Seat #1 is the button
Seat 1: s70n3fac3 (13156 in chips) 
Seat 2: FDIBA2009 (22957 in chips) 
s70n3fac3: posts small blind 50
FDIBA2009: posts big blind 100
*** HOLE CARDS ***
s70n3fac3: calls 50
FDIBA2009: checks 
*** FLOP *** [Ad Ac 7c]
FDIBA2009: checks 
s70n3fac3: checks 
*** TURN *** [Ad Ac 7c] [4d]
FDIBA2009: bets 189
s70n3fac3: folds 
Uncalled bet (189) returned to FDIBA2009
FDIBA2009 collected 189 from pot
FDIBA2009: doesn't show hand 
*** SUMMARY ***
Total pot 200 | Rake 11 
Board [Ad Ac 7c 4d]
Seat 1: s70n3fac3 (button) (small blind) folded on the Turn
Seat 2: FDIBA2009 (big blind) collected (189)



PokerStars Home Game Hand #227249627192: {Club #4781089}  Hold'em No Limit (50/100) - 2021/06/01 23:16:03 EET [2021/06/01 16:16:03 ET]
Table 'VTPP NLHE 0106' 2-max (Play Money) Seat #2 is the button
Seat 1: s70n3fac3 (13056 in chips) 
Seat 2: FDIBA2009 (23046 in chips) 
FDIBA2009: posts small blind 50
s70n3fac3: posts big blind 100
*** HOLE CARDS ***
FDIBA2009: raises 100 to 200
s70n3fac3: folds 
Uncalled bet (100) returned to FDIBA2009
FDIBA2009 collected 200 from pot
FDIBA2009: doesn't show hand 
*** SUMMARY ***
Total pot 200 | Rake 0 
Seat 1: s70n3fac3 (big blind) folded before Flop
Seat 2: FDIBA2009 (button) (small blind) collected (200)



PokerStars Home Game Hand #227249630313: {Club #4781089}  Hold'em No Limit (50/100) - 2021/06/01 23:16:08 EET [2021/06/01 16:16:08 ET]
Table 'VTPP NLHE 0106' 2-max (Play Money) Seat #1 is the button
Seat 1: s70n3fac3 (12956 in chips) 
Seat 2: FDIBA2009 (23146 in chips) 
s70n3fac3: posts small blind 50
FDIBA2009: posts big blind 100
*** HOLE CARDS ***
s70n3fac3: folds 
Uncalled bet (50) returned to FDIBA2009
FDIBA2009 collected 100 from pot
FDIBA2009: doesn't show hand 
*** SUMMARY ***
Total pot 100 | Rake 0 
Seat 1: s70n3fac3 (button) (small blind) folded before Flop
Seat 2: FDIBA2009 (big blind) collected (100)



PokerStars Home Game Hand #227249632243: {Club #4781089}  Hold'em No Limit (50/100) - 2021/06/01 23:16:12 EET [2021/06/01 16:16:12 ET]
Table 'VTPP NLHE 0106' 2-max (Play Money) Seat #2 is the button
Seat 1: s70n3fac3 (12906 in chips) 
Seat 2: FDIBA2009 (23196 in chips) 
FDIBA2009: posts small blind 50
s70n3fac3: posts big blind 100
*** HOLE CARDS ***
FDIBA2009: raises 100 to 200
s70n3fac3: calls 100
*** FLOP *** [4c Ks Jd]
s70n3fac3: checks 
FDIBA2009: checks 
*** TURN *** [4c Ks Jd] [Th]
s70n3fac3: checks 
FDIBA2009: bets 200
s70n3fac3: folds 
Uncalled bet (200) returned to FDIBA2009
FDIBA2009 collected 378 from pot
FDIBA2009: doesn't show hand 
*** SUMMARY ***
Total pot 400 | Rake 22 
Board [4c Ks Jd Th]
Seat 1: s70n3fac3 (big blind) folded on the Turn
Seat 2: FDIBA2009 (button) (small blind) collected (378)



PokerStars Home Game Hand #227249640395: {Club #4781089}  Hold'em No Limit (50/100) - 2021/06/01 23:16:27 EET [2021/06/01 16:16:27 ET]
Table 'VTPP NLHE 0106' 2-max (Play Money) Seat #1 is the button
Seat 1: s70n3fac3 (12706 in chips) 
Seat 2: FDIBA2009 (23374 in chips) 
s70n3fac3: posts small blind 50
FDIBA2009: posts big blind 100
*** HOLE CARDS ***
s70n3fac3: folds 
Uncalled bet (50) returned to FDIBA2009
FDIBA2009 collected 100 from pot
FDIBA2009: doesn't show hand 
*** SUMMARY ***
Total pot 100 | Rake 0 
Seat 1: s70n3fac3 (button) (small blind) folded before Flop
Seat 2: FDIBA2009 (big blind) collected (100)



PokerStars Home Game Hand #227249642389: {Club #4781089}  Hold'em No Limit (50/100) - 2021/06/01 23:16:31 EET [2021/06/01 16:16:31 ET]
Table 'VTPP NLHE 0106' 2-max (Play Money) Seat #2 is the button
Seat 1: s70n3fac3 (12656 in chips) 
Seat 2: FDIBA2009 (23424 in chips) 
FDIBA2009: posts small blind 50
s70n3fac3: posts big blind 100
*** HOLE CARDS ***
FDIBA2009: raises 100 to 200
s70n3fac3: calls 100
*** FLOP *** [Kd Jh 8h]
s70n3fac3: checks 
FDIBA2009: bets 200
s70n3fac3: folds 
Uncalled bet (200) returned to FDIBA2009
FDIBA2009 collected 378 from pot
FDIBA2009: doesn't show hand 
*** SUMMARY ***
Total pot 400 | Rake 22 
Board [Kd Jh 8h]
Seat 1: s70n3fac3 (big blind) folded on the Flop
Seat 2: FDIBA2009 (button) (small blind) collected (378)



PokerStars Home Game Hand #227249656003: {Club #4781089}  Hold'em No Limit (50/100) - 2021/06/01 23:16:42 EET [2021/06/01 16:16:42 ET]
Table 'VTPP NLHE 0106' 2-max (Play Money) Seat #1 is the button
Seat 1: s70n3fac3 (12456 in chips) 
Seat 2: FDIBA2009 (23602 in chips) 
s70n3fac3: posts small blind 50
FDIBA2009: posts big blind 100
*** HOLE CARDS ***
s70n3fac3: raises 150 to 250
FDIBA2009: calls 150
*** FLOP *** [Td 3h Ks]
FDIBA2009: checks 
s70n3fac3: bets 300
FDIBA2009: folds 
Uncalled bet (300) returned to s70n3fac3
s70n3fac3 collected 472 from pot
s70n3fac3: doesn't show hand 
*** SUMMARY ***
Total pot 500 | Rake 28 
Board [Td 3h Ks]
Seat 1: s70n3fac3 (button) (small blind) collected (472)
Seat 2: FDIBA2009 (big blind) folded on the Flop



PokerStars Home Game Hand #227249661606: {Club #4781089}  Hold'em No Limit (50/100) - 2021/06/01 23:16:52 EET [2021/06/01 16:16:52 ET]
Table 'VTPP NLHE 0106' 2-max (Play Money) Seat #2 is the button
Seat 1: s70n3fac3 (12678 in chips) 
Seat 2: FDIBA2009 (23352 in chips) 
FDIBA2009: posts small blind 50
s70n3fac3: posts big blind 100
*** HOLE CARDS ***
FDIBA2009: raises 100 to 200
s70n3fac3: calls 100
*** FLOP *** [6s Tc 6c]
s70n3fac3: checks 
FDIBA2009: checks 
*** TURN *** [6s Tc 6c] [Th]
s70n3fac3: checks 
FDIBA2009: bets 200
s70n3fac3: folds 
Uncalled bet (200) returned to FDIBA2009
FDIBA2009 collected 378 from pot
FDIBA2009: doesn't show hand 
*** SUMMARY ***
Total pot 400 | Rake 22 
Board [6s Tc 6c Th]
Seat 1: s70n3fac3 (big blind) folded on the Turn
Seat 2: FDIBA2009 (button) (small blind) collected (378)



PokerStars Home Game Hand #227249668937: {Club #4781089}  Hold'em No Limit (50/100) - 2021/06/01 23:17:06 EET [2021/06/01 16:17:06 ET]
Table 'VTPP NLHE 0106' 2-max (Play Money) Seat #1 is the button
Seat 1: s70n3fac3 (12478 in chips) 
Seat 2: FDIBA2009 (23530 in chips) 
s70n3fac3: posts small blind 50
FDIBA2009: posts big blind 100
*** HOLE CARDS ***
s70n3fac3: calls 50
FDIBA2009: raises 100 to 200
s70n3fac3: calls 100
*** FLOP *** [Td 7s Tc]
FDIBA2009: bets 200
s70n3fac3: folds 
Uncalled bet (200) returned to FDIBA2009
FDIBA2009 collected 378 from pot
FDIBA2009: doesn't show hand 
*** SUMMARY ***
Total pot 400 | Rake 22 
Board [Td 7s Tc]
Seat 1: s70n3fac3 (button) (small blind) folded on the Flop
Seat 2: FDIBA2009 (big blind) collected (378)



PokerStars Home Game Hand #227249675087: {Club #4781089}  Hold'em No Limit (50/100) - 2021/06/01 23:17:18 EET [2021/06/01 16:17:18 ET]
Table 'VTPP NLHE 0106' 2-max (Play Money) Seat #2 is the button
Seat 1: s70n3fac3 (12278 in chips) 
Seat 2: FDIBA2009 (23708 in chips) 
FDIBA2009: posts small blind 50
s70n3fac3: posts big blind 100
*** HOLE CARDS ***
FDIBA2009: raises 100 to 200
s70n3fac3: calls 100
*** FLOP *** [3c Jh Kh]
s70n3fac3: checks 
FDIBA2009: bets 200
s70n3fac3: calls 200
*** TURN *** [3c Jh Kh] [4c]
s70n3fac3: checks 
FDIBA2009: checks 
*** RIVER *** [3c Jh Kh 4c] [4d]
s70n3fac3: checks 
FDIBA2009: bets 756
s70n3fac3: folds 
Uncalled bet (756) returned to FDIBA2009
FDIBA2009 collected 756 from pot
FDIBA2009: doesn't show hand 
*** SUMMARY ***
Total pot 800 | Rake 44 
Board [3c Jh Kh 4c 4d]
Seat 1: s70n3fac3 (big blind) folded on the River
Seat 2: FDIBA2009 (button) (small blind) collected (756)



PokerStars Home Game Hand #227249689767: {Club #4781089}  Hold'em No Limit (50/100) - 2021/06/01 23:17:45 EET [2021/06/01 16:17:45 ET]
Table 'VTPP NLHE 0106' 2-max (Play Money) Seat #1 is the button
Seat 1: s70n3fac3 (11878 in chips) 
Seat 2: FDIBA2009 (24064 in chips) 
s70n3fac3: posts small blind 50
FDIBA2009: posts big blind 100
*** HOLE CARDS ***
s70n3fac3: folds 
Uncalled bet (50) returned to FDIBA2009
FDIBA2009 collected 100 from pot
FDIBA2009: doesn't show hand 
*** SUMMARY ***
Total pot 100 | Rake 0 
Seat 1: s70n3fac3 (button) (small blind) folded before Flop
Seat 2: FDIBA2009 (big blind) collected (100)



PokerStars Home Game Hand #227249691746: {Club #4781089}  Hold'em No Limit (50/100) - 2021/06/01 23:17:49 EET [2021/06/01 16:17:49 ET]
Table 'VTPP NLHE 0106' 2-max (Play Money) Seat #2 is the button
Seat 1: s70n3fac3 (11828 in chips) 
Seat 2: FDIBA2009 (24114 in chips) 
FDIBA2009: posts small blind 50
s70n3fac3: posts big blind 100
*** HOLE CARDS ***
FDIBA2009: raises 100 to 200
s70n3fac3: raises 400 to 600
FDIBA2009: calls 400
*** FLOP *** [Jc Ts 2d]
s70n3fac3: checks 
FDIBA2009: checks 
*** TURN *** [Jc Ts 2d] [Qh]
s70n3fac3: checks 
FDIBA2009: bets 600
s70n3fac3: calls 600
*** RIVER *** [Jc Ts 2d Qh] [4d]
s70n3fac3: checks 
FDIBA2009: bets 850
s70n3fac3: folds 
Uncalled bet (850) returned to FDIBA2009
FDIBA2009 collected 2268 from pot
FDIBA2009: doesn't show hand 
*** SUMMARY ***
Total pot 2400 | Rake 132 
Board [Jc Ts 2d Qh 4d]
Seat 1: s70n3fac3 (big blind) folded on the River
Seat 2: FDIBA2009 (button) (small blind) collected (2268)



PokerStars Home Game Hand #227249709493: {Club #4781089}  Hold'em No Limit (50/100) - 2021/06/01 23:18:22 EET [2021/06/01 16:18:22 ET]
Table 'VTPP NLHE 0106' 2-max (Play Money) Seat #1 is the button
Seat 1: s70n3fac3 (10628 in chips) 
Seat 2: FDIBA2009 (25182 in chips) 
s70n3fac3: posts small blind 50
FDIBA2009: posts big blind 100
*** HOLE CARDS ***
s70n3fac3: raises 150 to 250
FDIBA2009: calls 150
*** FLOP *** [8d Kd As]
FDIBA2009: checks 
s70n3fac3: bets 300
FDIBA2009: calls 300
*** TURN *** [8d Kd As] [4s]
FDIBA2009: checks 
s70n3fac3: bets 600
FDIBA2009: calls 600
*** RIVER *** [8d Kd As 4s] [Qh]
FDIBA2009: checks 
s70n3fac3: checks 
*** SHOW DOWN ***
FDIBA2009: shows [6c Ah] (a pair of Aces)
s70n3fac3: mucks hand 
FDIBA2009 collected 2173 from pot
*** SUMMARY ***
Total pot 2300 | Rake 127 
Board [8d Kd As 4s Qh]
Seat 1: s70n3fac3 (button) (small blind) mucked [7s Qc]
Seat 2: FDIBA2009 (big blind) showed [6c Ah] and won (2173) with a pair of Aces



PokerStars Home Game Hand #227249723492: {Club #4781089}  Hold'em No Limit (50/100) - 2021/06/01 23:18:48 EET [2021/06/01 16:18:48 ET]
Table 'VTPP NLHE 0106' 2-max (Play Money) Seat #2 is the button
Seat 1: s70n3fac3 (9478 in chips) 
Seat 2: FDIBA2009 (26205 in chips) 
FDIBA2009: posts small blind 50
s70n3fac3: posts big blind 100
*** HOLE CARDS ***
FDIBA2009: raises 100 to 200
s70n3fac3: calls 100
*** FLOP *** [2d 6c 3c]
s70n3fac3: checks 
FDIBA2009: bets 200
s70n3fac3: calls 200
*** TURN *** [2d 6c 3c] [9h]
s70n3fac3: checks 
FDIBA2009: bets 450
s70n3fac3: folds 
Uncalled bet (450) returned to FDIBA2009
FDIBA2009 collected 756 from pot
FDIBA2009: doesn't show hand 
*** SUMMARY ***
Total pot 800 | Rake 44 
Board [2d 6c 3c 9h]
Seat 1: s70n3fac3 (big blind) folded on the Turn
Seat 2: FDIBA2009 (button) (small blind) collected (756)



PokerStars Home Game Hand #227249734255: {Club #4781089}  Hold'em No Limit (50/100) - 2021/06/01 23:19:08 EET [2021/06/01 16:19:08 ET]
Table 'VTPP NLHE 0106' 2-max (Play Money) Seat #1 is the button
Seat 1: s70n3fac3 (9078 in chips) 
Seat 2: FDIBA2009 (26561 in chips) 
s70n3fac3: posts small blind 50
FDIBA2009: posts big blind 100
*** HOLE CARDS ***
s70n3fac3: folds 
Uncalled bet (50) returned to FDIBA2009
FDIBA2009 collected 100 from pot
FDIBA2009: doesn't show hand 
*** SUMMARY ***
Total pot 100 | Rake 0 
Seat 1: s70n3fac3 (button) (small blind) folded before Flop
Seat 2: FDIBA2009 (big blind) collected (100)



PokerStars Home Game Hand #227249736175: {Club #4781089}  Hold'em No Limit (50/100) - 2021/06/01 23:19:11 EET [2021/06/01 16:19:11 ET]
Table 'VTPP NLHE 0106' 2-max (Play Money) Seat #2 is the button
Seat 1: s70n3fac3 (9028 in chips) 
Seat 2: FDIBA2009 (26611 in chips) 
FDIBA2009: posts small blind 50
s70n3fac3: posts big blind 100
*** HOLE CARDS ***
FDIBA2009: raises 100 to 200
s70n3fac3: calls 100
*** FLOP *** [As Ad 2c]
s70n3fac3: checks 
FDIBA2009: checks 
*** TURN *** [As Ad 2c] [Js]
s70n3fac3: checks 
FDIBA2009: bets 200
s70n3fac3: folds 
Uncalled bet (200) returned to FDIBA2009
FDIBA2009 collected 378 from pot
FDIBA2009: doesn't show hand 
*** SUMMARY ***
Total pot 400 | Rake 22 
Board [As Ad 2c Js]
Seat 1: s70n3fac3 (big blind) folded on the Turn
Seat 2: FDIBA2009 (button) (small blind) collected (378)



PokerStars Home Game Hand #227249743960: {Club #4781089}  Hold'em No Limit (50/100) - 2021/06/01 23:19:26 EET [2021/06/01 16:19:26 ET]
Table 'VTPP NLHE 0106' 2-max (Play Money) Seat #1 is the button
Seat 1: s70n3fac3 (8828 in chips) 
Seat 2: FDIBA2009 (26789 in chips) 
s70n3fac3: posts small blind 50
FDIBA2009: posts big blind 100
*** HOLE CARDS ***
s70n3fac3: raises 200 to 300
FDIBA2009: calls 200
*** FLOP *** [Qc As 8c]
FDIBA2009: checks 
s70n3fac3: bets 400
FDIBA2009: folds 
Uncalled bet (400) returned to s70n3fac3
s70n3fac3 collected 567 from pot
s70n3fac3: doesn't show hand 
*** SUMMARY ***
Total pot 600 | Rake 33 
Board [Qc As 8c]
Seat 1: s70n3fac3 (button) (small blind) collected (567)
Seat 2: FDIBA2009 (big blind) folded on the Flop



PokerStars Home Game Hand #227249749406: {Club #4781089}  Hold'em No Limit (50/100) - 2021/06/01 23:19:36 EET [2021/06/01 16:19:36 ET]
Table 'VTPP NLHE 0106' 2-max (Play Money) Seat #2 is the button
Seat 1: s70n3fac3 (9095 in chips) 
Seat 2: FDIBA2009 (26489 in chips) 
FDIBA2009: posts small blind 50
s70n3fac3: posts big blind 100
*** HOLE CARDS ***
FDIBA2009: raises 100 to 200
s70n3fac3: raises 400 to 600
FDIBA2009: calls 400
*** FLOP *** [4h Js 8c]
s70n3fac3: checks 
FDIBA2009: checks 
*** TURN *** [4h Js 8c] [6s]
s70n3fac3: checks 
FDIBA2009: checks 
*** RIVER *** [4h Js 8c 6s] [Ah]
s70n3fac3: checks 
FDIBA2009: checks 
*** SHOW DOWN ***
s70n3fac3: shows [5c 5s] (a pair of Fives)
FDIBA2009: mucks hand 
s70n3fac3 collected 1134 from pot
*** SUMMARY ***
Total pot 1200 | Rake 66 
Board [4h Js 8c 6s Ah]
Seat 1: s70n3fac3 (big blind) showed [5c 5s] and won (1134) with a pair of Fives
Seat 2: FDIBA2009 (button) (small blind) mucked [Td Kd]



PokerStars Home Game Hand #227249759814: {Club #4781089}  Hold'em No Limit (50/100) - 2021/06/01 23:19:55 EET [2021/06/01 16:19:55 ET]
Table 'VTPP NLHE 0106' 2-max (Play Money) Seat #1 is the button
Seat 1: s70n3fac3 (9629 in chips) 
Seat 2: FDIBA2009 (25889 in chips) 
s70n3fac3: posts small blind 50
FDIBA2009: posts big blind 100
*** HOLE CARDS ***
s70n3fac3: calls 50
FDIBA2009: raises 200 to 300
s70n3fac3: calls 200
*** FLOP *** [9c 6h 2h]
FDIBA2009: bets 350
s70n3fac3: calls 350
*** TURN *** [9c 6h 2h] [9s]
FDIBA2009: checks 
s70n3fac3: checks 
*** RIVER *** [9c 6h 2h 9s] [Qc]
FDIBA2009: checks 
s70n3fac3: checks 
*** SHOW DOWN ***
FDIBA2009: shows [5h Ac] (a pair of Nines)
s70n3fac3: mucks hand 
FDIBA2009 collected 1228 from pot
*** SUMMARY ***
Total pot 1300 | Rake 72 
Board [9c 6h 2h 9s Qc]
Seat 1: s70n3fac3 (button) (small blind) mucked [8h 7s]
Seat 2: FDIBA2009 (big blind) showed [5h Ac] and won (1228) with a pair of Nines



PokerStars Home Game Hand #227249775307: {Club #4781089}  Hold'em No Limit (50/100) - 2021/06/01 23:20:24 EET [2021/06/01 16:20:24 ET]
Table 'VTPP NLHE 0106' 2-max (Play Money) Seat #2 is the button
Seat 1: s70n3fac3 (8979 in chips) 
Seat 2: FDIBA2009 (26467 in chips) 
FDIBA2009: posts small blind 50
s70n3fac3: posts big blind 100
*** HOLE CARDS ***
FDIBA2009: raises 100 to 200
s70n3fac3: calls 100
*** FLOP *** [8c Jc 9h]
s70n3fac3: checks 
FDIBA2009: checks 
*** TURN *** [8c Jc 9h] [As]
s70n3fac3: checks 
FDIBA2009: checks 
*** RIVER *** [8c Jc 9h As] [Qs]
s70n3fac3: checks 
FDIBA2009: bets 378
s70n3fac3: folds 
Uncalled bet (378) returned to FDIBA2009
FDIBA2009 collected 378 from pot
FDIBA2009: doesn't show hand 
*** SUMMARY ***
Total pot 400 | Rake 22 
Board [8c Jc 9h As Qs]
Seat 1: s70n3fac3 (big blind) folded on the River
Seat 2: FDIBA2009 (button) (small blind) collected (378)



PokerStars Home Game Hand #227249786509: {Club #4781089}  Hold'em No Limit (50/100) - 2021/06/01 23:20:45 EET [2021/06/01 16:20:45 ET]
Table 'VTPP NLHE 0106' 2-max (Play Money) Seat #1 is the button
Seat 1: s70n3fac3 (8779 in chips) 
Seat 2: FDIBA2009 (26645 in chips) 
s70n3fac3: posts small blind 50
FDIBA2009: posts big blind 100
*** HOLE CARDS ***
s70n3fac3: folds 
Uncalled bet (50) returned to FDIBA2009
FDIBA2009 collected 100 from pot
FDIBA2009: doesn't show hand 
*** SUMMARY ***
Total pot 100 | Rake 0 
Seat 1: s70n3fac3 (button) (small blind) folded before Flop
Seat 2: FDIBA2009 (big blind) collected (100)



PokerStars Home Game Hand #227249788545: {Club #4781089}  Hold'em No Limit (50/100) - 2021/06/01 23:20:49 EET [2021/06/01 16:20:49 ET]
Table 'VTPP NLHE 0106' 2-max (Play Money) Seat #2 is the button
Seat 1: s70n3fac3 (8729 in chips) 
Seat 2: FDIBA2009 (26695 in chips) 
FDIBA2009: posts small blind 50
s70n3fac3: posts big blind 100
*** HOLE CARDS ***
FDIBA2009: raises 100 to 200
s70n3fac3: calls 100
*** FLOP *** [2c 4h Kc]
s70n3fac3: checks 
FDIBA2009: checks 
*** TURN *** [2c 4h Kc] [7d]
s70n3fac3: bets 300
FDIBA2009: calls 300
*** RIVER *** [2c 4h Kc 7d] [5c]
s70n3fac3: bets 500
FDIBA2009: folds 
Uncalled bet (500) returned to s70n3fac3
s70n3fac3 collected 945 from pot
s70n3fac3: doesn't show hand 
*** SUMMARY ***
Total pot 1000 | Rake 55 
Board [2c 4h Kc 7d 5c]
Seat 1: s70n3fac3 (big blind) collected (945)
Seat 2: FDIBA2009 (button) (small blind) folded on the River



PokerStars Home Game Hand #227249799935: {Club #4781089}  Hold'em No Limit (50/100) - 2021/06/01 23:21:10 EET [2021/06/01 16:21:10 ET]
Table 'VTPP NLHE 0106' 2-max (Play Money) Seat #1 is the button
Seat 1: s70n3fac3 (9174 in chips) 
Seat 2: FDIBA2009 (26195 in chips) 
s70n3fac3: posts small blind 50
FDIBA2009: posts big blind 100
*** HOLE CARDS ***
s70n3fac3: calls 50
FDIBA2009: raises 100 to 200
s70n3fac3: calls 100
*** FLOP *** [6s 2d Ts]
FDIBA2009: bets 200
s70n3fac3: raises 400 to 600
FDIBA2009: folds 
Uncalled bet (400) returned to s70n3fac3
s70n3fac3 collected 756 from pot
s70n3fac3: doesn't show hand 
*** SUMMARY ***
Total pot 800 | Rake 44 
Board [6s 2d Ts]
Seat 1: s70n3fac3 (button) (small blind) collected (756)
Seat 2: FDIBA2009 (big blind) folded on the Flop



PokerStars Home Game Hand #227249808719: {Club #4781089}  Hold'em No Limit (50/100) - 2021/06/01 23:21:26 EET [2021/06/01 16:21:26 ET]
Table 'VTPP NLHE 0106' 2-max (Play Money) Seat #2 is the button
Seat 1: s70n3fac3 (9530 in chips) 
Seat 2: FDIBA2009 (25795 in chips) 
FDIBA2009: posts small blind 50
s70n3fac3: posts big blind 100
*** HOLE CARDS ***
FDIBA2009: raises 100 to 200
s70n3fac3: folds 
Uncalled bet (100) returned to FDIBA2009
FDIBA2009 collected 200 from pot
FDIBA2009: doesn't show hand 
*** SUMMARY ***
Total pot 200 | Rake 0 
Seat 1: s70n3fac3 (big blind) folded before Flop
Seat 2: FDIBA2009 (button) (small blind) collected (200)



PokerStars Home Game Hand #227249811852: {Club #4781089}  Hold'em No Limit (50/100) - 2021/06/01 23:21:32 EET [2021/06/01 16:21:32 ET]
Table 'VTPP NLHE 0106' 2-max (Play Money) Seat #1 is the button
Seat 1: s70n3fac3 (9430 in chips) 
Seat 2: FDIBA2009 (25895 in chips) 
s70n3fac3: posts small blind 50
FDIBA2009: posts big blind 100
*** HOLE CARDS ***
s70n3fac3: calls 50
FDIBA2009: raises 100 to 200
s70n3fac3: calls 100
*** FLOP *** [5h Ah Kh]
FDIBA2009: checks 
s70n3fac3: checks 
*** TURN *** [5h Ah Kh] [4h]
FDIBA2009: bets 200
s70n3fac3: calls 200
*** RIVER *** [5h Ah Kh 4h] [6h]
FDIBA2009: bets 900
s70n3fac3: folds 
Uncalled bet (900) returned to FDIBA2009
FDIBA2009 collected 756 from pot
FDIBA2009: doesn't show hand 
*** SUMMARY ***
Total pot 800 | Rake 44 
Board [5h Ah Kh 4h 6h]
Seat 1: s70n3fac3 (button) (small blind) folded on the River
Seat 2: FDIBA2009 (big blind) collected (756)



PokerStars Home Game Hand #227249827763: {Club #4781089}  Hold'em No Limit (50/100) - 2021/06/01 23:22:02 EET [2021/06/01 16:22:02 ET]
Table 'VTPP NLHE 0106' 2-max (Play Money) Seat #2 is the button
Seat 1: s70n3fac3 (9030 in chips) 
Seat 2: FDIBA2009 (26251 in chips) 
FDIBA2009: posts small blind 50
s70n3fac3: posts big blind 100
*** HOLE CARDS ***
FDIBA2009: raises 100 to 200
s70n3fac3: calls 100
*** FLOP *** [Jh 8c 2h]
s70n3fac3: checks 
FDIBA2009: bets 200
s70n3fac3: calls 200
*** TURN *** [Jh 8c 2h] [Ad]
s70n3fac3: checks 
FDIBA2009: checks 
*** RIVER *** [Jh 8c 2h Ad] [Td]
s70n3fac3: checks 
FDIBA2009: checks 
*** SHOW DOWN ***
s70n3fac3: shows [4c Qc] (high card Ace)
FDIBA2009: shows [2c 3d] (a pair of Deuces)
FDIBA2009 collected 756 from pot
*** SUMMARY ***
Total pot 800 | Rake 44 
Board [Jh 8c 2h Ad Td]
Seat 1: s70n3fac3 (big blind) showed [4c Qc] and lost with high card Ace
Seat 2: FDIBA2009 (button) (small blind) showed [2c 3d] and won (756) with a pair of Deuces



PokerStars Home Game Hand #227249836201: {Club #4781089}  Hold'em No Limit (50/100) - 2021/06/01 23:22:18 EET [2021/06/01 16:22:18 ET]
Table 'VTPP NLHE 0106' 2-max (Play Money) Seat #1 is the button
Seat 1: s70n3fac3 (8630 in chips) 
Seat 2: FDIBA2009 (26607 in chips) 
s70n3fac3: posts small blind 50
FDIBA2009: posts big blind 100
*** HOLE CARDS ***
s70n3fac3: folds 
Uncalled bet (50) returned to FDIBA2009
FDIBA2009 collected 100 from pot
FDIBA2009: doesn't show hand 
*** SUMMARY ***
Total pot 100 | Rake 0 
Seat 1: s70n3fac3 (button) (small blind) folded before Flop
Seat 2: FDIBA2009 (big blind) collected (100)



PokerStars Home Game Hand #227249840503: {Club #4781089}  Hold'em No Limit (50/100) - 2021/06/01 23:22:22 EET [2021/06/01 16:22:22 ET]
Table 'VTPP NLHE 0106' 2-max (Play Money) Seat #2 is the button
Seat 1: s70n3fac3 (8580 in chips) 
Seat 2: FDIBA2009 (26657 in chips) 
FDIBA2009: posts small blind 50
s70n3fac3: posts big blind 100
*** HOLE CARDS ***
FDIBA2009: raises 100 to 200
s70n3fac3: folds 
Uncalled bet (100) returned to FDIBA2009
FDIBA2009 collected 200 from pot
FDIBA2009: doesn't show hand 
*** SUMMARY ***
Total pot 200 | Rake 0 
Seat 1: s70n3fac3 (big blind) folded before Flop
Seat 2: FDIBA2009 (button) (small blind) collected (200)



PokerStars Home Game Hand #227249843808: {Club #4781089}  Hold'em No Limit (50/100) - 2021/06/01 23:22:28 EET [2021/06/01 16:22:28 ET]
Table 'VTPP NLHE 0106' 2-max (Play Money) Seat #1 is the button
Seat 1: s70n3fac3 (8480 in chips) 
Seat 2: FDIBA2009 (26757 in chips) 
s70n3fac3: posts small blind 50
FDIBA2009: posts big blind 100
*** HOLE CARDS ***
s70n3fac3: raises 200 to 300
FDIBA2009: calls 200
*** FLOP *** [3c Jc Ts]
FDIBA2009: checks 
s70n3fac3: checks 
*** TURN *** [3c Jc Ts] [9d]
FDIBA2009: checks 
s70n3fac3: bets 400
FDIBA2009: calls 400
*** RIVER *** [3c Jc Ts 9d] [4c]
FDIBA2009: checks 
s70n3fac3: checks 
*** SHOW DOWN ***
FDIBA2009: shows [5c 3s] (a pair of Threes)
s70n3fac3: shows [7d 4h] (a pair of Fours)
s70n3fac3 collected 1323 from pot
*** SUMMARY ***
Total pot 1400 | Rake 77 
Board [3c Jc Ts 9d 4c]
Seat 1: s70n3fac3 (button) (small blind) showed [7d 4h] and won (1323) with a pair of Fours
Seat 2: FDIBA2009 (big blind) showed [5c 3s] and lost with a pair of Threes



PokerStars Home Game Hand #227249853480: {Club #4781089}  Hold'em No Limit (50/100) - 2021/06/01 23:22:46 EET [2021/06/01 16:22:46 ET]
Table 'VTPP NLHE 0106' 2-max (Play Money) Seat #2 is the button
Seat 1: s70n3fac3 (9103 in chips) 
Seat 2: FDIBA2009 (26057 in chips) 
FDIBA2009: posts small blind 50
s70n3fac3: posts big blind 100
*** HOLE CARDS ***
FDIBA2009: raises 100 to 200
s70n3fac3: folds 
Uncalled bet (100) returned to FDIBA2009
FDIBA2009 collected 200 from pot
FDIBA2009: doesn't show hand 
*** SUMMARY ***
Total pot 200 | Rake 0 
Seat 1: s70n3fac3 (big blind) folded before Flop
Seat 2: FDIBA2009 (button) (small blind) collected (200)



PokerStars Home Game Hand #227249859620: {Club #4781089}  Hold'em No Limit (50/100) - 2021/06/01 23:22:57 EET [2021/06/01 16:22:57 ET]
Table 'VTPP NLHE 0106' 2-max (Play Money) Seat #1 is the button
Seat 1: s70n3fac3 (9003 in chips) 
Seat 2: FDIBA2009 (26157 in chips) 
s70n3fac3: posts small blind 50
FDIBA2009: posts big blind 100
*** HOLE CARDS ***
s70n3fac3: calls 50
FDIBA2009: raises 200 to 300
s70n3fac3: calls 200
*** FLOP *** [Ad 7c 4s]
FDIBA2009: checks 
s70n3fac3: checks 
*** TURN *** [Ad 7c 4s] [Tc]
FDIBA2009: bets 300
s70n3fac3: folds 
Uncalled bet (300) returned to FDIBA2009
FDIBA2009 collected 567 from pot
FDIBA2009: doesn't show hand 
*** SUMMARY ***
Total pot 600 | Rake 33 
Board [Ad 7c 4s Tc]
Seat 1: s70n3fac3 (button) (small blind) folded on the Turn
Seat 2: FDIBA2009 (big blind) collected (567)



PokerStars Home Game Hand #227249868294: {Club #4781089}  Hold'em No Limit (50/100) - 2021/06/01 23:23:14 EET [2021/06/01 16:23:14 ET]
Table 'VTPP NLHE 0106' 2-max (Play Money) Seat #2 is the button
Seat 1: s70n3fac3 (8703 in chips) 
Seat 2: FDIBA2009 (26424 in chips) 
FDIBA2009: posts small blind 50
s70n3fac3: posts big blind 100
*** HOLE CARDS ***
FDIBA2009: raises 100 to 200
s70n3fac3: calls 100
*** FLOP *** [5c Jc 8s]
s70n3fac3: checks 
FDIBA2009: checks 
*** TURN *** [5c Jc 8s] [8d]
s70n3fac3: checks 
FDIBA2009: bets 200
s70n3fac3: calls 200
*** RIVER *** [5c Jc 8s 8d] [3h]
s70n3fac3: checks 
FDIBA2009: checks 
*** SHOW DOWN ***
s70n3fac3: shows [Js Td] (two pair, Jacks and Eights)
FDIBA2009: mucks hand 
s70n3fac3 collected 756 from pot
*** SUMMARY ***
Total pot 800 | Rake 44 
Board [5c Jc 8s 8d 3h]
Seat 1: s70n3fac3 (big blind) showed [Js Td] and won (756) with two pair, Jacks and Eights
Seat 2: FDIBA2009 (button) (small blind) mucked [Ad 6h]



PokerStars Home Game Hand #227249877337: {Club #4781089}  Hold'em No Limit (50/100) - 2021/06/01 23:23:31 EET [2021/06/01 16:23:31 ET]
Table 'VTPP NLHE 0106' 2-max (Play Money) Seat #1 is the button
Seat 1: s70n3fac3 (9059 in chips) 
Seat 2: FDIBA2009 (26024 in chips) 
s70n3fac3: posts small blind 50
FDIBA2009: posts big blind 100
*** HOLE CARDS ***
s70n3fac3: raises 150 to 250
FDIBA2009: raises 150 to 400
s70n3fac3: calls 150
*** FLOP *** [3d 8s Kd]
FDIBA2009: checks 
s70n3fac3: checks 
*** TURN *** [3d 8s Kd] [2c]
FDIBA2009: checks 
s70n3fac3: checks 
*** RIVER *** [3d 8s Kd 2c] [5d]
FDIBA2009: bets 756
s70n3fac3: folds 
Uncalled bet (756) returned to FDIBA2009
FDIBA2009 collected 756 from pot
FDIBA2009: doesn't show hand 
*** SUMMARY ***
Total pot 800 | Rake 44 
Board [3d 8s Kd 2c 5d]
Seat 1: s70n3fac3 (button) (small blind) folded on the River
Seat 2: FDIBA2009 (big blind) collected (756)



PokerStars Home Game Hand #227249889628: {Club #4781089}  Hold'em No Limit (50/100) - 2021/06/01 23:23:54 EET [2021/06/01 16:23:54 ET]
Table 'VTPP NLHE 0106' 2-max (Play Money) Seat #2 is the button
Seat 1: s70n3fac3 (8659 in chips) 
Seat 2: FDIBA2009 (26380 in chips) 
FDIBA2009: posts small blind 50
s70n3fac3: posts big blind 100
*** HOLE CARDS ***
FDIBA2009: raises 100 to 200
s70n3fac3: raises 400 to 600
FDIBA2009: calls 400
*** FLOP *** [2c 7c 7s]
s70n3fac3: bets 600
FDIBA2009: folds 
Uncalled bet (600) returned to s70n3fac3
s70n3fac3 collected 1134 from pot
s70n3fac3: doesn't show hand 
*** SUMMARY ***
Total pot 1200 | Rake 66 
Board [2c 7c 7s]
Seat 1: s70n3fac3 (big blind) collected (1134)
Seat 2: FDIBA2009 (button) (small blind) folded on the Flop



PokerStars Home Game Hand #227249897670: {Club #4781089}  Hold'em No Limit (50/100) - 2021/06/01 23:24:09 EET [2021/06/01 16:24:09 ET]
Table 'VTPP NLHE 0106' 2-max (Play Money) Seat #1 is the button
Seat 1: s70n3fac3 (9193 in chips) 
Seat 2: FDIBA2009 (25780 in chips) 
s70n3fac3: posts small blind 50
FDIBA2009: posts big blind 100
*** HOLE CARDS ***
s70n3fac3: folds 
Uncalled bet (50) returned to FDIBA2009
FDIBA2009 collected 100 from pot
FDIBA2009: doesn't show hand 
*** SUMMARY ***
Total pot 100 | Rake 0 
Seat 1: s70n3fac3 (button) (small blind) folded before Flop
Seat 2: FDIBA2009 (big blind) collected (100)



PokerStars Home Game Hand #227249899733: {Club #4781089}  Hold'em No Limit (50/100) - 2021/06/01 23:24:13 EET [2021/06/01 16:24:13 ET]
Table 'VTPP NLHE 0106' 2-max (Play Money) Seat #2 is the button
Seat 1: s70n3fac3 (9143 in chips) 
Seat 2: FDIBA2009 (25830 in chips) 
FDIBA2009: posts small blind 50
s70n3fac3: posts big blind 100
*** HOLE CARDS ***
FDIBA2009: raises 100 to 200
s70n3fac3: calls 100
*** FLOP *** [Tc 8c 3h]
s70n3fac3: checks 
FDIBA2009: bets 250
s70n3fac3: folds 
Uncalled bet (250) returned to FDIBA2009
FDIBA2009 collected 378 from pot
FDIBA2009: doesn't show hand 
*** SUMMARY ***
Total pot 400 | Rake 22 
Board [Tc 8c 3h]
Seat 1: s70n3fac3 (big blind) folded on the Flop
Seat 2: FDIBA2009 (button) (small blind) collected (378)



PokerStars Home Game Hand #227249905503: {Club #4781089}  Hold'em No Limit (50/100) - 2021/06/01 23:24:24 EET [2021/06/01 16:24:24 ET]
Table 'VTPP NLHE 0106' 2-max (Play Money) Seat #1 is the button
Seat 1: s70n3fac3 (8943 in chips) 
Seat 2: FDIBA2009 (26008 in chips) 
s70n3fac3: posts small blind 50
FDIBA2009: posts big blind 100
*** HOLE CARDS ***
s70n3fac3: raises 200 to 300
FDIBA2009: raises 650 to 950
s70n3fac3: folds 
Uncalled bet (650) returned to FDIBA2009
FDIBA2009 collected 600 from pot
FDIBA2009: doesn't show hand 
*** SUMMARY ***
Total pot 600 | Rake 0 
Seat 1: s70n3fac3 (button) (small blind) folded before Flop
Seat 2: FDIBA2009 (big blind) collected (600)



PokerStars Home Game Hand #227249913178: {Club #4781089}  Hold'em No Limit (50/100) - 2021/06/01 23:24:38 EET [2021/06/01 16:24:38 ET]
Table 'VTPP NLHE 0106' 2-max (Play Money) Seat #2 is the button
Seat 1: s70n3fac3 (8643 in chips) 
Seat 2: FDIBA2009 (26308 in chips) 
FDIBA2009: posts small blind 50
s70n3fac3: posts big blind 100
*** HOLE CARDS ***
FDIBA2009: raises 150 to 250
s70n3fac3: calls 150
*** FLOP *** [8h 3d Tc]
s70n3fac3: checks 
FDIBA2009: bets 300
s70n3fac3: calls 300
*** TURN *** [8h 3d Tc] [4c]
s70n3fac3: checks 
FDIBA2009: checks 
*** RIVER *** [8h 3d Tc 4c] [Ad]
s70n3fac3: checks 
FDIBA2009: bets 1050
s70n3fac3: folds 
Uncalled bet (1050) returned to FDIBA2009
FDIBA2009 collected 1039 from pot
FDIBA2009: doesn't show hand 
*** SUMMARY ***
Total pot 1100 | Rake 61 
Board [8h 3d Tc 4c Ad]
Seat 1: s70n3fac3 (big blind) folded on the River
Seat 2: FDIBA2009 (button) (small blind) collected (1039)



PokerStars Home Game Hand #227249934579: {Club #4781089}  Hold'em No Limit (50/100) - 2021/06/01 23:25:19 EET [2021/06/01 16:25:19 ET]
Table 'VTPP NLHE 0106' 2-max (Play Money) Seat #1 is the button
Seat 1: s70n3fac3 (8093 in chips) 
Seat 2: FDIBA2009 (26797 in chips) 
s70n3fac3: posts small blind 50
FDIBA2009: posts big blind 100
*** HOLE CARDS ***
s70n3fac3: calls 50
FDIBA2009: checks 
*** FLOP *** [Js As 8c]
FDIBA2009: checks 
s70n3fac3: checks 
*** TURN *** [Js As 8c] [Ts]
FDIBA2009: checks 
s70n3fac3: checks 
*** RIVER *** [Js As 8c Ts] [2d]
FDIBA2009: checks 
s70n3fac3: checks 
*** SHOW DOWN ***
FDIBA2009: shows [8d 9h] (a pair of Eights)
s70n3fac3: mucks hand 
FDIBA2009 collected 189 from pot
*** SUMMARY ***
Total pot 200 | Rake 11 
Board [Js As 8c Ts 2d]
Seat 1: s70n3fac3 (button) (small blind) mucked [7d Kd]
Seat 2: FDIBA2009 (big blind) showed [8d 9h] and won (189) with a pair of Eights



PokerStars Home Game Hand #227249942500: {Club #4781089}  Hold'em No Limit (50/100) - 2021/06/01 23:25:34 EET [2021/06/01 16:25:34 ET]
Table 'VTPP NLHE 0106' 2-max (Play Money) Seat #2 is the button
Seat 1: s70n3fac3 (7993 in chips) 
Seat 2: FDIBA2009 (26886 in chips) 
FDIBA2009: posts small blind 50
s70n3fac3: posts big blind 100
*** HOLE CARDS ***
FDIBA2009: raises 100 to 200
s70n3fac3: folds 
Uncalled bet (100) returned to FDIBA2009
FDIBA2009 collected 200 from pot
FDIBA2009: doesn't show hand 
*** SUMMARY ***
Total pot 200 | Rake 0 
Seat 1: s70n3fac3 (big blind) folded before Flop
Seat 2: FDIBA2009 (button) (small blind) collected (200)



PokerStars Home Game Hand #227249945560: {Club #4781089}  Hold'em No Limit (50/100) - 2021/06/01 23:25:40 EET [2021/06/01 16:25:40 ET]
Table 'VTPP NLHE 0106' 2-max (Play Money) Seat #1 is the button
Seat 1: s70n3fac3 (7893 in chips) 
Seat 2: FDIBA2009 (26986 in chips) 
s70n3fac3: posts small blind 50
FDIBA2009: posts big blind 100
*** HOLE CARDS ***
s70n3fac3: calls 50
FDIBA2009: checks 
*** FLOP *** [Tc Js Jc]
FDIBA2009: checks 
s70n3fac3: checks 
*** TURN *** [Tc Js Jc] [Jh]
FDIBA2009: bets 100
s70n3fac3: folds 
Uncalled bet (100) returned to FDIBA2009
FDIBA2009 collected 189 from pot
FDIBA2009: doesn't show hand 
*** SUMMARY ***
Total pot 200 | Rake 11 
Board [Tc Js Jc Jh]
Seat 1: s70n3fac3 (button) (small blind) folded on the Turn
Seat 2: FDIBA2009 (big blind) collected (189)



PokerStars Home Game Hand #227249952034: {Club #4781089}  Hold'em No Limit (50/100) - 2021/06/01 23:25:52 EET [2021/06/01 16:25:52 ET]
Table 'VTPP NLHE 0106' 2-max (Play Money) Seat #2 is the button
Seat 1: s70n3fac3 (7793 in chips) 
Seat 2: FDIBA2009 (27075 in chips) 
FDIBA2009: posts small blind 50
s70n3fac3: posts big blind 100
*** HOLE CARDS ***
FDIBA2009: raises 100 to 200
s70n3fac3: calls 100
*** FLOP *** [8s Ts 5h]
s70n3fac3: checks 
FDIBA2009: checks 
*** TURN *** [8s Ts 5h] [8h]
s70n3fac3: checks 
FDIBA2009: bets 100
s70n3fac3: calls 100
*** RIVER *** [8s Ts 5h 8h] [5s]
s70n3fac3: checks 
FDIBA2009: checks 
*** SHOW DOWN ***
s70n3fac3: shows [2s Kh] (two pair, Eights and Fives)
FDIBA2009: shows [4h Ks] (two pair, Eights and Fives)
s70n3fac3 collected 284 from pot
FDIBA2009 collected 283 from pot
*** SUMMARY ***
Total pot 600 | Rake 33 
Board [8s Ts 5h 8h 5s]
Seat 1: s70n3fac3 (big blind) showed [2s Kh] and won (284) with two pair, Eights and Fives
Seat 2: FDIBA2009 (button) (small blind) showed [4h Ks] and won (283) with two pair, Eights and Fives



PokerStars Home Game Hand #227249959807: {Club #4781089}  Hold'em No Limit (50/100) - 2021/06/01 23:26:07 EET [2021/06/01 16:26:07 ET]
Table 'VTPP NLHE 0106' 2-max (Play Money) Seat #1 is the button
Seat 1: s70n3fac3 (7777 in chips) 
Seat 2: FDIBA2009 (27058 in chips) 
s70n3fac3: posts small blind 50
FDIBA2009: posts big blind 100
*** HOLE CARDS ***
s70n3fac3: raises 100 to 200
FDIBA2009: folds 
Uncalled bet (100) returned to s70n3fac3
s70n3fac3 collected 200 from pot
s70n3fac3: doesn't show hand 
*** SUMMARY ***
Total pot 200 | Rake 0 
Seat 1: s70n3fac3 (button) (small blind) collected (200)
Seat 2: FDIBA2009 (big blind) folded before Flop



PokerStars Home Game Hand #227249962841: {Club #4781089}  Hold'em No Limit (50/100) - 2021/06/01 23:26:12 EET [2021/06/01 16:26:12 ET]
Table 'VTPP NLHE 0106' 2-max (Play Money) Seat #2 is the button
Seat 1: s70n3fac3 (7877 in chips) 
Seat 2: FDIBA2009 (26958 in chips) 
FDIBA2009: posts small blind 50
s70n3fac3: posts big blind 100
*** HOLE CARDS ***
FDIBA2009: raises 100 to 200
s70n3fac3: calls 100
*** FLOP *** [7c 7d 9h]
s70n3fac3: checks 
FDIBA2009: checks 
*** TURN *** [7c 7d 9h] [8d]
s70n3fac3: bets 200
FDIBA2009: folds 
Uncalled bet (200) returned to s70n3fac3
s70n3fac3 collected 378 from pot
s70n3fac3: doesn't show hand 
*** SUMMARY ***
Total pot 400 | Rake 22 
Board [7c 7d 9h 8d]
Seat 1: s70n3fac3 (big blind) collected (378)
Seat 2: FDIBA2009 (button) (small blind) folded on the Turn



PokerStars Home Game Hand #227249970979: {Club #4781089}  Hold'em No Limit (50/100) - 2021/06/01 23:26:28 EET [2021/06/01 16:26:28 ET]
Table 'VTPP NLHE 0106' 2-max (Play Money) Seat #1 is the button
Seat 1: s70n3fac3 (8055 in chips) 
Seat 2: FDIBA2009 (26758 in chips) 
s70n3fac3: posts small blind 50
FDIBA2009: posts big blind 100
*** HOLE CARDS ***
s70n3fac3: raises 200 to 300
FDIBA2009: raises 600 to 900
s70n3fac3: calls 600
*** FLOP *** [8s Kd 9c]
FDIBA2009: checks 
s70n3fac3: checks 
*** TURN *** [8s Kd 9c] [3h]
FDIBA2009: checks 
s70n3fac3: checks 
*** RIVER *** [8s Kd 9c 3h] [Jd]
FDIBA2009: bets 1701
s70n3fac3: folds 
Uncalled bet (1701) returned to FDIBA2009
FDIBA2009 collected 1701 from pot
FDIBA2009: doesn't show hand 
*** SUMMARY ***
Total pot 1800 | Rake 99 
Board [8s Kd 9c 3h Jd]
Seat 1: s70n3fac3 (button) (small blind) folded on the River
Seat 2: FDIBA2009 (big blind) collected (1701)



PokerStars Home Game Hand #227249993631: {Club #4781089}  Hold'em No Limit (50/100) - 2021/06/01 23:27:04 EET [2021/06/01 16:27:04 ET]
Table 'VTPP NLHE 0106' 2-max (Play Money) Seat #2 is the button
Seat 1: s70n3fac3 (7155 in chips) 
Seat 2: FDIBA2009 (27559 in chips) 
FDIBA2009: posts small blind 50
s70n3fac3: posts big blind 100
*** HOLE CARDS ***
FDIBA2009: raises 100 to 200
s70n3fac3: raises 400 to 600
FDIBA2009: calls 400
*** FLOP *** [3s 5s 9s]
s70n3fac3: bets 600
FDIBA2009: calls 600
*** TURN *** [3s 5s 9s] [2c]
s70n3fac3: bets 1200
FDIBA2009: calls 1200
*** RIVER *** [3s 5s 9s 2c] [7h]
s70n3fac3: bets 4755 and is all-in
FDIBA2009: folds 
Uncalled bet (4755) returned to s70n3fac3
s70n3fac3 collected 4536 from pot
s70n3fac3: doesn't show hand 
*** SUMMARY ***
Total pot 4800 | Rake 264 
Board [3s 5s 9s 2c 7h]
Seat 1: s70n3fac3 (big blind) collected (4536)
Seat 2: FDIBA2009 (button) (small blind) folded on the River



PokerStars Home Game Hand #227250014479: {Club #4781089}  Hold'em No Limit (50/100) - 2021/06/01 23:27:43 EET [2021/06/01 16:27:43 ET]
Table 'VTPP NLHE 0106' 2-max (Play Money) Seat #1 is the button
Seat 1: s70n3fac3 (9291 in chips) 
Seat 2: FDIBA2009 (25159 in chips) 
s70n3fac3: posts small blind 50
FDIBA2009: posts big blind 100
*** HOLE CARDS ***
s70n3fac3: calls 50
FDIBA2009: raises 100 to 200
s70n3fac3: calls 100
*** FLOP *** [3c Qs 6h]
FDIBA2009: checks 
s70n3fac3: checks 
*** TURN *** [3c Qs 6h] [As]
FDIBA2009: bets 378
s70n3fac3: folds 
Uncalled bet (378) returned to FDIBA2009
FDIBA2009 collected 378 from pot
FDIBA2009: doesn't show hand 
*** SUMMARY ***
Total pot 400 | Rake 22 
Board [3c Qs 6h As]
Seat 1: s70n3fac3 (button) (small blind) folded on the Turn
Seat 2: FDIBA2009 (big blind) collected (378)



PokerStars Home Game Hand #227250022553: {Club #4781089}  Hold'em No Limit (50/100) - 2021/06/01 23:27:59 EET [2021/06/01 16:27:59 ET]
Table 'VTPP NLHE 0106' 2-max (Play Money) Seat #2 is the button
Seat 1: s70n3fac3 (9091 in chips) 
Seat 2: FDIBA2009 (25337 in chips) 
FDIBA2009: posts small blind 50
s70n3fac3: posts big blind 100
*** HOLE CARDS ***
FDIBA2009: raises 100 to 200
s70n3fac3: folds 
Uncalled bet (100) returned to FDIBA2009
FDIBA2009 collected 200 from pot
FDIBA2009: doesn't show hand 
*** SUMMARY ***
Total pot 200 | Rake 0 
Seat 1: s70n3fac3 (big blind) folded before Flop
Seat 2: FDIBA2009 (button) (small blind) collected (200)



PokerStars Home Game Hand #227250025998: {Club #4781089}  Hold'em No Limit (50/100) - 2021/06/01 23:28:05 EET [2021/06/01 16:28:05 ET]
Table 'VTPP NLHE 0106' 2-max (Play Money) Seat #1 is the button
Seat 1: s70n3fac3 (8991 in chips) 
Seat 2: FDIBA2009 (25437 in chips) 
s70n3fac3: posts small blind 50
FDIBA2009: posts big blind 100
*** HOLE CARDS ***
s70n3fac3: raises 150 to 250
FDIBA2009: raises 500 to 750
s70n3fac3: calls 500
*** FLOP *** [6c Ac Th]
FDIBA2009: bets 750
s70n3fac3: folds 
Uncalled bet (750) returned to FDIBA2009
FDIBA2009 collected 1417 from pot
FDIBA2009: doesn't show hand 
*** SUMMARY ***
Total pot 1500 | Rake 83 
Board [6c Ac Th]
Seat 1: s70n3fac3 (button) (small blind) folded on the Flop
Seat 2: FDIBA2009 (big blind) collected (1417)



PokerStars Home Game Hand #227250033719: {Club #4781089}  Hold'em No Limit (50/100) - 2021/06/01 23:28:20 EET [2021/06/01 16:28:20 ET]
Table 'VTPP NLHE 0106' 2-max (Play Money) Seat #2 is the button
Seat 1: s70n3fac3 (8241 in chips) 
Seat 2: FDIBA2009 (26104 in chips) 
FDIBA2009: posts small blind 50
s70n3fac3: posts big blind 100
*** HOLE CARDS ***
FDIBA2009: raises 100 to 200
s70n3fac3: calls 100
*** FLOP *** [6c 9d 2s]
s70n3fac3: checks 
FDIBA2009: checks 
*** TURN *** [6c 9d 2s] [4s]
s70n3fac3: bets 200
FDIBA2009: calls 200
*** RIVER *** [6c 9d 2s 4s] [5h]
s70n3fac3: checks 
FDIBA2009: checks 
*** SHOW DOWN ***
s70n3fac3: shows [Kh 2d] (a pair of Deuces)
FDIBA2009: shows [Kc 4h] (a pair of Fours)
FDIBA2009 collected 756 from pot
*** SUMMARY ***
Total pot 800 | Rake 44 
Board [6c 9d 2s 4s 5h]
Seat 1: s70n3fac3 (big blind) showed [Kh 2d] and lost with a pair of Deuces
Seat 2: FDIBA2009 (button) (small blind) showed [Kc 4h] and won (756) with a pair of Fours



PokerStars Home Game Hand #227250043485: {Club #4781089}  Hold'em No Limit (50/100) - 2021/06/01 23:28:38 EET [2021/06/01 16:28:38 ET]
Table 'VTPP NLHE 0106' 2-max (Play Money) Seat #1 is the button
Seat 1: s70n3fac3 (7841 in chips) 
Seat 2: FDIBA2009 (26460 in chips) 
s70n3fac3: posts small blind 50
FDIBA2009: posts big blind 100
*** HOLE CARDS ***
s70n3fac3: calls 50
FDIBA2009: raises 200 to 300
s70n3fac3: calls 200
*** FLOP *** [As 9d Qc]
FDIBA2009: bets 300
s70n3fac3: folds 
Uncalled bet (300) returned to FDIBA2009
FDIBA2009 collected 567 from pot
FDIBA2009: doesn't show hand 
*** SUMMARY ***
Total pot 600 | Rake 33 
Board [As 9d Qc]
Seat 1: s70n3fac3 (button) (small blind) folded on the Flop
Seat 2: FDIBA2009 (big blind) collected (567)



PokerStars Home Game Hand #227250050387: {Club #4781089}  Hold'em No Limit (50/100) - 2021/06/01 23:28:52 EET [2021/06/01 16:28:52 ET]
Table 'VTPP NLHE 0106' 2-max (Play Money) Seat #2 is the button
Seat 1: s70n3fac3 (7541 in chips) 
Seat 2: FDIBA2009 (26727 in chips) 
FDIBA2009: posts small blind 50
s70n3fac3: posts big blind 100
*** HOLE CARDS ***
FDIBA2009: raises 100 to 200
s70n3fac3: raises 400 to 600
FDIBA2009: folds 
Uncalled bet (400) returned to s70n3fac3
s70n3fac3 collected 400 from pot
s70n3fac3: doesn't show hand 
*** SUMMARY ***
Total pot 400 | Rake 0 
Seat 1: s70n3fac3 (big blind) collected (400)
Seat 2: FDIBA2009 (button) (small blind) folded before Flop



PokerStars Home Game Hand #227250054318: {Club #4781089}  Hold'em No Limit (50/100) - 2021/06/01 23:28:59 EET [2021/06/01 16:28:59 ET]
Table 'VTPP NLHE 0106' 2-max (Play Money) Seat #1 is the button
Seat 1: s70n3fac3 (7741 in chips) 
Seat 2: FDIBA2009 (26527 in chips) 
s70n3fac3: posts small blind 50
FDIBA2009: posts big blind 100
*** HOLE CARDS ***
s70n3fac3: folds 
Uncalled bet (50) returned to FDIBA2009
FDIBA2009 collected 100 from pot
FDIBA2009: doesn't show hand 
*** SUMMARY ***
Total pot 100 | Rake 0 
Seat 1: s70n3fac3 (button) (small blind) folded before Flop
Seat 2: FDIBA2009 (big blind) collected (100)



PokerStars Home Game Hand #227250056265: {Club #4781089}  Hold'em No Limit (50/100) - 2021/06/01 23:29:03 EET [2021/06/01 16:29:03 ET]
Table 'VTPP NLHE 0106' 2-max (Play Money) Seat #2 is the button
Seat 1: s70n3fac3 (7691 in chips) 
Seat 2: FDIBA2009 (26577 in chips) 
FDIBA2009: posts small blind 50
s70n3fac3: posts big blind 100
*** HOLE CARDS ***
FDIBA2009: raises 100 to 200
s70n3fac3: raises 400 to 600
FDIBA2009: calls 400
*** FLOP *** [8c 4d 2c]
s70n3fac3: bets 600
FDIBA2009: raises 25377 to 25977 and is all-in
s70n3fac3: calls 6491 and is all-in
Uncalled bet (18886) returned to FDIBA2009
*** TURN *** [8c 4d 2c] [Jh]
*** RIVER *** [8c 4d 2c Jh] [4h]
*** SHOW DOWN ***
s70n3fac3: shows [7d 7c] (two pair, Sevens and Fours)
FDIBA2009: shows [Td 8s] (two pair, Eights and Fours)
FDIBA2009 collected 14536 from pot
*** SUMMARY ***
Total pot 15382 | Rake 846 
Board [8c 4d 2c Jh 4h]
Seat 1: s70n3fac3 (big blind) showed [7d 7c] and lost with two pair, Sevens and Fours
Seat 2: FDIBA2009 (button) (small blind) showed [Td 8s] and won (14536) with two pair, Eights and Fours



PokerStars Home Game Hand #227250074537: {Club #4781089}  Hold'em No Limit (50/100) - 2021/06/01 23:29:38 EET [2021/06/01 16:29:38 ET]
Table 'VTPP NLHE 0106' 2-max (Play Money) Seat #1 is the button
Seat 1: s70n3fac3 (10000 in chips) 
Seat 2: FDIBA2009 (33422 in chips) 
s70n3fac3: posts small blind 50
FDIBA2009: posts big blind 100
*** HOLE CARDS ***
s70n3fac3: raises 200 to 300
FDIBA2009: calls 200
*** FLOP *** [8c 3s 3h]
FDIBA2009: checks 
s70n3fac3: bets 567
FDIBA2009: folds 
Uncalled bet (567) returned to s70n3fac3
s70n3fac3 collected 567 from pot
s70n3fac3: doesn't show hand 
*** SUMMARY ***
Total pot 600 | Rake 33 
Board [8c 3s 3h]
Seat 1: s70n3fac3 (button) (small blind) collected (567)
Seat 2: FDIBA2009 (big blind) folded on the Flop



PokerStars Home Game Hand #227250081301: {Club #4781089}  Hold'em No Limit (50/100) - 2021/06/01 23:29:51 EET [2021/06/01 16:29:51 ET]
Table 'VTPP NLHE 0106' 2-max (Play Money) Seat #2 is the button
Seat 1: s70n3fac3 (10267 in chips) 
Seat 2: FDIBA2009 (33122 in chips) 
FDIBA2009: posts small blind 50
s70n3fac3: posts big blind 100
*** HOLE CARDS ***
FDIBA2009: raises 100 to 200
s70n3fac3: folds 
Uncalled bet (100) returned to FDIBA2009
FDIBA2009 collected 200 from pot
FDIBA2009: doesn't show hand 
*** SUMMARY ***
Total pot 200 | Rake 0 
Seat 1: s70n3fac3 (big blind) folded before Flop
Seat 2: FDIBA2009 (button) (small blind) collected (200)



PokerStars Home Game Hand #227250084512: {Club #4781089}  Hold'em No Limit (50/100) - 2021/06/01 23:29:57 EET [2021/06/01 16:29:57 ET]
Table 'VTPP NLHE 0106' 2-max (Play Money) Seat #1 is the button
Seat 1: s70n3fac3 (10167 in chips) 
Seat 2: FDIBA2009 (33222 in chips) 
s70n3fac3: posts small blind 50
FDIBA2009: posts big blind 100
*** HOLE CARDS ***
s70n3fac3: raises 300 to 400
FDIBA2009: calls 300
*** FLOP *** [2h 5d 5h]
FDIBA2009: checks 
s70n3fac3: checks 
*** TURN *** [2h 5d 5h] [4d]
FDIBA2009: checks 
s70n3fac3: bets 756
FDIBA2009: calls 756
*** RIVER *** [2h 5d 5h 4d] [7h]
FDIBA2009: checks 
s70n3fac3: bets 2185
FDIBA2009: folds 
Uncalled bet (2185) returned to s70n3fac3
s70n3fac3 collected 2185 from pot
s70n3fac3: doesn't show hand 
*** SUMMARY ***
Total pot 2312 | Rake 127 
Board [2h 5d 5h 4d 7h]
Seat 1: s70n3fac3 (button) (small blind) collected (2185)
Seat 2: FDIBA2009 (big blind) folded on the River



PokerStars Home Game Hand #227250096042: {Club #4781089}  Hold'em No Limit (50/100) - 2021/06/01 23:30:19 EET [2021/06/01 16:30:19 ET]
Table 'VTPP NLHE 0106' 2-max (Play Money) Seat #2 is the button
Seat 1: s70n3fac3 (11196 in chips) 
Seat 2: FDIBA2009 (32066 in chips) 
FDIBA2009: posts small blind 50
s70n3fac3: posts big blind 100
*** HOLE CARDS ***
FDIBA2009: raises 100 to 200
s70n3fac3: calls 100
*** FLOP *** [5c Jh 6d]
s70n3fac3: checks 
FDIBA2009: checks 
*** TURN *** [5c Jh 6d] [5s]
s70n3fac3: checks 
FDIBA2009: bets 200
s70n3fac3: calls 200
*** RIVER *** [5c Jh 6d 5s] [Kd]
s70n3fac3: checks 
FDIBA2009: bets 756
s70n3fac3: calls 756
*** SHOW DOWN ***
FDIBA2009: shows [7d 3h] (a pair of Fives)
s70n3fac3: shows [9d Js] (two pair, Jacks and Fives)
s70n3fac3 collected 2185 from pot
*** SUMMARY ***
Total pot 2312 | Rake 127 
Board [5c Jh 6d 5s Kd]
Seat 1: s70n3fac3 (big blind) showed [9d Js] and won (2185) with two pair, Jacks and Fives
Seat 2: FDIBA2009 (button) (small blind) showed [7d 3h] and lost with a pair of Fives



PokerStars Home Game Hand #227250111955: {Club #4781089}  Hold'em No Limit (50/100) - 2021/06/01 23:30:40 EET [2021/06/01 16:30:40 ET]
Table 'VTPP NLHE 0106' 2-max (Play Money) Seat #1 is the button
Seat 1: s70n3fac3 (12225 in chips) 
Seat 2: FDIBA2009 (30910 in chips) 
s70n3fac3: posts small blind 50
FDIBA2009: posts big blind 100
*** HOLE CARDS ***
s70n3fac3: calls 50
FDIBA2009: checks 
*** FLOP *** [Kd 5s Th]
FDIBA2009: checks 
s70n3fac3: bets 200
FDIBA2009: folds 
Uncalled bet (200) returned to s70n3fac3
s70n3fac3 collected 189 from pot
s70n3fac3: doesn't show hand 
*** SUMMARY ***
Total pot 200 | Rake 11 
Board [Kd 5s Th]
Seat 1: s70n3fac3 (button) (small blind) collected (189)
Seat 2: FDIBA2009 (big blind) folded on the Flop



PokerStars Home Game Hand #227250117495: {Club #4781089}  Hold'em No Limit (50/100) - 2021/06/01 23:30:50 EET [2021/06/01 16:30:50 ET]
Table 'VTPP NLHE 0106' 2-max (Play Money) Seat #2 is the button
Seat 1: s70n3fac3 (12314 in chips) 
Seat 2: FDIBA2009 (30810 in chips) 
FDIBA2009: posts small blind 50
s70n3fac3: posts big blind 100
*** HOLE CARDS ***
FDIBA2009: raises 100 to 200
s70n3fac3: raises 500 to 700
FDIBA2009: folds 
Uncalled bet (500) returned to s70n3fac3
s70n3fac3 collected 400 from pot
s70n3fac3: doesn't show hand 
*** SUMMARY ***
Total pot 400 | Rake 0 
Seat 1: s70n3fac3 (big blind) collected (400)
Seat 2: FDIBA2009 (button) (small blind) folded before Flop



PokerStars Home Game Hand #227250122079: {Club #4781089}  Hold'em No Limit (50/100) - 2021/06/01 23:30:59 EET [2021/06/01 16:30:59 ET]
Table 'VTPP NLHE 0106' 2-max (Play Money) Seat #1 is the button
Seat 1: s70n3fac3 (12514 in chips) 
Seat 2: FDIBA2009 (30610 in chips) 
s70n3fac3: posts small blind 50
FDIBA2009: posts big blind 100
*** HOLE CARDS ***
s70n3fac3: calls 50
FDIBA2009: raises 200 to 300
s70n3fac3: folds 
Uncalled bet (200) returned to FDIBA2009
FDIBA2009 collected 200 from pot
FDIBA2009: doesn't show hand 
*** SUMMARY ***
Total pot 200 | Rake 0 
Seat 1: s70n3fac3 (button) (small blind) folded before Flop
Seat 2: FDIBA2009 (big blind) collected (200)



PokerStars Home Game Hand #227250125649: {Club #4781089}  Hold'em No Limit (50/100) - 2021/06/01 23:31:06 EET [2021/06/01 16:31:06 ET]
Table 'VTPP NLHE 0106' 2-max (Play Money) Seat #2 is the button
Seat 1: s70n3fac3 (12414 in chips) 
Seat 2: FDIBA2009 (30710 in chips) 
FDIBA2009: posts small blind 50
s70n3fac3: posts big blind 100
*** HOLE CARDS ***
FDIBA2009: raises 100 to 200
s70n3fac3: calls 100
*** FLOP *** [5h 4d 3s]
s70n3fac3: checks 
FDIBA2009: bets 200
s70n3fac3: raises 778 to 978
FDIBA2009: calls 778
*** TURN *** [5h 4d 3s] [2h]
s70n3fac3: checks 
FDIBA2009: bets 1150
s70n3fac3: calls 1150
*** RIVER *** [5h 4d 3s 2h] [7d]
s70n3fac3: checks 
FDIBA2009: checks 
*** SHOW DOWN ***
s70n3fac3: shows [4c 5d] (two pair, Fives and Fours)
FDIBA2009: mucks hand 
s70n3fac3 collected 4400 from pot
*** SUMMARY ***
Total pot 4656 | Rake 256 
Board [5h 4d 3s 2h 7d]
Seat 1: s70n3fac3 (big blind) showed [4c 5d] and won (4400) with two pair, Fives and Fours
Seat 2: FDIBA2009 (button) (small blind) mucked [8c 7s]



PokerStars Home Game Hand #227250140641: {Club #4781089}  Hold'em No Limit (50/100) - 2021/06/01 23:31:34 EET [2021/06/01 16:31:34 ET]
Table 'VTPP NLHE 0106' 2-max (Play Money) Seat #1 is the button
Seat 1: s70n3fac3 (14486 in chips) 
Seat 2: FDIBA2009 (28382 in chips) 
s70n3fac3: posts small blind 50
FDIBA2009: posts big blind 100
*** HOLE CARDS ***
s70n3fac3: calls 50
FDIBA2009: checks 
*** FLOP *** [Ad 5d 8h]
FDIBA2009: checks 
s70n3fac3: checks 
*** TURN *** [Ad 5d 8h] [3d]
FDIBA2009: checks 
s70n3fac3: checks 
*** RIVER *** [Ad 5d 8h 3d] [8d]
FDIBA2009: checks 
s70n3fac3: checks 
*** SHOW DOWN ***
FDIBA2009: shows [Tc 3s] (two pair, Eights and Threes)
s70n3fac3: mucks hand 
FDIBA2009 collected 189 from pot
*** SUMMARY ***
Total pot 200 | Rake 11 
Board [Ad 5d 8h 3d 8d]
Seat 1: s70n3fac3 (button) (small blind) mucked [2c Kc]
Seat 2: FDIBA2009 (big blind) showed [Tc 3s] and won (189) with two pair, Eights and Threes



PokerStars Home Game Hand #227250151201: {Club #4781089}  Hold'em No Limit (50/100) - 2021/06/01 23:31:54 EET [2021/06/01 16:31:54 ET]
Table 'VTPP NLHE 0106' 2-max (Play Money) Seat #2 is the button
Seat 1: s70n3fac3 (14386 in chips) 
Seat 2: FDIBA2009 (28471 in chips) 
FDIBA2009: posts small blind 50
s70n3fac3: posts big blind 100
*** HOLE CARDS ***
FDIBA2009: raises 200 to 300
s70n3fac3: calls 200
*** FLOP *** [3c Jd 2s]
s70n3fac3: checks 
FDIBA2009: bets 300
s70n3fac3: calls 300
*** TURN *** [3c Jd 2s] [8h]
s70n3fac3: checks 
FDIBA2009: checks 
*** RIVER *** [3c Jd 2s 8h] [Kd]
s70n3fac3: checks 
FDIBA2009: checks 
*** SHOW DOWN ***
s70n3fac3: shows [3s 4s] (a pair of Threes)
FDIBA2009: mucks hand 
s70n3fac3 collected 1134 from pot
*** SUMMARY ***
Total pot 1200 | Rake 66 
Board [3c Jd 2s 8h Kd]
Seat 1: s70n3fac3 (big blind) showed [3s 4s] and won (1134) with a pair of Threes
Seat 2: FDIBA2009 (button) (small blind) mucked [2c Ac]



PokerStars Home Game Hand #227250160554: {Club #4781089}  Hold'em No Limit (50/100) - 2021/06/01 23:32:12 EET [2021/06/01 16:32:12 ET]
Table 'VTPP NLHE 0106' 2-max (Play Money) Seat #1 is the button
Seat 1: s70n3fac3 (14920 in chips) 
Seat 2: FDIBA2009 (27871 in chips) 
s70n3fac3: posts small blind 50
FDIBA2009: posts big blind 100
*** HOLE CARDS ***
s70n3fac3: raises 100 to 200
FDIBA2009: calls 100
*** FLOP *** [2c 7s Qs]
FDIBA2009: checks 
s70n3fac3: checks 
*** TURN *** [2c 7s Qs] [Tc]
FDIBA2009: checks 
s70n3fac3: bets 300
FDIBA2009: folds 
Uncalled bet (300) returned to s70n3fac3
s70n3fac3 collected 378 from pot
s70n3fac3: doesn't show hand 
*** SUMMARY ***
Total pot 400 | Rake 22 
Board [2c 7s Qs Tc]
Seat 1: s70n3fac3 (button) (small blind) collected (378)
Seat 2: FDIBA2009 (big blind) folded on the Turn



PokerStars Home Game Hand #227250168638: {Club #4781089}  Hold'em No Limit (50/100) - 2021/06/01 23:32:28 EET [2021/06/01 16:32:28 ET]
Table 'VTPP NLHE 0106' 2-max (Play Money) Seat #2 is the button
Seat 1: s70n3fac3 (15098 in chips) 
Seat 2: FDIBA2009 (27671 in chips) 
FDIBA2009: posts small blind 50
s70n3fac3: posts big blind 100
*** HOLE CARDS ***
FDIBA2009: raises 200 to 300
s70n3fac3: calls 200
*** FLOP *** [7s 9c 7h]
s70n3fac3: checks 
FDIBA2009: checks 
*** TURN *** [7s 9c 7h] [Ks]
s70n3fac3: checks 
FDIBA2009: bets 350
s70n3fac3: raises 350 to 700
FDIBA2009: calls 350
*** RIVER *** [7s 9c 7h Ks] [7d]
s70n3fac3: bets 1890
FDIBA2009: folds 
Uncalled bet (1890) returned to s70n3fac3
s70n3fac3 collected 1890 from pot
s70n3fac3: doesn't show hand 
*** SUMMARY ***
Total pot 2000 | Rake 110 
Board [7s 9c 7h Ks 7d]
Seat 1: s70n3fac3 (big blind) collected (1890)
Seat 2: FDIBA2009 (button) (small blind) folded on the River



PokerStars Home Game Hand #227250180545: {Club #4781089}  Hold'em No Limit (50/100) - 2021/06/01 23:32:50 EET [2021/06/01 16:32:50 ET]
Table 'VTPP NLHE 0106' 2-max (Play Money) Seat #1 is the button
Seat 1: s70n3fac3 (15988 in chips) 
Seat 2: FDIBA2009 (26671 in chips) 
s70n3fac3: posts small blind 50
FDIBA2009: posts big blind 100
*** HOLE CARDS ***
s70n3fac3: raises 100 to 200
FDIBA2009: folds 
Uncalled bet (100) returned to s70n3fac3
s70n3fac3 collected 200 from pot
s70n3fac3: doesn't show hand 
*** SUMMARY ***
Total pot 200 | Rake 0 
Seat 1: s70n3fac3 (button) (small blind) collected (200)
Seat 2: FDIBA2009 (big blind) folded before Flop



PokerStars Home Game Hand #227250183187: {Club #4781089}  Hold'em No Limit (50/100) - 2021/06/01 23:32:55 EET [2021/06/01 16:32:55 ET]
Table 'VTPP NLHE 0106' 2-max (Play Money) Seat #2 is the button
Seat 1: s70n3fac3 (16088 in chips) 
Seat 2: FDIBA2009 (26571 in chips) 
FDIBA2009: posts small blind 50
s70n3fac3: posts big blind 100
*** HOLE CARDS ***
FDIBA2009: raises 100 to 200
s70n3fac3: folds 
Uncalled bet (100) returned to FDIBA2009
FDIBA2009 collected 200 from pot
FDIBA2009: doesn't show hand 
*** SUMMARY ***
Total pot 200 | Rake 0 
Seat 1: s70n3fac3 (big blind) folded before Flop
Seat 2: FDIBA2009 (button) (small blind) collected (200)



PokerStars Home Game Hand #227250187867: {Club #4781089}  Hold'em No Limit (50/100) - 2021/06/01 23:33:04 EET [2021/06/01 16:33:04 ET]
Table 'VTPP NLHE 0106' 2-max (Play Money) Seat #1 is the button
Seat 1: s70n3fac3 (15988 in chips) 
Seat 2: FDIBA2009 (26671 in chips) 
s70n3fac3: posts small blind 50
FDIBA2009: posts big blind 100
*** HOLE CARDS ***
s70n3fac3: raises 150 to 250
FDIBA2009: raises 150 to 400
s70n3fac3: calls 150
*** FLOP *** [Jd 2c 3s]
FDIBA2009: bets 400
s70n3fac3: folds 
Uncalled bet (400) returned to FDIBA2009
FDIBA2009 collected 756 from pot
FDIBA2009: doesn't show hand 
*** SUMMARY ***
Total pot 800 | Rake 44 
Board [Jd 2c 3s]
Seat 1: s70n3fac3 (button) (small blind) folded on the Flop
Seat 2: FDIBA2009 (big blind) collected (756)



PokerStars Home Game Hand #227250198006: {Club #4781089}  Hold'em No Limit (50/100) - 2021/06/01 23:33:23 EET [2021/06/01 16:33:23 ET]
Table 'VTPP NLHE 0106' 2-max (Play Money) Seat #2 is the button
Seat 1: s70n3fac3 (15588 in chips) 
Seat 2: FDIBA2009 (27027 in chips) 
FDIBA2009: posts small blind 50
s70n3fac3: posts big blind 100
*** HOLE CARDS ***
FDIBA2009: raises 100 to 200
s70n3fac3: calls 100
*** FLOP *** [7s 6d 8d]
s70n3fac3: checks 
FDIBA2009: bets 200
s70n3fac3: calls 200
*** TURN *** [7s 6d 8d] [Td]
s70n3fac3: checks 
FDIBA2009: bets 400
s70n3fac3: folds 
Uncalled bet (400) returned to FDIBA2009
FDIBA2009 collected 756 from pot
FDIBA2009: doesn't show hand 
*** SUMMARY ***
Total pot 800 | Rake 44 
Board [7s 6d 8d Td]
Seat 1: s70n3fac3 (big blind) folded on the Turn
Seat 2: FDIBA2009 (button) (small blind) collected (756)



PokerStars Home Game Hand #227250206865: {Club #4781089}  Hold'em No Limit (50/100) - 2021/06/01 23:33:40 EET [2021/06/01 16:33:40 ET]
Table 'VTPP NLHE 0106' 2-max (Play Money) Seat #1 is the button
Seat 1: s70n3fac3 (15188 in chips) 
Seat 2: FDIBA2009 (27383 in chips) 
s70n3fac3: posts small blind 50
FDIBA2009: posts big blind 100
*** HOLE CARDS ***
s70n3fac3: calls 50
FDIBA2009: checks 
*** FLOP *** [5s 4d Kc]
FDIBA2009: bets 189
s70n3fac3: calls 189
*** TURN *** [5s 4d Kc] [Ac]
FDIBA2009: checks 
s70n3fac3: checks 
*** RIVER *** [5s 4d Kc Ac] [5c]
FDIBA2009: checks 
s70n3fac3: checks 
*** SHOW DOWN ***
FDIBA2009: shows [8d Ks] (two pair, Kings and Fives)
s70n3fac3: mucks hand 
FDIBA2009 collected 546 from pot
*** SUMMARY ***
Total pot 578 | Rake 32 
Board [5s 4d Kc Ac 5c]
Seat 1: s70n3fac3 (button) (small blind) mucked [3c 6d]
Seat 2: FDIBA2009 (big blind) showed [8d Ks] and won (546) with two pair, Kings and Fives



PokerStars Home Game Hand #227250217169: {Club #4781089}  Hold'em No Limit (50/100) - 2021/06/01 23:34:00 EET [2021/06/01 16:34:00 ET]
Table 'VTPP NLHE 0106' 2-max (Play Money) Seat #2 is the button
Seat 1: s70n3fac3 (14899 in chips) 
Seat 2: FDIBA2009 (27640 in chips) 
FDIBA2009: posts small blind 50
s70n3fac3: posts big blind 100
*** HOLE CARDS ***
FDIBA2009: raises 100 to 200
s70n3fac3: calls 100
*** FLOP *** [Td Ah Jh]
s70n3fac3: checks 
FDIBA2009: bets 378
s70n3fac3: folds 
Uncalled bet (378) returned to FDIBA2009
FDIBA2009 collected 378 from pot
FDIBA2009: doesn't show hand 
*** SUMMARY ***
Total pot 400 | Rake 22 
Board [Td Ah Jh]
Seat 1: s70n3fac3 (big blind) folded on the Flop
Seat 2: FDIBA2009 (button) (small blind) collected (378)



PokerStars Home Game Hand #227250223413: {Club #4781089}  Hold'em No Limit (50/100) - 2021/06/01 23:34:12 EET [2021/06/01 16:34:12 ET]
Table 'VTPP NLHE 0106' 2-max (Play Money) Seat #1 is the button
Seat 1: s70n3fac3 (14699 in chips) 
Seat 2: FDIBA2009 (27818 in chips) 
s70n3fac3: posts small blind 50
FDIBA2009: posts big blind 100
*** HOLE CARDS ***
s70n3fac3: raises 150 to 250
FDIBA2009: calls 150
*** FLOP *** [Ah 9h Qh]
FDIBA2009: checks 
s70n3fac3: bets 300
FDIBA2009: calls 300
*** TURN *** [Ah 9h Qh] [Ts]
FDIBA2009: checks 
s70n3fac3: bets 650
FDIBA2009: calls 650
*** RIVER *** [Ah 9h Qh Ts] [2s]
FDIBA2009: checks 
s70n3fac3: bets 1850
FDIBA2009: calls 1850
*** SHOW DOWN ***
s70n3fac3: shows [3h Th] (a flush, Ace high)
FDIBA2009: mucks hand 
s70n3fac3 collected 5764 from pot
*** SUMMARY ***
Total pot 6100 | Rake 336 
Board [Ah 9h Qh Ts 2s]
Seat 1: s70n3fac3 (button) (small blind) showed [3h Th] and won (5764) with a flush, Ace high
Seat 2: FDIBA2009 (big blind) mucked [As 9s]



PokerStars Home Game Hand #227250246347: {Club #4781089}  Hold'em No Limit (50/100) - 2021/06/01 23:34:56 EET [2021/06/01 16:34:56 ET]
Table 'VTPP NLHE 0106' 2-max (Play Money) Seat #2 is the button
Seat 1: s70n3fac3 (17413 in chips) 
Seat 2: FDIBA2009 (24768 in chips) 
FDIBA2009: posts small blind 50
s70n3fac3: posts big blind 100
*** HOLE CARDS ***
FDIBA2009: folds 
Uncalled bet (50) returned to s70n3fac3
s70n3fac3 collected 100 from pot
s70n3fac3: doesn't show hand 
*** SUMMARY ***
Total pot 100 | Rake 0 
Seat 1: s70n3fac3 (big blind) collected (100)
Seat 2: FDIBA2009 (button) (small blind) folded before Flop



PokerStars Home Game Hand #227250250026: {Club #4781089}  Hold'em No Limit (50/100) - 2021/06/01 23:35:03 EET [2021/06/01 16:35:03 ET]
Table 'VTPP NLHE 0106' 2-max (Play Money) Seat #1 is the button
Seat 1: s70n3fac3 (17463 in chips) 
Seat 2: FDIBA2009 (24718 in chips) 
s70n3fac3: posts small blind 50
FDIBA2009: posts big blind 100
*** HOLE CARDS ***
s70n3fac3: calls 50
FDIBA2009: checks 
*** FLOP *** [8c 6d 6c]
FDIBA2009: checks 
s70n3fac3: checks 
*** TURN *** [8c 6d 6c] [Kc]
FDIBA2009: bets 189
s70n3fac3: raises 511 to 700
FDIBA2009: folds 
Uncalled bet (511) returned to s70n3fac3
s70n3fac3 collected 546 from pot
s70n3fac3: doesn't show hand 
*** SUMMARY ***
Total pot 578 | Rake 32 
Board [8c 6d 6c Kc]
Seat 1: s70n3fac3 (button) (small blind) collected (546)
Seat 2: FDIBA2009 (big blind) folded on the Turn



PokerStars Home Game Hand #227250258082: {Club #4781089}  Hold'em No Limit (50/100) - 2021/06/01 23:35:18 EET [2021/06/01 16:35:18 ET]
Table 'VTPP NLHE 0106' 2-max (Play Money) Seat #2 is the button
Seat 1: s70n3fac3 (17720 in chips) 
Seat 2: FDIBA2009 (24429 in chips) 
FDIBA2009: posts small blind 50
s70n3fac3: posts big blind 100
*** HOLE CARDS ***
FDIBA2009: raises 100 to 200
s70n3fac3: calls 100
*** FLOP *** [As 9d 5h]
s70n3fac3: checks 
FDIBA2009: bets 200
s70n3fac3: calls 200
*** TURN *** [As 9d 5h] [Tc]
s70n3fac3: checks 
FDIBA2009: bets 450
s70n3fac3: folds 
Uncalled bet (450) returned to FDIBA2009
FDIBA2009 collected 756 from pot
FDIBA2009: doesn't show hand 
*** SUMMARY ***
Total pot 800 | Rake 44 
Board [As 9d 5h Tc]
Seat 1: s70n3fac3 (big blind) folded on the Turn
Seat 2: FDIBA2009 (button) (small blind) collected (756)



PokerStars Home Game Hand #227250268554: {Club #4781089}  Hold'em No Limit (50/100) - 2021/06/01 23:35:38 EET [2021/06/01 16:35:38 ET]
Table 'VTPP NLHE 0106' 2-max (Play Money) Seat #1 is the button
Seat 1: s70n3fac3 (17320 in chips) 
Seat 2: FDIBA2009 (24785 in chips) 
s70n3fac3: posts small blind 50
FDIBA2009: posts big blind 100
*** HOLE CARDS ***
s70n3fac3: raises 150 to 250
FDIBA2009: raises 500 to 750
s70n3fac3: calls 500
*** FLOP *** [6h 2c 6d]
FDIBA2009: checks 
s70n3fac3: checks 
*** TURN *** [6h 2c 6d] [Ac]
FDIBA2009: bets 950
s70n3fac3: calls 950
*** RIVER *** [6h 2c 6d Ac] [Qs]
FDIBA2009: checks 
s70n3fac3: bets 1850
FDIBA2009: folds 
Uncalled bet (1850) returned to s70n3fac3
s70n3fac3 collected 3213 from pot
s70n3fac3: doesn't show hand 
*** SUMMARY ***
Total pot 3400 | Rake 187 
Board [6h 2c 6d Ac Qs]
Seat 1: s70n3fac3 (button) (small blind) collected (3213)
Seat 2: FDIBA2009 (big blind) folded on the River



PokerStars Home Game Hand #227250288992: {Club #4781089}  Hold'em No Limit (50/100) - 2021/06/01 23:36:18 EET [2021/06/01 16:36:18 ET]
Table 'VTPP NLHE 0106' 2-max (Play Money) Seat #2 is the button
Seat 1: s70n3fac3 (18833 in chips) 
Seat 2: FDIBA2009 (23085 in chips) 
FDIBA2009: posts small blind 50
s70n3fac3: posts big blind 100
*** HOLE CARDS ***
FDIBA2009: raises 100 to 200
s70n3fac3: calls 100
*** FLOP *** [Jc 9s 3h]
s70n3fac3: checks 
FDIBA2009: checks 
*** TURN *** [Jc 9s 3h] [Ah]
s70n3fac3: checks 
FDIBA2009: bets 378
s70n3fac3: calls 378
*** RIVER *** [Jc 9s 3h Ah] [Tc]
s70n3fac3: checks 
FDIBA2009: checks 
*** SHOW DOWN ***
s70n3fac3: shows [9h 6s] (a pair of Nines)
FDIBA2009: mucks hand 
s70n3fac3 collected 1092 from pot
*** SUMMARY ***
Total pot 1156 | Rake 64 
Board [Jc 9s 3h Ah Tc]
Seat 1: s70n3fac3 (big blind) showed [9h 6s] and won (1092) with a pair of Nines
Seat 2: FDIBA2009 (button) (small blind) mucked [4h 2c]



PokerStars Home Game Hand #227250298093: {Club #4781089}  Hold'em No Limit (50/100) - 2021/06/01 23:36:35 EET [2021/06/01 16:36:35 ET]
Table 'VTPP NLHE 0106' 2-max (Play Money) Seat #1 is the button
Seat 1: s70n3fac3 (19347 in chips) 
Seat 2: FDIBA2009 (22507 in chips) 
s70n3fac3: posts small blind 50
FDIBA2009: posts big blind 100
*** HOLE CARDS ***
s70n3fac3: raises 150 to 250
FDIBA2009: folds 
Uncalled bet (150) returned to s70n3fac3
s70n3fac3 collected 200 from pot
s70n3fac3: doesn't show hand 
*** SUMMARY ***
Total pot 200 | Rake 0 
Seat 1: s70n3fac3 (button) (small blind) collected (200)
Seat 2: FDIBA2009 (big blind) folded before Flop



PokerStars Home Game Hand #227250300758: {Club #4781089}  Hold'em No Limit (50/100) - 2021/06/01 23:36:40 EET [2021/06/01 16:36:40 ET]
Table 'VTPP NLHE 0106' 2-max (Play Money) Seat #2 is the button
Seat 1: s70n3fac3 (19447 in chips) 
Seat 2: FDIBA2009 (22407 in chips) 
FDIBA2009: posts small blind 50
s70n3fac3: posts big blind 100
*** HOLE CARDS ***
FDIBA2009: raises 100 to 200
s70n3fac3: folds 
Uncalled bet (100) returned to FDIBA2009
FDIBA2009 collected 200 from pot
FDIBA2009: doesn't show hand 
*** SUMMARY ***
Total pot 200 | Rake 0 
Seat 1: s70n3fac3 (big blind) folded before Flop
Seat 2: FDIBA2009 (button) (small blind) collected (200)



PokerStars Home Game Hand #227250303867: {Club #4781089}  Hold'em No Limit (50/100) - 2021/06/01 23:36:46 EET [2021/06/01 16:36:46 ET]
Table 'VTPP NLHE 0106' 2-max (Play Money) Seat #1 is the button
Seat 1: s70n3fac3 (19347 in chips) 
Seat 2: FDIBA2009 (22507 in chips) 
s70n3fac3: posts small blind 50
FDIBA2009: posts big blind 100
*** HOLE CARDS ***
s70n3fac3: raises 150 to 250
FDIBA2009: folds 
Uncalled bet (150) returned to s70n3fac3
s70n3fac3 collected 200 from pot
s70n3fac3: doesn't show hand 
*** SUMMARY ***
Total pot 200 | Rake 0 
Seat 1: s70n3fac3 (button) (small blind) collected (200)
Seat 2: FDIBA2009 (big blind) folded before Flop



PokerStars Home Game Hand #227250306818: {Club #4781089}  Hold'em No Limit (50/100) - 2021/06/01 23:36:52 EET [2021/06/01 16:36:52 ET]
Table 'VTPP NLHE 0106' 2-max (Play Money) Seat #2 is the button
Seat 1: s70n3fac3 (19447 in chips) 
Seat 2: FDIBA2009 (22407 in chips) 
FDIBA2009: posts small blind 50
s70n3fac3: posts big blind 100
*** HOLE CARDS ***
FDIBA2009: raises 200 to 300
s70n3fac3: calls 200
*** FLOP *** [Ks Kd Ah]
s70n3fac3: checks 
FDIBA2009: bets 350
s70n3fac3: calls 350
*** TURN *** [Ks Kd Ah] [9s]
s70n3fac3: checks 
FDIBA2009: checks 
*** RIVER *** [Ks Kd Ah 9s] [9c]
s70n3fac3: checks 
FDIBA2009: bets 1228
s70n3fac3: calls 1228
*** SHOW DOWN ***
FDIBA2009: shows [Js 9d] (a full house, Nines full of Kings)
s70n3fac3: mucks hand 
FDIBA2009 collected 3549 from pot
*** SUMMARY ***
Total pot 3756 | Rake 207 
Board [Ks Kd Ah 9s 9c]
Seat 1: s70n3fac3 (big blind) mucked [As 4c]
Seat 2: FDIBA2009 (button) (small blind) showed [Js 9d] and won (3549) with a full house, Nines full of Kings



PokerStars Home Game Hand #227250319905: {Club #4781089}  Hold'em No Limit (50/100) - 2021/06/01 23:37:17 EET [2021/06/01 16:37:17 ET]
Table 'VTPP NLHE 0106' 2-max (Play Money) Seat #1 is the button
Seat 1: s70n3fac3 (17569 in chips) 
Seat 2: FDIBA2009 (24078 in chips) 
s70n3fac3: posts small blind 50
FDIBA2009: posts big blind 100
*** HOLE CARDS ***
s70n3fac3: raises 150 to 250
FDIBA2009: folds 
Uncalled bet (150) returned to s70n3fac3
s70n3fac3 collected 200 from pot
s70n3fac3: doesn't show hand 
*** SUMMARY ***
Total pot 200 | Rake 0 
Seat 1: s70n3fac3 (button) (small blind) collected (200)
Seat 2: FDIBA2009 (big blind) folded before Flop



PokerStars Home Game Hand #227250333582: {Club #4781089}  Hold'em No Limit (50/100) - 2021/06/01 23:37:25 EET [2021/06/01 16:37:25 ET]
Table 'VTPP NLHE 0106' 2-max (Play Money) Seat #2 is the button
Seat 1: s70n3fac3 (17669 in chips) 
Seat 2: FDIBA2009 (23978 in chips) 
FDIBA2009: posts small blind 50
s70n3fac3: posts big blind 100
*** HOLE CARDS ***
FDIBA2009: raises 100 to 200
s70n3fac3: calls 100
*** FLOP *** [3d 4s Qh]
s70n3fac3: checks 
FDIBA2009: bets 200
s70n3fac3: calls 200
*** TURN *** [3d 4s Qh] [Kc]
s70n3fac3: checks 
FDIBA2009: checks 
*** RIVER *** [3d 4s Qh Kc] [Qc]
s70n3fac3: checks 
FDIBA2009: checks 
*** SHOW DOWN ***
s70n3fac3: shows [Ac 3c] (two pair, Queens and Threes)
FDIBA2009: mucks hand 
s70n3fac3 collected 756 from pot
*** SUMMARY ***
Total pot 800 | Rake 44 
Board [3d 4s Qh Kc Qc]
Seat 1: s70n3fac3 (big blind) showed [Ac 3c] and won (756) with two pair, Queens and Threes
Seat 2: FDIBA2009 (button) (small blind) mucked [Jc 9h]



PokerStars Home Game Hand #227250344401: {Club #4781089}  Hold'em No Limit (50/100) - 2021/06/01 23:37:46 EET [2021/06/01 16:37:46 ET]
Table 'VTPP NLHE 0106' 2-max (Play Money) Seat #1 is the button
Seat 1: s70n3fac3 (18025 in chips) 
Seat 2: FDIBA2009 (23578 in chips) 
s70n3fac3: posts small blind 50
FDIBA2009: posts big blind 100
*** HOLE CARDS ***
s70n3fac3: calls 50
FDIBA2009: checks 
*** FLOP *** [Ah Qd Td]
FDIBA2009: checks 
s70n3fac3: bets 200
FDIBA2009: folds 
Uncalled bet (200) returned to s70n3fac3
s70n3fac3 collected 189 from pot
s70n3fac3: doesn't show hand 
*** SUMMARY ***
Total pot 200 | Rake 11 
Board [Ah Qd Td]
Seat 1: s70n3fac3 (button) (small blind) collected (189)
Seat 2: FDIBA2009 (big blind) folded on the Flop



PokerStars Home Game Hand #227250350873: {Club #4781089}  Hold'em No Limit (50/100) - 2021/06/01 23:37:58 EET [2021/06/01 16:37:58 ET]
Table 'VTPP NLHE 0106' 2-max (Play Money) Seat #2 is the button
Seat 1: s70n3fac3 (18114 in chips) 
Seat 2: FDIBA2009 (23478 in chips) 
FDIBA2009: posts small blind 50
s70n3fac3: posts big blind 100
*** HOLE CARDS ***
FDIBA2009: raises 100 to 200
s70n3fac3: calls 100
*** FLOP *** [9d 9c As]
s70n3fac3: checks 
FDIBA2009: checks 
*** TURN *** [9d 9c As] [5s]
s70n3fac3: bets 200
FDIBA2009: folds 
Uncalled bet (200) returned to s70n3fac3
s70n3fac3 collected 378 from pot
s70n3fac3: doesn't show hand 
*** SUMMARY ***
Total pot 400 | Rake 22 
Board [9d 9c As 5s]
Seat 1: s70n3fac3 (big blind) collected (378)
Seat 2: FDIBA2009 (button) (small blind) folded on the Turn



PokerStars Home Game Hand #227250359584: {Club #4781089}  Hold'em No Limit (50/100) - 2021/06/01 23:38:15 EET [2021/06/01 16:38:15 ET]
Table 'VTPP NLHE 0106' 2-max (Play Money) Seat #1 is the button
Seat 1: s70n3fac3 (18292 in chips) 
Seat 2: FDIBA2009 (23278 in chips) 
s70n3fac3: posts small blind 50
FDIBA2009: posts big blind 100
*** HOLE CARDS ***
s70n3fac3: calls 50
FDIBA2009: checks 
*** FLOP *** [Ac 9d 5h]
FDIBA2009: checks 
s70n3fac3: checks 
*** TURN *** [Ac 9d 5h] [5d]
FDIBA2009: checks 
s70n3fac3: bets 200
FDIBA2009: folds 
Uncalled bet (200) returned to s70n3fac3
s70n3fac3 collected 189 from pot
s70n3fac3: doesn't show hand 
*** SUMMARY ***
Total pot 200 | Rake 11 
Board [Ac 9d 5h 5d]
Seat 1: s70n3fac3 (button) (small blind) collected (189)
Seat 2: FDIBA2009 (big blind) folded on the Turn



PokerStars Home Game Hand #227250366033: {Club #4781089}  Hold'em No Limit (50/100) - 2021/06/01 23:38:28 EET [2021/06/01 16:38:28 ET]
Table 'VTPP NLHE 0106' 2-max (Play Money) Seat #2 is the button
Seat 1: s70n3fac3 (18381 in chips) 
Seat 2: FDIBA2009 (23178 in chips) 
FDIBA2009: posts small blind 50
s70n3fac3: posts big blind 100
*** HOLE CARDS ***
FDIBA2009: raises 100 to 200
s70n3fac3: folds 
Uncalled bet (100) returned to FDIBA2009
FDIBA2009 collected 200 from pot
FDIBA2009: doesn't show hand 
*** SUMMARY ***
Total pot 200 | Rake 0 
Seat 1: s70n3fac3 (big blind) folded before Flop
Seat 2: FDIBA2009 (button) (small blind) collected (200)



PokerStars Home Game Hand #227250369011: {Club #4781089}  Hold'em No Limit (50/100) - 2021/06/01 23:38:33 EET [2021/06/01 16:38:33 ET]
Table 'VTPP NLHE 0106' 2-max (Play Money) Seat #1 is the button
Seat 1: s70n3fac3 (18281 in chips) 
Seat 2: FDIBA2009 (23278 in chips) 
s70n3fac3: posts small blind 50
FDIBA2009: posts big blind 100
*** HOLE CARDS ***
s70n3fac3: raises 150 to 250
FDIBA2009: folds 
Uncalled bet (150) returned to s70n3fac3
s70n3fac3 collected 200 from pot
s70n3fac3: doesn't show hand 
*** SUMMARY ***
Total pot 200 | Rake 0 
Seat 1: s70n3fac3 (button) (small blind) collected (200)
Seat 2: FDIBA2009 (big blind) folded before Flop



PokerStars Home Game Hand #227250371751: {Club #4781089}  Hold'em No Limit (50/100) - 2021/06/01 23:38:39 EET [2021/06/01 16:38:39 ET]
Table 'VTPP NLHE 0106' 2-max (Play Money) Seat #2 is the button
Seat 1: s70n3fac3 (18381 in chips) 
Seat 2: FDIBA2009 (23178 in chips) 
FDIBA2009: posts small blind 50
s70n3fac3: posts big blind 100
*** HOLE CARDS ***
FDIBA2009: raises 100 to 200
s70n3fac3: calls 100
*** FLOP *** [5d Ad As]
s70n3fac3: checks 
FDIBA2009: checks 
*** TURN *** [5d Ad As] [8h]
s70n3fac3: checks 
FDIBA2009: bets 378
s70n3fac3: folds 
Uncalled bet (378) returned to FDIBA2009
FDIBA2009 collected 378 from pot
FDIBA2009: doesn't show hand 
*** SUMMARY ***
Total pot 400 | Rake 22 
Board [5d Ad As 8h]
Seat 1: s70n3fac3 (big blind) folded on the Turn
Seat 2: FDIBA2009 (button) (small blind) collected (378)



PokerStars Home Game Hand #227250380245: {Club #4781089}  Hold'em No Limit (50/100) - 2021/06/01 23:38:55 EET [2021/06/01 16:38:55 ET]
Table 'VTPP NLHE 0106' 2-max (Play Money) Seat #1 is the button
Seat 1: s70n3fac3 (18181 in chips) 
Seat 2: FDIBA2009 (23356 in chips) 
s70n3fac3: posts small blind 50
FDIBA2009: posts big blind 100
*** HOLE CARDS ***
s70n3fac3: raises 150 to 250
FDIBA2009: calls 150
*** FLOP *** [3d 5c Jh]
FDIBA2009: checks 
s70n3fac3: bets 300
FDIBA2009: folds 
Uncalled bet (300) returned to s70n3fac3
s70n3fac3 collected 472 from pot
s70n3fac3: doesn't show hand 
*** SUMMARY ***
Total pot 500 | Rake 28 
Board [3d 5c Jh]
Seat 1: s70n3fac3 (button) (small blind) collected (472)
Seat 2: FDIBA2009 (big blind) folded on the Flop



PokerStars Home Game Hand #227250388077: {Club #4781089}  Hold'em No Limit (50/100) - 2021/06/01 23:39:11 EET [2021/06/01 16:39:11 ET]
Table 'VTPP NLHE 0106' 2-max (Play Money) Seat #2 is the button
Seat 1: s70n3fac3 (18403 in chips) 
Seat 2: FDIBA2009 (23106 in chips) 
FDIBA2009: posts small blind 50
s70n3fac3: posts big blind 100
*** HOLE CARDS ***
FDIBA2009: raises 100 to 200
s70n3fac3: calls 100
*** FLOP *** [Td Tc Jd]
s70n3fac3: checks 
FDIBA2009: bets 200
s70n3fac3: folds 
Uncalled bet (200) returned to FDIBA2009
FDIBA2009 collected 378 from pot
FDIBA2009: doesn't show hand 
*** SUMMARY ***
Total pot 400 | Rake 22 
Board [Td Tc Jd]
Seat 1: s70n3fac3 (big blind) folded on the Flop
Seat 2: FDIBA2009 (button) (small blind) collected (378)



PokerStars Home Game Hand #227250394101: {Club #4781089}  Hold'em No Limit (50/100) - 2021/06/01 23:39:22 EET [2021/06/01 16:39:22 ET]
Table 'VTPP NLHE 0106' 2-max (Play Money) Seat #1 is the button
Seat 1: s70n3fac3 (18203 in chips) 
Seat 2: FDIBA2009 (23284 in chips) 
s70n3fac3: posts small blind 50
FDIBA2009: posts big blind 100
*** HOLE CARDS ***
s70n3fac3: raises 150 to 250
FDIBA2009: folds 
Uncalled bet (150) returned to s70n3fac3
s70n3fac3 collected 200 from pot
s70n3fac3: doesn't show hand 
*** SUMMARY ***
Total pot 200 | Rake 0 
Seat 1: s70n3fac3 (button) (small blind) collected (200)
Seat 2: FDIBA2009 (big blind) folded before Flop



PokerStars Home Game Hand #227250396988: {Club #4781089}  Hold'em No Limit (50/100) - 2021/06/01 23:39:28 EET [2021/06/01 16:39:28 ET]
Table 'VTPP NLHE 0106' 2-max (Play Money) Seat #2 is the button
Seat 1: s70n3fac3 (18303 in chips) 
Seat 2: FDIBA2009 (23184 in chips) 
FDIBA2009: posts small blind 50
s70n3fac3: posts big blind 100
*** HOLE CARDS ***
FDIBA2009: calls 50
s70n3fac3: checks 
*** FLOP *** [2s Qs Jh]
s70n3fac3: checks 
FDIBA2009: bets 189
s70n3fac3: calls 189
*** TURN *** [2s Qs Jh] [3d]
s70n3fac3: checks 
FDIBA2009: checks 
*** RIVER *** [2s Qs Jh 3d] [3s]
s70n3fac3: bets 546
FDIBA2009: calls 546
*** SHOW DOWN ***
s70n3fac3: shows [3h 9h] (three of a kind, Threes)
FDIBA2009: mucks hand 
s70n3fac3 collected 1578 from pot
*** SUMMARY ***
Total pot 1670 | Rake 92 
Board [2s Qs Jh 3d 3s]
Seat 1: s70n3fac3 (big blind) showed [3h 9h] and won (1578) with three of a kind, Threes
Seat 2: FDIBA2009 (button) (small blind) mucked [Qh 4h]



PokerStars Home Game Hand #227250405464: {Club #4781089}  Hold'em No Limit (50/100) - 2021/06/01 23:39:44 EET [2021/06/01 16:39:44 ET]
Table 'VTPP NLHE 0106' 2-max (Play Money) Seat #1 is the button
Seat 1: s70n3fac3 (19046 in chips) 
Seat 2: FDIBA2009 (22349 in chips) 
s70n3fac3: posts small blind 50
FDIBA2009: posts big blind 100
*** HOLE CARDS ***
s70n3fac3: raises 150 to 250
FDIBA2009: raises 500 to 750
s70n3fac3: calls 500
*** FLOP *** [Ah Js 8c]
FDIBA2009: checks 
s70n3fac3: checks 
*** TURN *** [Ah Js 8c] [Kd]
FDIBA2009: checks 
s70n3fac3: checks 
*** RIVER *** [Ah Js 8c Kd] [3h]
FDIBA2009: bets 750
s70n3fac3: folds 
Uncalled bet (750) returned to FDIBA2009
FDIBA2009 collected 1417 from pot
FDIBA2009: doesn't show hand 
*** SUMMARY ***
Total pot 1500 | Rake 83 
Board [Ah Js 8c Kd 3h]
Seat 1: s70n3fac3 (button) (small blind) folded on the River
Seat 2: FDIBA2009 (big blind) collected (1417)



PokerStars Home Game Hand #227250421612: {Club #4781089}  Hold'em No Limit (50/100) - 2021/06/01 23:40:16 EET [2021/06/01 16:40:16 ET]
Table 'VTPP NLHE 0106' 2-max (Play Money) Seat #2 is the button
Seat 1: s70n3fac3 (18296 in chips) 
Seat 2: FDIBA2009 (23016 in chips) 
FDIBA2009: posts small blind 50
s70n3fac3: posts big blind 100
*** HOLE CARDS ***
FDIBA2009: raises 100 to 200
s70n3fac3: folds 
Uncalled bet (100) returned to FDIBA2009
FDIBA2009 collected 200 from pot
FDIBA2009: doesn't show hand 
*** SUMMARY ***
Total pot 200 | Rake 0 
Seat 1: s70n3fac3 (big blind) folded before Flop
Seat 2: FDIBA2009 (button) (small blind) collected (200)



PokerStars Home Game Hand #227250424540: {Club #4781089}  Hold'em No Limit (50/100) - 2021/06/01 23:40:21 EET [2021/06/01 16:40:21 ET]
Table 'VTPP NLHE 0106' 2-max (Play Money) Seat #1 is the button
Seat 1: s70n3fac3 (18196 in chips) 
Seat 2: FDIBA2009 (23116 in chips) 
s70n3fac3: posts small blind 50
FDIBA2009: posts big blind 100
*** HOLE CARDS ***
s70n3fac3: calls 50
FDIBA2009: raises 200 to 300
s70n3fac3: calls 200
*** FLOP *** [6s 9c 3c]
FDIBA2009: bets 400
s70n3fac3: calls 400
*** TURN *** [6s 9c 3c] [5c]
FDIBA2009: bets 1050
s70n3fac3: folds 
Uncalled bet (1050) returned to FDIBA2009
FDIBA2009 collected 1323 from pot
FDIBA2009: doesn't show hand 
*** SUMMARY ***
Total pot 1400 | Rake 77 
Board [6s 9c 3c 5c]
Seat 1: s70n3fac3 (button) (small blind) folded on the Turn
Seat 2: FDIBA2009 (big blind) collected (1323)



PokerStars Home Game Hand #227250439414: {Club #4781089}  Hold'em No Limit (50/100) - 2021/06/01 23:40:50 EET [2021/06/01 16:40:50 ET]
Table 'VTPP NLHE 0106' 2-max (Play Money) Seat #2 is the button
Seat 1: s70n3fac3 (17496 in chips) 
Seat 2: FDIBA2009 (23739 in chips) 
FDIBA2009: posts small blind 50
s70n3fac3: posts big blind 100
*** HOLE CARDS ***
FDIBA2009: raises 100 to 200
s70n3fac3: folds 
Uncalled bet (100) returned to FDIBA2009
FDIBA2009 collected 200 from pot
FDIBA2009: doesn't show hand 
*** SUMMARY ***
Total pot 200 | Rake 0 
Seat 1: s70n3fac3 (big blind) folded before Flop
Seat 2: FDIBA2009 (button) (small blind) collected (200)



PokerStars Home Game Hand #227250442487: {Club #4781089}  Hold'em No Limit (50/100) - 2021/06/01 23:40:56 EET [2021/06/01 16:40:56 ET]
Table 'VTPP NLHE 0106' 2-max (Play Money) Seat #1 is the button
Seat 1: s70n3fac3 (17396 in chips) 
Seat 2: FDIBA2009 (23839 in chips) 
s70n3fac3: posts small blind 50
FDIBA2009: posts big blind 100
*** HOLE CARDS ***
s70n3fac3: calls 50
FDIBA2009: checks 
*** FLOP *** [Td 6d 6c]
FDIBA2009: checks 
s70n3fac3: checks 
*** TURN *** [Td 6d 6c] [Jd]
FDIBA2009: checks 
s70n3fac3: checks 
*** RIVER *** [Td 6d 6c Jd] [9s]
FDIBA2009: bets 400
s70n3fac3: folds 
Uncalled bet (400) returned to FDIBA2009
FDIBA2009 collected 189 from pot
FDIBA2009: doesn't show hand 
*** SUMMARY ***
Total pot 200 | Rake 11 
Board [Td 6d 6c Jd 9s]
Seat 1: s70n3fac3 (button) (small blind) folded on the River
Seat 2: FDIBA2009 (big blind) collected (189)



PokerStars Home Game Hand #227250452431: {Club #4781089}  Hold'em No Limit (50/100) - 2021/06/01 23:41:15 EET [2021/06/01 16:41:15 ET]
Table 'VTPP NLHE 0106' 2-max (Play Money) Seat #2 is the button
Seat 1: s70n3fac3 (17296 in chips) 
Seat 2: FDIBA2009 (23928 in chips) 
FDIBA2009: posts small blind 50
s70n3fac3: posts big blind 100
*** HOLE CARDS ***
FDIBA2009: raises 100 to 200
s70n3fac3: calls 100
*** FLOP *** [3h Ts Qh]
s70n3fac3: checks 
FDIBA2009: bets 200
s70n3fac3: calls 200
*** TURN *** [3h Ts Qh] [3c]
s70n3fac3: checks 
FDIBA2009: checks 
*** RIVER *** [3h Ts Qh 3c] [Tc]
s70n3fac3: checks 
FDIBA2009: checks 
*** SHOW DOWN ***
s70n3fac3: shows [5h 5s] (two pair, Tens and Fives)
FDIBA2009: mucks hand 
s70n3fac3 collected 756 from pot
*** SUMMARY ***
Total pot 800 | Rake 44 
Board [3h Ts Qh 3c Tc]
Seat 1: s70n3fac3 (big blind) showed [5h 5s] and won (756) with two pair, Tens and Fives
Seat 2: FDIBA2009 (button) (small blind) mucked [8c 2c]



PokerStars Home Game Hand #227250461400: {Club #4781089}  Hold'em No Limit (50/100) - 2021/06/01 23:41:32 EET [2021/06/01 16:41:32 ET]
Table 'VTPP NLHE 0106' 2-max (Play Money) Seat #1 is the button
Seat 1: s70n3fac3 (17652 in chips) 
Seat 2: FDIBA2009 (23528 in chips) 
s70n3fac3: posts small blind 50
FDIBA2009: posts big blind 100
*** HOLE CARDS ***
s70n3fac3: calls 50
FDIBA2009: checks 
*** FLOP *** [Qd 6s 2h]
FDIBA2009: checks 
s70n3fac3: bets 200
FDIBA2009: raises 589 to 789
s70n3fac3: calls 589
*** TURN *** [Qd 6s 2h] [Tc]
FDIBA2009: checks 
s70n3fac3: checks 
*** RIVER *** [Qd 6s 2h Tc] [5d]
FDIBA2009: bets 950
s70n3fac3: folds 
Uncalled bet (950) returned to FDIBA2009
FDIBA2009 collected 1680 from pot
FDIBA2009: doesn't show hand 
*** SUMMARY ***
Total pot 1778 | Rake 98 
Board [Qd 6s 2h Tc 5d]
Seat 1: s70n3fac3 (button) (small blind) folded on the River
Seat 2: FDIBA2009 (big blind) collected (1680)



PokerStars Home Game Hand #227250480557: {Club #4781089}  Hold'em No Limit (50/100) - 2021/06/01 23:42:09 EET [2021/06/01 16:42:09 ET]
Table 'VTPP NLHE 0106' 2-max (Play Money) Seat #2 is the button
Seat 1: s70n3fac3 (16763 in chips) 
Seat 2: FDIBA2009 (24319 in chips) 
FDIBA2009: posts small blind 50
s70n3fac3: posts big blind 100
*** HOLE CARDS ***
FDIBA2009: raises 100 to 200
s70n3fac3: calls 100
*** FLOP *** [7c Jc Qs]
s70n3fac3: checks 
FDIBA2009: bets 200
s70n3fac3: folds 
Uncalled bet (200) returned to FDIBA2009
FDIBA2009 collected 378 from pot
FDIBA2009: doesn't show hand 
*** SUMMARY ***
Total pot 400 | Rake 22 
Board [7c Jc Qs]
Seat 1: s70n3fac3 (big blind) folded on the Flop
Seat 2: FDIBA2009 (button) (small blind) collected (378)



PokerStars Home Game Hand #227250486593: {Club #4781089}  Hold'em No Limit (50/100) - 2021/06/01 23:42:21 EET [2021/06/01 16:42:21 ET]
Table 'VTPP NLHE 0106' 2-max (Play Money) Seat #1 is the button
Seat 1: s70n3fac3 (16563 in chips) 
Seat 2: FDIBA2009 (24497 in chips) 
s70n3fac3: posts small blind 50
FDIBA2009: posts big blind 100
*** HOLE CARDS ***
s70n3fac3: folds 
Uncalled bet (50) returned to FDIBA2009
FDIBA2009 collected 100 from pot
FDIBA2009: doesn't show hand 
*** SUMMARY ***
Total pot 100 | Rake 0 
Seat 1: s70n3fac3 (button) (small blind) folded before Flop
Seat 2: FDIBA2009 (big blind) collected (100)



PokerStars Home Game Hand #227250488547: {Club #4781089}  Hold'em No Limit (50/100) - 2021/06/01 23:42:25 EET [2021/06/01 16:42:25 ET]
Table 'VTPP NLHE 0106' 2-max (Play Money) Seat #2 is the button
Seat 1: s70n3fac3 (16513 in chips) 
Seat 2: FDIBA2009 (24547 in chips) 
FDIBA2009: posts small blind 50
s70n3fac3: posts big blind 100
*** HOLE CARDS ***
FDIBA2009: raises 100 to 200
s70n3fac3: folds 
Uncalled bet (100) returned to FDIBA2009
FDIBA2009 collected 200 from pot
FDIBA2009: doesn't show hand 
*** SUMMARY ***
Total pot 200 | Rake 0 
Seat 1: s70n3fac3 (big blind) folded before Flop
Seat 2: FDIBA2009 (button) (small blind) collected (200)



PokerStars Home Game Hand #227250491947: {Club #4781089}  Hold'em No Limit (50/100) - 2021/06/01 23:42:32 EET [2021/06/01 16:42:32 ET]
Table 'VTPP NLHE 0106' 2-max (Play Money) Seat #1 is the button
Seat 1: s70n3fac3 (16413 in chips) 
Seat 2: FDIBA2009 (24647 in chips) 
s70n3fac3: posts small blind 50
FDIBA2009: posts big blind 100
*** HOLE CARDS ***
s70n3fac3: raises 150 to 250
FDIBA2009: calls 150
*** FLOP *** [5s Tc Jd]
FDIBA2009: checks 
s70n3fac3: checks 
*** TURN *** [5s Tc Jd] [Ts]
FDIBA2009: checks 
s70n3fac3: bets 300
FDIBA2009: folds 
Uncalled bet (300) returned to s70n3fac3
s70n3fac3 collected 472 from pot
s70n3fac3: doesn't show hand 
*** SUMMARY ***
Total pot 500 | Rake 28 
Board [5s Tc Jd Ts]
Seat 1: s70n3fac3 (button) (small blind) collected (472)
Seat 2: FDIBA2009 (big blind) folded on the Turn



PokerStars Home Game Hand #227250499737: {Club #4781089}  Hold'em No Limit (50/100) - 2021/06/01 23:42:47 EET [2021/06/01 16:42:47 ET]
Table 'VTPP NLHE 0106' 2-max (Play Money) Seat #2 is the button
Seat 1: s70n3fac3 (16635 in chips) 
Seat 2: FDIBA2009 (24397 in chips) 
FDIBA2009: posts small blind 50
s70n3fac3: posts big blind 100
*** HOLE CARDS ***
FDIBA2009: raises 100 to 200
s70n3fac3: folds 
Uncalled bet (100) returned to FDIBA2009
FDIBA2009 collected 200 from pot
FDIBA2009: doesn't show hand 
*** SUMMARY ***
Total pot 200 | Rake 0 
Seat 1: s70n3fac3 (big blind) folded before Flop
Seat 2: FDIBA2009 (button) (small blind) collected (200)



PokerStars Home Game Hand #227250502636: {Club #4781089}  Hold'em No Limit (50/100) - 2021/06/01 23:42:53 EET [2021/06/01 16:42:53 ET]
Table 'VTPP NLHE 0106' 2-max (Play Money) Seat #1 is the button
Seat 1: s70n3fac3 (16535 in chips) 
Seat 2: FDIBA2009 (24497 in chips) 
s70n3fac3: posts small blind 50
FDIBA2009: posts big blind 100
*** HOLE CARDS ***
s70n3fac3: raises 150 to 250
FDIBA2009: calls 150
*** FLOP *** [Qh 2s 6c]
FDIBA2009: checks 
s70n3fac3: checks 
*** TURN *** [Qh 2s 6c] [Tc]
FDIBA2009: checks 
s70n3fac3: bets 300
FDIBA2009: calls 300
*** RIVER *** [Qh 2s 6c Tc] [7c]
FDIBA2009: checks 
s70n3fac3: bets 800
FDIBA2009: calls 800
*** SHOW DOWN ***
s70n3fac3: shows [8c Kc] (a flush, King high)
FDIBA2009: mucks hand 
s70n3fac3 collected 2551 from pot
*** SUMMARY ***
Total pot 2700 | Rake 149 
Board [Qh 2s 6c Tc 7c]
Seat 1: s70n3fac3 (button) (small blind) showed [8c Kc] and won (2551) with a flush, King high
Seat 2: FDIBA2009 (big blind) mucked [Ah Ad]



PokerStars Home Game Hand #227250515628: {Club #4781089}  Hold'em No Limit (50/100) - 2021/06/01 23:43:18 EET [2021/06/01 16:43:18 ET]
Table 'VTPP NLHE 0106' 2-max (Play Money) Seat #2 is the button
Seat 1: s70n3fac3 (17736 in chips) 
Seat 2: FDIBA2009 (23147 in chips) 
FDIBA2009: posts small blind 50
s70n3fac3: posts big blind 100
*** HOLE CARDS ***
FDIBA2009: raises 200 to 300
s70n3fac3: calls 200
*** FLOP *** [Jd 5h 3d]
s70n3fac3: checks 
FDIBA2009: bets 450
s70n3fac3: folds 
Uncalled bet (450) returned to FDIBA2009
FDIBA2009 collected 567 from pot
FDIBA2009: doesn't show hand 
*** SUMMARY ***
Total pot 600 | Rake 33 
Board [Jd 5h 3d]
Seat 1: s70n3fac3 (big blind) folded on the Flop
Seat 2: FDIBA2009 (button) (small blind) collected (567)



PokerStars Home Game Hand #227250524331: {Club #4781089}  Hold'em No Limit (50/100) - 2021/06/01 23:43:35 EET [2021/06/01 16:43:35 ET]
Table 'VTPP NLHE 0106' 2-max (Play Money) Seat #1 is the button
Seat 1: s70n3fac3 (17436 in chips) 
Seat 2: FDIBA2009 (23414 in chips) 
s70n3fac3: posts small blind 50
FDIBA2009: posts big blind 100
*** HOLE CARDS ***
s70n3fac3: folds 
Uncalled bet (50) returned to FDIBA2009
FDIBA2009 collected 100 from pot
FDIBA2009: doesn't show hand 
*** SUMMARY ***
Total pot 100 | Rake 0 
Seat 1: s70n3fac3 (button) (small blind) folded before Flop
Seat 2: FDIBA2009 (big blind) collected (100)



PokerStars Home Game Hand #227250526128: {Club #4781089}  Hold'em No Limit (50/100) - 2021/06/01 23:43:39 EET [2021/06/01 16:43:39 ET]
Table 'VTPP NLHE 0106' 2-max (Play Money) Seat #2 is the button
Seat 1: s70n3fac3 (17386 in chips) 
Seat 2: FDIBA2009 (23464 in chips) 
FDIBA2009: posts small blind 50
s70n3fac3: posts big blind 100
*** HOLE CARDS ***
FDIBA2009: raises 100 to 200
s70n3fac3: raises 400 to 600
FDIBA2009: folds 
Uncalled bet (400) returned to s70n3fac3
s70n3fac3 collected 400 from pot
s70n3fac3: doesn't show hand 
*** SUMMARY ***
Total pot 400 | Rake 0 
Seat 1: s70n3fac3 (big blind) collected (400)
Seat 2: FDIBA2009 (button) (small blind) folded before Flop



PokerStars Home Game Hand #227250530574: {Club #4781089}  Hold'em No Limit (50/100) - 2021/06/01 23:43:47 EET [2021/06/01 16:43:47 ET]
Table 'VTPP NLHE 0106' 2-max (Play Money) Seat #1 is the button
Seat 1: s70n3fac3 (17586 in chips) 
Seat 2: FDIBA2009 (23264 in chips) 
s70n3fac3: posts small blind 50
FDIBA2009: posts big blind 100
*** HOLE CARDS ***
s70n3fac3: raises 150 to 250
FDIBA2009: calls 150
*** FLOP *** [2d Jc 2c]
FDIBA2009: checks 
s70n3fac3: checks 
*** TURN *** [2d Jc 2c] [4c]
FDIBA2009: bets 300
s70n3fac3: folds 
Uncalled bet (300) returned to FDIBA2009
FDIBA2009 collected 472 from pot
FDIBA2009: doesn't show hand 
*** SUMMARY ***
Total pot 500 | Rake 28 
Board [2d Jc 2c 4c]
Seat 1: s70n3fac3 (button) (small blind) folded on the Turn
Seat 2: FDIBA2009 (big blind) collected (472)



PokerStars Home Game Hand #227250538535: {Club #4781089}  Hold'em No Limit (50/100) - 2021/06/01 23:44:03 EET [2021/06/01 16:44:03 ET]
Table 'VTPP NLHE 0106' 2-max (Play Money) Seat #2 is the button
Seat 1: s70n3fac3 (17336 in chips) 
Seat 2: FDIBA2009 (23486 in chips) 
FDIBA2009: posts small blind 50
s70n3fac3: posts big blind 100
*** HOLE CARDS ***
FDIBA2009: raises 100 to 200
s70n3fac3: calls 100
*** FLOP *** [8d Jc 9d]
s70n3fac3: checks 
FDIBA2009: bets 250
s70n3fac3: calls 250
*** TURN *** [8d Jc 9d] [3s]
s70n3fac3: checks 
FDIBA2009: bets 600
s70n3fac3: calls 600
*** RIVER *** [8d Jc 9d 3s] [Qs]
s70n3fac3: checks 
FDIBA2009: bets 1050
s70n3fac3: folds 
Uncalled bet (1050) returned to FDIBA2009
FDIBA2009 collected 1984 from pot
FDIBA2009: doesn't show hand 
*** SUMMARY ***
Total pot 2100 | Rake 116 
Board [8d Jc 9d 3s Qs]
Seat 1: s70n3fac3 (big blind) folded on the River
Seat 2: FDIBA2009 (button) (small blind) collected (1984)



PokerStars Home Game Hand #227250556589: {Club #4781089}  Hold'em No Limit (50/100) - 2021/06/01 23:44:39 EET [2021/06/01 16:44:39 ET]
Table 'VTPP NLHE 0106' 2-max (Play Money) Seat #1 is the button
Seat 1: s70n3fac3 (16286 in chips) 
Seat 2: FDIBA2009 (24420 in chips) 
s70n3fac3: posts small blind 50
FDIBA2009: posts big blind 100
*** HOLE CARDS ***
s70n3fac3: raises 150 to 250
FDIBA2009: folds 
Uncalled bet (150) returned to s70n3fac3
s70n3fac3 collected 200 from pot
s70n3fac3: doesn't show hand 
*** SUMMARY ***
Total pot 200 | Rake 0 
Seat 1: s70n3fac3 (button) (small blind) collected (200)
Seat 2: FDIBA2009 (big blind) folded before Flop



PokerStars Home Game Hand #227250559289: {Club #4781089}  Hold'em No Limit (50/100) - 2021/06/01 23:44:44 EET [2021/06/01 16:44:44 ET]
Table 'VTPP NLHE 0106' 2-max (Play Money) Seat #2 is the button
Seat 1: s70n3fac3 (16386 in chips) 
Seat 2: FDIBA2009 (24320 in chips) 
FDIBA2009: posts small blind 50
s70n3fac3: posts big blind 100
*** HOLE CARDS ***
FDIBA2009: raises 100 to 200
s70n3fac3: calls 100
*** FLOP *** [Ks 5c Qd]
s70n3fac3: checks 
FDIBA2009: checks 
*** TURN *** [Ks 5c Qd] [Ad]
s70n3fac3: checks 
FDIBA2009: checks 
*** RIVER *** [Ks 5c Qd Ad] [8s]
s70n3fac3: bets 200
FDIBA2009: calls 200
*** SHOW DOWN ***
s70n3fac3: shows [7s 8c] (a pair of Eights)
FDIBA2009: shows [8h 7c] (a pair of Eights)
s70n3fac3 collected 378 from pot
FDIBA2009 collected 378 from pot
*** SUMMARY ***
Total pot 800 | Rake 44 
Board [Ks 5c Qd Ad 8s]
Seat 1: s70n3fac3 (big blind) showed [7s 8c] and won (378) with a pair of Eights
Seat 2: FDIBA2009 (button) (small blind) showed [8h 7c] and won (378) with a pair of Eights



PokerStars Home Game Hand #227250566242: {Club #4781089}  Hold'em No Limit (50/100) - 2021/06/01 23:44:58 EET [2021/06/01 16:44:58 ET]
Table 'VTPP NLHE 0106' 2-max (Play Money) Seat #1 is the button
Seat 1: s70n3fac3 (16364 in chips) 
Seat 2: FDIBA2009 (24298 in chips) 
s70n3fac3: posts small blind 50
FDIBA2009: posts big blind 100
*** HOLE CARDS ***
s70n3fac3: folds 
Uncalled bet (50) returned to FDIBA2009
FDIBA2009 collected 100 from pot
FDIBA2009: doesn't show hand 
*** SUMMARY ***
Total pot 100 | Rake 0 
Seat 1: s70n3fac3 (button) (small blind) folded before Flop
Seat 2: FDIBA2009 (big blind) collected (100)



PokerStars Home Game Hand #227250568182: {Club #4781089}  Hold'em No Limit (50/100) - 2021/06/01 23:45:02 EET [2021/06/01 16:45:02 ET]
Table 'VTPP NLHE 0106' 2-max (Play Money) Seat #2 is the button
Seat 1: s70n3fac3 (16314 in chips) 
Seat 2: FDIBA2009 (24348 in chips) 
FDIBA2009: posts small blind 50
s70n3fac3: posts big blind 100
*** HOLE CARDS ***
FDIBA2009: raises 100 to 200
s70n3fac3: raises 400 to 600
FDIBA2009: calls 400
*** FLOP *** [7c Jh 8d]
s70n3fac3: checks 
FDIBA2009: checks 
*** TURN *** [7c Jh 8d] [Kd]
s70n3fac3: checks 
FDIBA2009: bets 600
s70n3fac3: calls 600
*** RIVER *** [7c Jh 8d Kd] [4s]
s70n3fac3: checks 
FDIBA2009: bets 1700
s70n3fac3: raises 2600 to 4300
FDIBA2009: folds 
Uncalled bet (2600) returned to s70n3fac3
s70n3fac3 collected 5481 from pot
s70n3fac3: doesn't show hand 
*** SUMMARY ***
Total pot 5800 | Rake 319 
Board [7c Jh 8d Kd 4s]
Seat 1: s70n3fac3 (big blind) collected (5481)
Seat 2: FDIBA2009 (button) (small blind) folded on the River



PokerStars Home Game Hand #227250592821: {Club #4781089}  Hold'em No Limit (50/100) - 2021/06/01 23:45:49 EET [2021/06/01 16:45:49 ET]
Table 'VTPP NLHE 0106' 2-max (Play Money) Seat #1 is the button
Seat 1: s70n3fac3 (18895 in chips) 
Seat 2: FDIBA2009 (21448 in chips) 
s70n3fac3: posts small blind 50
FDIBA2009: posts big blind 100
*** HOLE CARDS ***
s70n3fac3: calls 50
FDIBA2009: raises 200 to 300
s70n3fac3: calls 200
*** FLOP *** [2s 4d 7c]
FDIBA2009: checks 
s70n3fac3: checks 
*** TURN *** [2s 4d 7c] [9h]
FDIBA2009: bets 450
s70n3fac3: calls 450
*** RIVER *** [2s 4d 7c 9h] [6h]
FDIBA2009: checks 
s70n3fac3: bets 1100
FDIBA2009: calls 1100
*** SHOW DOWN ***
s70n3fac3: shows [2c 2d] (three of a kind, Deuces)
FDIBA2009: mucks hand 
s70n3fac3 collected 3496 from pot
*** SUMMARY ***
Total pot 3700 | Rake 204 
Board [2s 4d 7c 9h 6h]
Seat 1: s70n3fac3 (button) (small blind) showed [2c 2d] and won (3496) with three of a kind, Deuces
Seat 2: FDIBA2009 (big blind) mucked [9s Th]



PokerStars Home Game Hand #227250608261: {Club #4781089}  Hold'em No Limit (50/100) - 2021/06/01 23:46:19 EET [2021/06/01 16:46:19 ET]
Table 'VTPP NLHE 0106' 2-max (Play Money) Seat #2 is the button
Seat 1: s70n3fac3 (20541 in chips) 
Seat 2: FDIBA2009 (19598 in chips) 
FDIBA2009: posts small blind 50
s70n3fac3: posts big blind 100
*** HOLE CARDS ***
FDIBA2009: raises 100 to 200
s70n3fac3: calls 100
*** FLOP *** [2s 5s Kh]
s70n3fac3: checks 
FDIBA2009: checks 
*** TURN *** [2s 5s Kh] [Jd]
s70n3fac3: checks 
FDIBA2009: checks 
*** RIVER *** [2s 5s Kh Jd] [7s]
s70n3fac3: checks 
FDIBA2009: bets 378
s70n3fac3: folds 
Uncalled bet (378) returned to FDIBA2009
FDIBA2009 collected 378 from pot
FDIBA2009: doesn't show hand 
*** SUMMARY ***
Total pot 400 | Rake 22 
Board [2s 5s Kh Jd 7s]
Seat 1: s70n3fac3 (big blind) folded on the River
Seat 2: FDIBA2009 (button) (small blind) collected (378)



PokerStars Home Game Hand #227250617642: {Club #4781089}  Hold'em No Limit (50/100) - 2021/06/01 23:46:37 EET [2021/06/01 16:46:37 ET]
Table 'VTPP NLHE 0106' 2-max (Play Money) Seat #1 is the button
Seat 1: s70n3fac3 (20341 in chips) 
Seat 2: FDIBA2009 (19776 in chips) 
s70n3fac3: posts small blind 50
FDIBA2009: posts big blind 100
*** HOLE CARDS ***
s70n3fac3: folds 
Uncalled bet (50) returned to FDIBA2009
FDIBA2009 collected 100 from pot
FDIBA2009: doesn't show hand 
*** SUMMARY ***
Total pot 100 | Rake 0 
Seat 1: s70n3fac3 (button) (small blind) folded before Flop
Seat 2: FDIBA2009 (big blind) collected (100)



PokerStars Home Game Hand #227250619643: {Club #4781089}  Hold'em No Limit (50/100) - 2021/06/01 23:46:41 EET [2021/06/01 16:46:41 ET]
Table 'VTPP NLHE 0106' 2-max (Play Money) Seat #2 is the button
Seat 1: s70n3fac3 (20291 in chips) 
Seat 2: FDIBA2009 (19826 in chips) 
FDIBA2009: posts small blind 50
s70n3fac3: posts big blind 100
*** HOLE CARDS ***
FDIBA2009: folds 
Uncalled bet (50) returned to s70n3fac3
s70n3fac3 collected 100 from pot
s70n3fac3: doesn't show hand 
*** SUMMARY ***
Total pot 100 | Rake 0 
Seat 1: s70n3fac3 (big blind) collected (100)
Seat 2: FDIBA2009 (button) (small blind) folded before Flop



PokerStars Home Game Hand #227250622255: {Club #4781089}  Hold'em No Limit (50/100) - 2021/06/01 23:46:46 EET [2021/06/01 16:46:46 ET]
Table 'VTPP NLHE 0106' 2-max (Play Money) Seat #1 is the button
Seat 1: s70n3fac3 (20341 in chips) 
Seat 2: FDIBA2009 (19776 in chips) 
s70n3fac3: posts small blind 50
FDIBA2009: posts big blind 100
*** HOLE CARDS ***
s70n3fac3: raises 150 to 250
FDIBA2009: folds 
Uncalled bet (150) returned to s70n3fac3
s70n3fac3 collected 200 from pot
s70n3fac3: doesn't show hand 
*** SUMMARY ***
Total pot 200 | Rake 0 
Seat 1: s70n3fac3 (button) (small blind) collected (200)
Seat 2: FDIBA2009 (big blind) folded before Flop



PokerStars Home Game Hand #227250624978: {Club #4781089}  Hold'em No Limit (50/100) - 2021/06/01 23:46:51 EET [2021/06/01 16:46:51 ET]
Table 'VTPP NLHE 0106' 2-max (Play Money) Seat #2 is the button
Seat 1: s70n3fac3 (20441 in chips) 
Seat 2: FDIBA2009 (19676 in chips) 
FDIBA2009: posts small blind 50
s70n3fac3: posts big blind 100
*** HOLE CARDS ***
FDIBA2009: raises 100 to 200
s70n3fac3: folds 
Uncalled bet (100) returned to FDIBA2009
FDIBA2009 collected 200 from pot
FDIBA2009: doesn't show hand 
*** SUMMARY ***
Total pot 200 | Rake 0 
Seat 1: s70n3fac3 (big blind) folded before Flop
Seat 2: FDIBA2009 (button) (small blind) collected (200)



PokerStars Home Game Hand #227250627916: {Club #4781089}  Hold'em No Limit (50/100) - 2021/06/01 23:46:57 EET [2021/06/01 16:46:57 ET]
Table 'VTPP NLHE 0106' 2-max (Play Money) Seat #1 is the button
Seat 1: s70n3fac3 (20341 in chips) 
Seat 2: FDIBA2009 (19776 in chips) 
s70n3fac3: posts small blind 50
FDIBA2009: posts big blind 100
*** HOLE CARDS ***
s70n3fac3: raises 150 to 250
FDIBA2009: calls 150
*** FLOP *** [7c 8c 5s]
FDIBA2009: checks 
s70n3fac3: bets 300
FDIBA2009: folds 
Uncalled bet (300) returned to s70n3fac3
s70n3fac3 collected 472 from pot
s70n3fac3: doesn't show hand 
*** SUMMARY ***
Total pot 500 | Rake 28 
Board [7c 8c 5s]
Seat 1: s70n3fac3 (button) (small blind) collected (472)
Seat 2: FDIBA2009 (big blind) folded on the Flop



PokerStars Home Game Hand #227250633027: {Club #4781089}  Hold'em No Limit (50/100) - 2021/06/01 23:47:07 EET [2021/06/01 16:47:07 ET]
Table 'VTPP NLHE 0106' 2-max (Play Money) Seat #2 is the button
Seat 1: s70n3fac3 (20563 in chips) 
Seat 2: FDIBA2009 (19526 in chips) 
FDIBA2009: posts small blind 50
s70n3fac3: posts big blind 100
*** HOLE CARDS ***
FDIBA2009: raises 100 to 200
s70n3fac3: raises 400 to 600
FDIBA2009: folds 
Uncalled bet (400) returned to s70n3fac3
s70n3fac3 collected 400 from pot
s70n3fac3: doesn't show hand 
*** SUMMARY ***
Total pot 400 | Rake 0 
Seat 1: s70n3fac3 (big blind) collected (400)
Seat 2: FDIBA2009 (button) (small blind) folded before Flop



PokerStars Home Game Hand #227250637212: {Club #4781089}  Hold'em No Limit (50/100) - 2021/06/01 23:47:15 EET [2021/06/01 16:47:15 ET]
Table 'VTPP NLHE 0106' 2-max (Play Money) Seat #1 is the button
Seat 1: s70n3fac3 (20763 in chips) 
Seat 2: FDIBA2009 (19326 in chips) 
s70n3fac3: posts small blind 50
FDIBA2009: posts big blind 100
*** HOLE CARDS ***
s70n3fac3: raises 150 to 250
FDIBA2009: calls 150
*** FLOP *** [2s 4c 8c]
FDIBA2009: checks 
s70n3fac3: checks 
*** TURN *** [2s 4c 8c] [6h]
FDIBA2009: bets 236
s70n3fac3: calls 236
*** RIVER *** [2s 4c 8c 6h] [Jd]
FDIBA2009: checks 
s70n3fac3: checks 
*** SHOW DOWN ***
FDIBA2009: shows [8s Ac] (a pair of Eights)
s70n3fac3: mucks hand 
FDIBA2009 collected 919 from pot
*** SUMMARY ***
Total pot 972 | Rake 53 
Board [2s 4c 8c 6h Jd]
Seat 1: s70n3fac3 (button) (small blind) mucked [Qs Ks]
Seat 2: FDIBA2009 (big blind) showed [8s Ac] and won (919) with a pair of Eights



PokerStars Home Game Hand #227250657245: {Club #4781089}  Hold'em No Limit (50/100) - 2021/06/01 23:47:35 EET [2021/06/01 16:47:35 ET]
Table 'VTPP NLHE 0106' 2-max (Play Money) Seat #2 is the button
Seat 1: s70n3fac3 (20277 in chips) 
Seat 2: FDIBA2009 (19759 in chips) 
FDIBA2009: posts small blind 50
s70n3fac3: posts big blind 100
*** HOLE CARDS ***
FDIBA2009: raises 100 to 200
s70n3fac3: calls 100
*** FLOP *** [3c Qd 7s]
s70n3fac3: checks 
FDIBA2009: bets 200
s70n3fac3: calls 200
*** TURN *** [3c Qd 7s] [5c]
s70n3fac3: checks 
FDIBA2009: bets 550
s70n3fac3: folds 
Uncalled bet (550) returned to FDIBA2009
FDIBA2009 collected 756 from pot
FDIBA2009: doesn't show hand 
*** SUMMARY ***
Total pot 800 | Rake 44 
Board [3c Qd 7s 5c]
Seat 1: s70n3fac3 (big blind) folded on the Turn
Seat 2: FDIBA2009 (button) (small blind) collected (756)



PokerStars Home Game Hand #227250668183: {Club #4781089}  Hold'em No Limit (50/100) - 2021/06/01 23:47:56 EET [2021/06/01 16:47:56 ET]
Table 'VTPP NLHE 0106' 2-max (Play Money) Seat #1 is the button
Seat 1: s70n3fac3 (19877 in chips) 
Seat 2: FDIBA2009 (20115 in chips) 
s70n3fac3: posts small blind 50
FDIBA2009: posts big blind 100
*** HOLE CARDS ***
s70n3fac3: raises 150 to 250
FDIBA2009: calls 150
*** FLOP *** [8d 6d 7h]
FDIBA2009: checks 
s70n3fac3: bets 300
FDIBA2009: calls 300
*** TURN *** [8d 6d 7h] [Qc]
FDIBA2009: checks 
s70n3fac3: checks 
*** RIVER *** [8d 6d 7h Qc] [Qh]
FDIBA2009: checks 
s70n3fac3: checks 
*** SHOW DOWN ***
FDIBA2009: shows [Ac 9d] (a pair of Queens)
s70n3fac3: shows [Ah 9h] (a pair of Queens)
FDIBA2009 collected 520 from pot
s70n3fac3 collected 519 from pot
*** SUMMARY ***
Total pot 1100 | Rake 61 
Board [8d 6d 7h Qc Qh]
Seat 1: s70n3fac3 (button) (small blind) showed [Ah 9h] and won (519) with a pair of Queens
Seat 2: FDIBA2009 (big blind) showed [Ac 9d] and won (520) with a pair of Queens



PokerStars Home Game Hand #227250680215: {Club #4781089}  Hold'em No Limit (50/100) - 2021/06/01 23:48:19 EET [2021/06/01 16:48:19 ET]
Table 'VTPP NLHE 0106' 2-max (Play Money) Seat #2 is the button
Seat 1: s70n3fac3 (19846 in chips) 
Seat 2: FDIBA2009 (20085 in chips) 
FDIBA2009: posts small blind 50
s70n3fac3: posts big blind 100
*** HOLE CARDS ***
FDIBA2009: raises 100 to 200
s70n3fac3: calls 100
*** FLOP *** [3c 5h 6s]
s70n3fac3: checks 
FDIBA2009: bets 378
s70n3fac3: calls 378
*** TURN *** [3c 5h 6s] [Qc]
s70n3fac3: checks 
FDIBA2009: checks 
*** RIVER *** [3c 5h 6s Qc] [Qh]
s70n3fac3: bets 546
FDIBA2009: calls 546
*** SHOW DOWN ***
s70n3fac3: shows [9c 6c] (two pair, Queens and Sixes)
FDIBA2009: mucks hand 
s70n3fac3 collected 2124 from pot
*** SUMMARY ***
Total pot 2248 | Rake 124 
Board [3c 5h 6s Qc Qh]
Seat 1: s70n3fac3 (big blind) showed [9c 6c] and won (2124) with two pair, Queens and Sixes
Seat 2: FDIBA2009 (button) (small blind) mucked [3h 9s]



PokerStars Home Game Hand #227250690792: {Club #4781089}  Hold'em No Limit (50/100) - 2021/06/01 23:48:40 EET [2021/06/01 16:48:40 ET]
Table 'VTPP NLHE 0106' 2-max (Play Money) Seat #1 is the button
Seat 1: s70n3fac3 (20846 in chips) 
Seat 2: FDIBA2009 (18961 in chips) 
s70n3fac3: posts small blind 50
FDIBA2009: posts big blind 100
*** HOLE CARDS ***
s70n3fac3: folds 
Uncalled bet (50) returned to FDIBA2009
FDIBA2009 collected 100 from pot
FDIBA2009: doesn't show hand 
*** SUMMARY ***
Total pot 100 | Rake 0 
Seat 1: s70n3fac3 (button) (small blind) folded before Flop
Seat 2: FDIBA2009 (big blind) collected (100)



PokerStars Home Game Hand #227250692694: {Club #4781089}  Hold'em No Limit (50/100) - 2021/06/01 23:48:44 EET [2021/06/01 16:48:44 ET]
Table 'VTPP NLHE 0106' 2-max (Play Money) Seat #2 is the button
Seat 1: s70n3fac3 (20796 in chips) 
Seat 2: FDIBA2009 (19011 in chips) 
FDIBA2009: posts small blind 50
s70n3fac3: posts big blind 100
*** HOLE CARDS ***
FDIBA2009: calls 50
s70n3fac3: checks 
*** FLOP *** [7d Td Kd]
s70n3fac3: checks 
FDIBA2009: bets 189
s70n3fac3: folds 
Uncalled bet (189) returned to FDIBA2009
FDIBA2009 collected 189 from pot
FDIBA2009: doesn't show hand 
*** SUMMARY ***
Total pot 200 | Rake 11 
Board [7d Td Kd]
Seat 1: s70n3fac3 (big blind) folded on the Flop
Seat 2: FDIBA2009 (button) (small blind) collected (189)



PokerStars Home Game Hand #227250698099: {Club #4781089}  Hold'em No Limit (50/100) - 2021/06/01 23:48:54 EET [2021/06/01 16:48:54 ET]
Table 'VTPP NLHE 0106' 2-max (Play Money) Seat #1 is the button
Seat 1: s70n3fac3 (20696 in chips) 
Seat 2: FDIBA2009 (19100 in chips) 
s70n3fac3: posts small blind 50
FDIBA2009: posts big blind 100
*** HOLE CARDS ***
s70n3fac3: raises 150 to 250
FDIBA2009: raises 150 to 400
s70n3fac3: calls 150
*** FLOP *** [2d 4h Kh]
FDIBA2009: bets 400
s70n3fac3: folds 
Uncalled bet (400) returned to FDIBA2009
FDIBA2009 collected 756 from pot
FDIBA2009: doesn't show hand 
*** SUMMARY ***
Total pot 800 | Rake 44 
Board [2d 4h Kh]
Seat 1: s70n3fac3 (button) (small blind) folded on the Flop
Seat 2: FDIBA2009 (big blind) collected (756)



PokerStars Home Game Hand #227250703814: {Club #4781089}  Hold'em No Limit (50/100) - 2021/06/01 23:49:05 EET [2021/06/01 16:49:05 ET]
Table 'VTPP NLHE 0106' 2-max (Play Money) Seat #2 is the button
Seat 1: s70n3fac3 (20296 in chips) 
Seat 2: FDIBA2009 (19456 in chips) 
FDIBA2009: posts small blind 50
s70n3fac3: posts big blind 100
*** HOLE CARDS ***
FDIBA2009: raises 100 to 200
s70n3fac3: calls 100
*** FLOP *** [7c 8h Qc]
s70n3fac3: checks 
FDIBA2009: bets 200
s70n3fac3: calls 200
*** TURN *** [7c 8h Qc] [4s]
s70n3fac3: checks 
FDIBA2009: checks 
*** RIVER *** [7c 8h Qc 4s] [Jd]
s70n3fac3: checks 
FDIBA2009: bets 378
s70n3fac3: folds 
Uncalled bet (378) returned to FDIBA2009
FDIBA2009 collected 756 from pot
FDIBA2009: doesn't show hand 
*** SUMMARY ***
Total pot 800 | Rake 44 
Board [7c 8h Qc 4s Jd]
Seat 1: s70n3fac3 (big blind) folded on the River
Seat 2: FDIBA2009 (button) (small blind) collected (756)



PokerStars Home Game Hand #227250714395: {Club #4781089}  Hold'em No Limit (50/100) - 2021/06/01 23:49:26 EET [2021/06/01 16:49:26 ET]
Table 'VTPP NLHE 0106' 2-max (Play Money) Seat #1 is the button
Seat 1: s70n3fac3 (19896 in chips) 
Seat 2: FDIBA2009 (19812 in chips) 
s70n3fac3: posts small blind 50
FDIBA2009: posts big blind 100
*** HOLE CARDS ***
s70n3fac3: calls 50
FDIBA2009: checks 
*** FLOP *** [2c 8s 2d]
FDIBA2009: checks 
s70n3fac3: checks 
*** TURN *** [2c 8s 2d] [9c]
FDIBA2009: bets 189
s70n3fac3: folds 
Uncalled bet (189) returned to FDIBA2009
FDIBA2009 collected 189 from pot
FDIBA2009: doesn't show hand 
*** SUMMARY ***
Total pot 200 | Rake 11 
Board [2c 8s 2d 9c]
Seat 1: s70n3fac3 (button) (small blind) folded on the Turn
Seat 2: FDIBA2009 (big blind) collected (189)



PokerStars Home Game Hand #227250721486: {Club #4781089}  Hold'em No Limit (50/100) - 2021/06/01 23:49:40 EET [2021/06/01 16:49:40 ET]
Table 'VTPP NLHE 0106' 2-max (Play Money) Seat #2 is the button
Seat 1: s70n3fac3 (19796 in chips) 
Seat 2: FDIBA2009 (19901 in chips) 
FDIBA2009: posts small blind 50
s70n3fac3: posts big blind 100
*** HOLE CARDS ***
FDIBA2009: raises 100 to 200
s70n3fac3: calls 100
*** FLOP *** [Tc 6s Kd]
s70n3fac3: checks 
FDIBA2009: checks 
*** TURN *** [Tc 6s Kd] [7s]
s70n3fac3: checks 
FDIBA2009: bets 200
s70n3fac3: calls 200
*** RIVER *** [Tc 6s Kd 7s] [Qs]
s70n3fac3: checks 
FDIBA2009: checks 
*** SHOW DOWN ***
s70n3fac3: shows [4c 3s] (high card King)
FDIBA2009: shows [2d Jc] (high card King - Queen+Jack kicker)
FDIBA2009 collected 756 from pot
*** SUMMARY ***
Total pot 800 | Rake 44 
Board [Tc 6s Kd 7s Qs]
Seat 1: s70n3fac3 (big blind) showed [4c 3s] and lost with high card King
Seat 2: FDIBA2009 (button) (small blind) showed [2d Jc] and won (756) with high card King



PokerStars Home Game Hand #227250730842: {Club #4781089}  Hold'em No Limit (50/100) - 2021/06/01 23:49:58 EET [2021/06/01 16:49:58 ET]
Table 'VTPP NLHE 0106' 2-max (Play Money) Seat #1 is the button
Seat 1: s70n3fac3 (19396 in chips) 
Seat 2: FDIBA2009 (20257 in chips) 
s70n3fac3: posts small blind 50
FDIBA2009: posts big blind 100
*** HOLE CARDS ***
s70n3fac3: raises 150 to 250
FDIBA2009: calls 150
*** FLOP *** [Kd 3c Jd]
FDIBA2009: checks 
s70n3fac3: checks 
*** TURN *** [Kd 3c Jd] [Qs]
FDIBA2009: bets 250
s70n3fac3: raises 450 to 700
FDIBA2009: folds 
Uncalled bet (450) returned to s70n3fac3
s70n3fac3 collected 945 from pot
s70n3fac3: doesn't show hand 
*** SUMMARY ***
Total pot 1000 | Rake 55 
Board [Kd 3c Jd Qs]
Seat 1: s70n3fac3 (button) (small blind) collected (945)
Seat 2: FDIBA2009 (big blind) folded on the Turn



PokerStars Home Game Hand #227250742202: {Club #4781089}  Hold'em No Limit (50/100) - 2021/06/01 23:50:19 EET [2021/06/01 16:50:19 ET]
Table 'VTPP NLHE 0106' 2-max (Play Money) Seat #2 is the button
Seat 1: s70n3fac3 (19841 in chips) 
Seat 2: FDIBA2009 (19757 in chips) 
FDIBA2009: posts small blind 50
s70n3fac3: posts big blind 100
*** HOLE CARDS ***
FDIBA2009: raises 100 to 200
s70n3fac3: raises 400 to 600
FDIBA2009: calls 400
*** FLOP *** [2d 8s 2h]
s70n3fac3: checks 
FDIBA2009: checks 
*** TURN *** [2d 8s 2h] [6s]
s70n3fac3: checks 
FDIBA2009: bets 600
s70n3fac3: calls 600
*** RIVER *** [2d 8s 2h 6s] [Ah]
s70n3fac3: checks 
FDIBA2009: checks 
*** SHOW DOWN ***
s70n3fac3: shows [Ac 9d] (two pair, Aces and Deuces)
FDIBA2009: mucks hand 
s70n3fac3 collected 2268 from pot
*** SUMMARY ***
Total pot 2400 | Rake 132 
Board [2d 8s 2h 6s Ah]
Seat 1: s70n3fac3 (big blind) showed [Ac 9d] and won (2268) with two pair, Aces and Deuces
Seat 2: FDIBA2009 (button) (small blind) mucked [6d 8c]



PokerStars Home Game Hand #227250753381: {Club #4781089}  Hold'em No Limit (50/100) - 2021/06/01 23:50:41 EET [2021/06/01 16:50:41 ET]
Table 'VTPP NLHE 0106' 2-max (Play Money) Seat #1 is the button
Seat 1: s70n3fac3 (20909 in chips) 
Seat 2: FDIBA2009 (18557 in chips) 
s70n3fac3: posts small blind 50
FDIBA2009: posts big blind 100
*** HOLE CARDS ***
s70n3fac3: raises 150 to 250
FDIBA2009: folds 
Uncalled bet (150) returned to s70n3fac3
s70n3fac3 collected 200 from pot
s70n3fac3: doesn't show hand 
*** SUMMARY ***
Total pot 200 | Rake 0 
Seat 1: s70n3fac3 (button) (small blind) collected (200)
Seat 2: FDIBA2009 (big blind) folded before Flop



PokerStars Home Game Hand #227250758115: {Club #4781089}  Hold'em No Limit (50/100) - 2021/06/01 23:50:50 EET [2021/06/01 16:50:50 ET]
Table 'VTPP NLHE 0106' 2-max (Play Money) Seat #2 is the button
Seat 1: s70n3fac3 (21009 in chips) 
Seat 2: FDIBA2009 (18457 in chips) 
FDIBA2009: posts small blind 50
s70n3fac3: posts big blind 100
*** HOLE CARDS ***
FDIBA2009: raises 100 to 200
s70n3fac3: calls 100
*** FLOP *** [3d 7c 3s]
s70n3fac3: checks 
FDIBA2009: bets 200
s70n3fac3: folds 
Uncalled bet (200) returned to FDIBA2009
FDIBA2009 collected 378 from pot
FDIBA2009: doesn't show hand 
*** SUMMARY ***
Total pot 400 | Rake 22 
Board [3d 7c 3s]
Seat 1: s70n3fac3 (big blind) folded on the Flop
Seat 2: FDIBA2009 (button) (small blind) collected (378)



PokerStars Home Game Hand #227250764790: {Club #4781089}  Hold'em No Limit (50/100) - 2021/06/01 23:51:03 EET [2021/06/01 16:51:03 ET]
Table 'VTPP NLHE 0106' 2-max (Play Money) Seat #1 is the button
Seat 1: s70n3fac3 (20809 in chips) 
Seat 2: FDIBA2009 (18635 in chips) 
s70n3fac3: posts small blind 50
FDIBA2009: posts big blind 100
*** HOLE CARDS ***
s70n3fac3: calls 50
FDIBA2009: raises 200 to 300
s70n3fac3: calls 200
*** FLOP *** [7d 9c Ks]
FDIBA2009: bets 300
s70n3fac3: calls 300
*** TURN *** [7d 9c Ks] [9s]
FDIBA2009: bets 700
s70n3fac3: calls 700
*** RIVER *** [7d 9c Ks 9s] [Th]
FDIBA2009: checks 
s70n3fac3: bets 2457
FDIBA2009: folds 
Uncalled bet (2457) returned to s70n3fac3
s70n3fac3 collected 2457 from pot
s70n3fac3: doesn't show hand 
*** SUMMARY ***
Total pot 2600 | Rake 143 
Board [7d 9c Ks 9s Th]
Seat 1: s70n3fac3 (button) (small blind) collected (2457)
Seat 2: FDIBA2009 (big blind) folded on the River



PokerStars Home Game Hand #227250779370: {Club #4781089}  Hold'em No Limit (50/100) - 2021/06/01 23:51:32 EET [2021/06/01 16:51:32 ET]
Table 'VTPP NLHE 0106' 2-max (Play Money) Seat #2 is the button
Seat 1: s70n3fac3 (21966 in chips) 
Seat 2: FDIBA2009 (17335 in chips) 
FDIBA2009: posts small blind 50
s70n3fac3: posts big blind 100
*** HOLE CARDS ***
FDIBA2009: raises 100 to 200
s70n3fac3: folds 
Uncalled bet (100) returned to FDIBA2009
FDIBA2009 collected 200 from pot
FDIBA2009: doesn't show hand 
*** SUMMARY ***
Total pot 200 | Rake 0 
Seat 1: s70n3fac3 (big blind) folded before Flop
Seat 2: FDIBA2009 (button) (small blind) collected (200)



PokerStars Home Game Hand #227250782299: {Club #4781089}  Hold'em No Limit (50/100) - 2021/06/01 23:51:38 EET [2021/06/01 16:51:38 ET]
Table 'VTPP NLHE 0106' 2-max (Play Money) Seat #1 is the button
Seat 1: s70n3fac3 (21866 in chips) 
Seat 2: FDIBA2009 (17435 in chips) 
s70n3fac3: posts small blind 50
FDIBA2009: posts big blind 100
*** HOLE CARDS ***
s70n3fac3: raises 150 to 250
FDIBA2009: calls 150
*** FLOP *** [Ks Js 3s]
FDIBA2009: checks 
s70n3fac3: checks 
*** TURN *** [Ks Js 3s] [Qd]
FDIBA2009: checks 
s70n3fac3: bets 300
FDIBA2009: folds 
Uncalled bet (300) returned to s70n3fac3
s70n3fac3 collected 472 from pot
s70n3fac3: doesn't show hand 
*** SUMMARY ***
Total pot 500 | Rake 28 
Board [Ks Js 3s Qd]
Seat 1: s70n3fac3 (button) (small blind) collected (472)
Seat 2: FDIBA2009 (big blind) folded on the Turn



PokerStars Home Game Hand #227250789909: {Club #4781089}  Hold'em No Limit (50/100) - 2021/06/01 23:51:53 EET [2021/06/01 16:51:53 ET]
Table 'VTPP NLHE 0106' 2-max (Play Money) Seat #2 is the button
Seat 1: s70n3fac3 (22088 in chips) 
Seat 2: FDIBA2009 (17185 in chips) 
FDIBA2009: posts small blind 50
s70n3fac3: posts big blind 100
*** HOLE CARDS ***
FDIBA2009: raises 100 to 200
s70n3fac3: folds 
Uncalled bet (100) returned to FDIBA2009
FDIBA2009 collected 200 from pot
FDIBA2009: doesn't show hand 
*** SUMMARY ***
Total pot 200 | Rake 0 
Seat 1: s70n3fac3 (big blind) folded before Flop
Seat 2: FDIBA2009 (button) (small blind) collected (200)



PokerStars Home Game Hand #227250792775: {Club #4781089}  Hold'em No Limit (50/100) - 2021/06/01 23:51:58 EET [2021/06/01 16:51:58 ET]
Table 'VTPP NLHE 0106' 2-max (Play Money) Seat #1 is the button
Seat 1: s70n3fac3 (21988 in chips) 
Seat 2: FDIBA2009 (17285 in chips) 
s70n3fac3: posts small blind 50
FDIBA2009: posts big blind 100
*** HOLE CARDS ***
s70n3fac3: folds 
Uncalled bet (50) returned to FDIBA2009
FDIBA2009 collected 100 from pot
FDIBA2009: doesn't show hand 
*** SUMMARY ***
Total pot 100 | Rake 0 
Seat 1: s70n3fac3 (button) (small blind) folded before Flop
Seat 2: FDIBA2009 (big blind) collected (100)



PokerStars Home Game Hand #227250794868: {Club #4781089}  Hold'em No Limit (50/100) - 2021/06/01 23:52:02 EET [2021/06/01 16:52:02 ET]
Table 'VTPP NLHE 0106' 2-max (Play Money) Seat #2 is the button
Seat 1: s70n3fac3 (21938 in chips) 
Seat 2: FDIBA2009 (17335 in chips) 
FDIBA2009: posts small blind 50
s70n3fac3: posts big blind 100
*** HOLE CARDS ***
FDIBA2009: raises 100 to 200
s70n3fac3: raises 400 to 600
FDIBA2009: calls 400
*** FLOP *** [3d 2h 5s]
s70n3fac3: checks 
FDIBA2009: checks 
*** TURN *** [3d 2h 5s] [Td]
s70n3fac3: checks 
FDIBA2009: bets 750
s70n3fac3: calls 750
*** RIVER *** [3d 2h 5s Td] [9c]
s70n3fac3: checks 
FDIBA2009: checks 
*** SHOW DOWN ***
s70n3fac3: shows [Qd Ah] (high card Ace)
FDIBA2009: shows [Ts 6h] (a pair of Tens)
FDIBA2009 collected 2551 from pot
*** SUMMARY ***
Total pot 2700 | Rake 149 
Board [3d 2h 5s Td 9c]
Seat 1: s70n3fac3 (big blind) showed [Qd Ah] and lost with high card Ace
Seat 2: FDIBA2009 (button) (small blind) showed [Ts 6h] and won (2551) with a pair of Tens



PokerStars Home Game Hand #227250807479: {Club #4781089}  Hold'em No Limit (50/100) - 2021/06/01 23:52:27 EET [2021/06/01 16:52:27 ET]
Table 'VTPP NLHE 0106' 2-max (Play Money) Seat #1 is the button
Seat 1: s70n3fac3 (20588 in chips) 
Seat 2: FDIBA2009 (18536 in chips) 
s70n3fac3: posts small blind 50
FDIBA2009: posts big blind 100
*** HOLE CARDS ***
s70n3fac3: raises 150 to 250
FDIBA2009: folds 
Uncalled bet (150) returned to s70n3fac3
s70n3fac3 collected 200 from pot
s70n3fac3: doesn't show hand 
*** SUMMARY ***
Total pot 200 | Rake 0 
Seat 1: s70n3fac3 (button) (small blind) collected (200)
Seat 2: FDIBA2009 (big blind) folded before Flop



PokerStars Home Game Hand #227250810933: {Club #4781089}  Hold'em No Limit (50/100) - 2021/06/01 23:52:34 EET [2021/06/01 16:52:34 ET]
Table 'VTPP NLHE 0106' 2-max (Play Money) Seat #2 is the button
Seat 1: s70n3fac3 (20688 in chips) 
Seat 2: FDIBA2009 (18436 in chips) 
FDIBA2009: posts small blind 50
s70n3fac3: posts big blind 100
*** HOLE CARDS ***
FDIBA2009: raises 100 to 200
s70n3fac3: raises 400 to 600
FDIBA2009: calls 400
*** FLOP *** [Js 2h Th]
s70n3fac3: checks 
FDIBA2009: checks 
*** TURN *** [Js 2h Th] [8s]
s70n3fac3: bets 600
FDIBA2009: calls 600
*** RIVER *** [Js 2h Th 8s] [Ts]
s70n3fac3: bets 1000
FDIBA2009: calls 1000
*** SHOW DOWN ***
s70n3fac3: shows [Tc Ad] (three of a kind, Tens)
FDIBA2009: shows [7d 9h] (a straight, Seven to Jack)
FDIBA2009 collected 4158 from pot
*** SUMMARY ***
Total pot 4400 | Rake 242 
Board [Js 2h Th 8s Ts]
Seat 1: s70n3fac3 (big blind) showed [Tc Ad] and lost with three of a kind, Tens
Seat 2: FDIBA2009 (button) (small blind) showed [7d 9h] and won (4158) with a straight, Seven to Jack



PokerStars Home Game Hand #227250824069: {Club #4781089}  Hold'em No Limit (50/100) - 2021/06/01 23:53:00 EET [2021/06/01 16:53:00 ET]
Table 'VTPP NLHE 0106' 2-max (Play Money) Seat #1 is the button
Seat 1: s70n3fac3 (18488 in chips) 
Seat 2: FDIBA2009 (20394 in chips) 
s70n3fac3: posts small blind 50
FDIBA2009: posts big blind 100
*** HOLE CARDS ***
s70n3fac3: folds 
Uncalled bet (50) returned to FDIBA2009
FDIBA2009 collected 100 from pot
FDIBA2009: doesn't show hand 
*** SUMMARY ***
Total pot 100 | Rake 0 
Seat 1: s70n3fac3 (button) (small blind) folded before Flop
Seat 2: FDIBA2009 (big blind) collected (100)



PokerStars Home Game Hand #227250829190: {Club #4781089}  Hold'em No Limit (50/100) - 2021/06/01 23:53:10 EET [2021/06/01 16:53:10 ET]
Table 'VTPP NLHE 0106' 2-max (Play Money) Seat #2 is the button
Seat 1: s70n3fac3 (18438 in chips) 
Seat 2: FDIBA2009 (20444 in chips) 
FDIBA2009: posts small blind 50
s70n3fac3: posts big blind 100
*** HOLE CARDS ***
FDIBA2009: raises 100 to 200
s70n3fac3: calls 100
*** FLOP *** [8h 3d 6h]
s70n3fac3: checks 
FDIBA2009: checks 
*** TURN *** [8h 3d 6h] [Tc]
s70n3fac3: checks 
FDIBA2009: checks 
*** RIVER *** [8h 3d 6h Tc] [5d]
s70n3fac3: checks 
FDIBA2009: bets 100
s70n3fac3: folds 
Uncalled bet (100) returned to FDIBA2009
FDIBA2009 collected 378 from pot
FDIBA2009: doesn't show hand 
*** SUMMARY ***
Total pot 400 | Rake 22 
Board [8h 3d 6h Tc 5d]
Seat 1: s70n3fac3 (big blind) folded on the River
Seat 2: FDIBA2009 (button) (small blind) collected (378)



PokerStars Home Game Hand #227250840099: {Club #4781089}  Hold'em No Limit (50/100) - 2021/06/01 23:53:31 EET [2021/06/01 16:53:31 ET]
Table 'VTPP NLHE 0106' 2-max (Play Money) Seat #1 is the button
Seat 1: s70n3fac3 (18238 in chips) 
Seat 2: FDIBA2009 (20622 in chips) 
s70n3fac3: posts small blind 50
FDIBA2009: posts big blind 100
*** HOLE CARDS ***
s70n3fac3: raises 200 to 300
FDIBA2009: folds 
Uncalled bet (200) returned to s70n3fac3
s70n3fac3 collected 200 from pot
s70n3fac3: doesn't show hand 
*** SUMMARY ***
Total pot 200 | Rake 0 
Seat 1: s70n3fac3 (button) (small blind) collected (200)
Seat 2: FDIBA2009 (big blind) folded before Flop



PokerStars Home Game Hand #227250843086: {Club #4781089}  Hold'em No Limit (50/100) - 2021/06/01 23:53:37 EET [2021/06/01 16:53:37 ET]
Table 'VTPP NLHE 0106' 2-max (Play Money) Seat #2 is the button
Seat 1: s70n3fac3 (18338 in chips) 
Seat 2: FDIBA2009 (20522 in chips) 
FDIBA2009: posts small blind 50
s70n3fac3: posts big blind 100
*** HOLE CARDS ***
FDIBA2009: raises 100 to 200
s70n3fac3: raises 500 to 700
FDIBA2009: calls 500
*** FLOP *** [6c Kh Qh]
s70n3fac3: bets 900
FDIBA2009: calls 900
*** TURN *** [6c Kh Qh] [Js]
s70n3fac3: checks 
FDIBA2009: checks 
*** RIVER *** [6c Kh Qh Js] [Ah]
s70n3fac3: checks 
FDIBA2009: checks 
*** SHOW DOWN ***
s70n3fac3: shows [8h 8s] (a pair of Eights)
FDIBA2009: shows [Qc 7s] (a pair of Queens)
FDIBA2009 collected 3024 from pot
*** SUMMARY ***
Total pot 3200 | Rake 176 
Board [6c Kh Qh Js Ah]
Seat 1: s70n3fac3 (big blind) showed [8h 8s] and lost with a pair of Eights
Seat 2: FDIBA2009 (button) (small blind) showed [Qc 7s] and won (3024) with a pair of Queens



PokerStars Home Game Hand #227250860472: {Club #4781089}  Hold'em No Limit (50/100) - 2021/06/01 23:54:11 EET [2021/06/01 16:54:11 ET]
Table 'VTPP NLHE 0106' 2-max (Play Money) Seat #1 is the button
Seat 1: s70n3fac3 (16738 in chips) 
Seat 2: FDIBA2009 (21946 in chips) 
s70n3fac3: posts small blind 50
FDIBA2009: posts big blind 100
*** HOLE CARDS ***
s70n3fac3: raises 200 to 300
FDIBA2009: raises 600 to 900
s70n3fac3: calls 600
*** FLOP *** [9h 4c 5d]
FDIBA2009: bets 900
s70n3fac3: folds 
Uncalled bet (900) returned to FDIBA2009
FDIBA2009 collected 1701 from pot
FDIBA2009: doesn't show hand 
*** SUMMARY ***
Total pot 1800 | Rake 99 
Board [9h 4c 5d]
Seat 1: s70n3fac3 (button) (small blind) folded on the Flop
Seat 2: FDIBA2009 (big blind) collected (1701)



PokerStars Home Game Hand #227250871626: {Club #4781089}  Hold'em No Limit (50/100) - 2021/06/01 23:54:33 EET [2021/06/01 16:54:33 ET]
Table 'VTPP NLHE 0106' 2-max (Play Money) Seat #2 is the button
Seat 1: s70n3fac3 (15838 in chips) 
Seat 2: FDIBA2009 (22747 in chips) 
FDIBA2009: posts small blind 50
s70n3fac3: posts big blind 100
*** HOLE CARDS ***
FDIBA2009: folds 
Uncalled bet (50) returned to s70n3fac3
s70n3fac3 collected 100 from pot
s70n3fac3: doesn't show hand 
*** SUMMARY ***
Total pot 100 | Rake 0 
Seat 1: s70n3fac3 (big blind) collected (100)
Seat 2: FDIBA2009 (button) (small blind) folded before Flop



PokerStars Home Game Hand #227250874849: {Club #4781089}  Hold'em No Limit (50/100) - 2021/06/01 23:54:40 EET [2021/06/01 16:54:40 ET]
Table 'VTPP NLHE 0106' 2-max (Play Money) Seat #1 is the button
Seat 1: s70n3fac3 (15888 in chips) 
Seat 2: FDIBA2009 (22697 in chips) 
s70n3fac3: posts small blind 50
FDIBA2009: posts big blind 100
*** HOLE CARDS ***
s70n3fac3: folds 
Uncalled bet (50) returned to FDIBA2009
FDIBA2009 collected 100 from pot
FDIBA2009: doesn't show hand 
*** SUMMARY ***
Total pot 100 | Rake 0 
Seat 1: s70n3fac3 (button) (small blind) folded before Flop
Seat 2: FDIBA2009 (big blind) collected (100)



PokerStars Home Game Hand #227250876726: {Club #4781089}  Hold'em No Limit (50/100) - 2021/06/01 23:54:43 EET [2021/06/01 16:54:43 ET]
Table 'VTPP NLHE 0106' 2-max (Play Money) Seat #2 is the button
Seat 1: s70n3fac3 (15838 in chips) 
Seat 2: FDIBA2009 (22747 in chips) 
FDIBA2009: posts small blind 50
s70n3fac3: posts big blind 100
*** HOLE CARDS ***
FDIBA2009: raises 100 to 200
s70n3fac3: raises 600 to 800
FDIBA2009: calls 600
*** FLOP *** [5s 5c Ah]
s70n3fac3: checks 
FDIBA2009: checks 
*** TURN *** [5s 5c Ah] [Kd]
s70n3fac3: bets 1200
FDIBA2009: folds 
Uncalled bet (1200) returned to s70n3fac3
s70n3fac3 collected 1512 from pot
s70n3fac3: doesn't show hand 
*** SUMMARY ***
Total pot 1600 | Rake 88 
Board [5s 5c Ah Kd]
Seat 1: s70n3fac3 (big blind) collected (1512)
Seat 2: FDIBA2009 (button) (small blind) folded on the Turn



PokerStars Home Game Hand #227250888061: {Club #4781089}  Hold'em No Limit (50/100) - 2021/06/01 23:55:07 EET [2021/06/01 16:55:07 ET]
Table 'VTPP NLHE 0106' 2-max (Play Money) Seat #1 is the button
Seat 1: s70n3fac3 (16550 in chips) 
Seat 2: FDIBA2009 (21947 in chips) 
s70n3fac3: posts small blind 50
FDIBA2009: posts big blind 100
*** HOLE CARDS ***
s70n3fac3: folds 
Uncalled bet (50) returned to FDIBA2009
FDIBA2009 collected 100 from pot
FDIBA2009: doesn't show hand 
*** SUMMARY ***
Total pot 100 | Rake 0 
Seat 1: s70n3fac3 (button) (small blind) folded before Flop
Seat 2: FDIBA2009 (big blind) collected (100)



PokerStars Home Game Hand #227250889417: {Club #4781089}  Hold'em No Limit (50/100) - 2021/06/01 23:55:10 EET [2021/06/01 16:55:10 ET]
Table 'VTPP NLHE 0106' 2-max (Play Money) Seat #2 is the button
Seat 1: s70n3fac3 (16500 in chips) 
Seat 2: FDIBA2009 (21997 in chips) 
FDIBA2009: posts small blind 50
s70n3fac3: posts big blind 100
*** HOLE CARDS ***
FDIBA2009: raises 200 to 300
s70n3fac3: calls 200
*** FLOP *** [3s 6s 6h]
s70n3fac3: checks 
FDIBA2009: checks 
*** TURN *** [3s 6s 6h] [6c]
s70n3fac3: checks 
FDIBA2009: bets 300
s70n3fac3: calls 300
*** RIVER *** [3s 6s 6h 6c] [Kc]
s70n3fac3: checks 
FDIBA2009: checks 
*** SHOW DOWN ***
s70n3fac3: shows [6d As] (four of a kind, Sixes)
FDIBA2009: mucks hand 
s70n3fac3 collected 1134 from pot
*** SUMMARY ***
Total pot 1200 | Rake 66 
Board [3s 6s 6h 6c Kc]
Seat 1: s70n3fac3 (big blind) showed [6d As] and won (1134) with four of a kind, Sixes
Seat 2: FDIBA2009 (button) (small blind) mucked [Ah Qd]



PokerStars Home Game Hand #227250897264: {Club #4781089}  Hold'em No Limit (50/100) - 2021/06/01 23:55:31 EET [2021/06/01 16:55:31 ET]
Table 'VTPP NLHE 0106' 2-max (Play Money) Seat #1 is the button
Seat 1: s70n3fac3 (17034 in chips) 
Seat 2: FDIBA2009 (21397 in chips) 
s70n3fac3: posts small blind 50
FDIBA2009: posts big blind 100
*** HOLE CARDS ***
s70n3fac3: raises 150 to 250
FDIBA2009: folds 
Uncalled bet (150) returned to s70n3fac3
s70n3fac3 collected 200 from pot
s70n3fac3: doesn't show hand 
*** SUMMARY ***
Total pot 200 | Rake 0 
Seat 1: s70n3fac3 (button) (small blind) collected (200)
Seat 2: FDIBA2009 (big blind) folded before Flop



PokerStars Home Game Hand #227250899417: {Club #4781089}  Hold'em No Limit (50/100) - 2021/06/01 23:55:37 EET [2021/06/01 16:55:37 ET]
Table 'VTPP NLHE 0106' 2-max (Play Money) Seat #2 is the button
Seat 1: s70n3fac3 (17134 in chips) 
Seat 2: FDIBA2009 (21297 in chips) 
FDIBA2009: posts small blind 50
s70n3fac3: posts big blind 100
*** HOLE CARDS ***
FDIBA2009: raises 100 to 200
s70n3fac3: folds 
Uncalled bet (100) returned to FDIBA2009
FDIBA2009 collected 200 from pot
FDIBA2009: doesn't show hand 
*** SUMMARY ***
Total pot 200 | Rake 0 
Seat 1: s70n3fac3 (big blind) folded before Flop
Seat 2: FDIBA2009 (button) (small blind) collected (200)



PokerStars Home Game Hand #227250901852: {Club #4781089}  Hold'em No Limit (50/100) - 2021/06/01 23:55:43 EET [2021/06/01 16:55:43 ET]
Table 'VTPP NLHE 0106' 2-max (Play Money) Seat #1 is the button
Seat 1: s70n3fac3 (17034 in chips) 
Seat 2: FDIBA2009 (21397 in chips) 
s70n3fac3: posts small blind 50
FDIBA2009: posts big blind 100
*** HOLE CARDS ***
s70n3fac3: folds 
Uncalled bet (50) returned to FDIBA2009
FDIBA2009 collected 100 from pot
FDIBA2009: doesn't show hand 
*** SUMMARY ***
Total pot 100 | Rake 0 
Seat 1: s70n3fac3 (button) (small blind) folded before Flop
Seat 2: FDIBA2009 (big blind) collected (100)



PokerStars Home Game Hand #227250903257: {Club #4781089}  Hold'em No Limit (50/100) - 2021/06/01 23:55:47 EET [2021/06/01 16:55:47 ET]
Table 'VTPP NLHE 0106' 2-max (Play Money) Seat #2 is the button
Seat 1: s70n3fac3 (16984 in chips) 
Seat 2: FDIBA2009 (21447 in chips) 
FDIBA2009: posts small blind 50
s70n3fac3: posts big blind 100
*** HOLE CARDS ***
FDIBA2009: raises 100 to 200
s70n3fac3: calls 100
*** FLOP *** [Kd Qs 6h]
s70n3fac3: checks 
FDIBA2009: checks 
*** TURN *** [Kd Qs 6h] [Jc]
s70n3fac3: checks 
FDIBA2009: checks 
*** RIVER *** [Kd Qs 6h Jc] [Ac]
s70n3fac3: checks 
FDIBA2009: bets 378
s70n3fac3: folds 
Uncalled bet (378) returned to FDIBA2009
FDIBA2009 collected 378 from pot
FDIBA2009: doesn't show hand 
*** SUMMARY ***
Total pot 400 | Rake 22 
Board [Kd Qs 6h Jc Ac]
Seat 1: s70n3fac3 (big blind) folded on the River
Seat 2: FDIBA2009 (button) (small blind) collected (378)



PokerStars Home Game Hand #227250909340: {Club #4781089}  Hold'em No Limit (50/100) - 2021/06/01 23:56:03 EET [2021/06/01 16:56:03 ET]
Table 'VTPP NLHE 0106' 2-max (Play Money) Seat #1 is the button
Seat 1: s70n3fac3 (16784 in chips) 
Seat 2: FDIBA2009 (21625 in chips) 
s70n3fac3: posts small blind 50
FDIBA2009: posts big blind 100
*** HOLE CARDS ***
s70n3fac3: folds 
Uncalled bet (50) returned to FDIBA2009
FDIBA2009 collected 100 from pot
FDIBA2009: doesn't show hand 
*** SUMMARY ***
Total pot 100 | Rake 0 
Seat 1: s70n3fac3 (button) (small blind) folded before Flop
Seat 2: FDIBA2009 (big blind) collected (100)



PokerStars Home Game Hand #227250910752: {Club #4781089}  Hold'em No Limit (50/100) - 2021/06/01 23:56:07 EET [2021/06/01 16:56:07 ET]
Table 'VTPP NLHE 0106' 2-max (Play Money) Seat #2 is the button
Seat 1: s70n3fac3 (16734 in chips) 
Seat 2: FDIBA2009 (21675 in chips) 
FDIBA2009: posts small blind 50
s70n3fac3: posts big blind 100
*** HOLE CARDS ***
FDIBA2009: raises 100 to 200
s70n3fac3: calls 100
*** FLOP *** [2d Ac 3s]
s70n3fac3: checks 
FDIBA2009: bets 200
s70n3fac3: folds 
Uncalled bet (200) returned to FDIBA2009
FDIBA2009 collected 378 from pot
FDIBA2009: doesn't show hand 
*** SUMMARY ***
Total pot 400 | Rake 22 
Board [2d Ac 3s]
Seat 1: s70n3fac3 (big blind) folded on the Flop
Seat 2: FDIBA2009 (button) (small blind) collected (378)



PokerStars Home Game Hand #227250914613: {Club #4781089}  Hold'em No Limit (50/100) - 2021/06/01 23:56:17 EET [2021/06/01 16:56:17 ET]
Table 'VTPP NLHE 0106' 2-max (Play Money) Seat #1 is the button
Seat 1: s70n3fac3 (16534 in chips) 
Seat 2: FDIBA2009 (21853 in chips) 
s70n3fac3: posts small blind 50
FDIBA2009: posts big blind 100
*** HOLE CARDS ***
s70n3fac3: folds 
Uncalled bet (50) returned to FDIBA2009
FDIBA2009 collected 100 from pot
FDIBA2009: doesn't show hand 
*** SUMMARY ***
Total pot 100 | Rake 0 
Seat 1: s70n3fac3 (button) (small blind) folded before Flop
Seat 2: FDIBA2009 (big blind) collected (100)



PokerStars Home Game Hand #227250916081: {Club #4781089}  Hold'em No Limit (50/100) - 2021/06/01 23:56:21 EET [2021/06/01 16:56:21 ET]
Table 'VTPP NLHE 0106' 2-max (Play Money) Seat #2 is the button
Seat 1: s70n3fac3 (16484 in chips) 
Seat 2: FDIBA2009 (21903 in chips) 
FDIBA2009: posts small blind 50
s70n3fac3: posts big blind 100
*** HOLE CARDS ***
FDIBA2009: folds 
Uncalled bet (50) returned to s70n3fac3
s70n3fac3 collected 100 from pot
s70n3fac3: doesn't show hand 
*** SUMMARY ***
Total pot 100 | Rake 0 
Seat 1: s70n3fac3 (big blind) collected (100)
Seat 2: FDIBA2009 (button) (small blind) folded before Flop



PokerStars Home Game Hand #227250918076: {Club #4781089}  Hold'em No Limit (50/100) - 2021/06/01 23:56:26 EET [2021/06/01 16:56:26 ET]
Table 'VTPP NLHE 0106' 2-max (Play Money) Seat #1 is the button
Seat 1: s70n3fac3 (16534 in chips) 
Seat 2: FDIBA2009 (21853 in chips) 
s70n3fac3: posts small blind 50
FDIBA2009: posts big blind 100
*** HOLE CARDS ***
s70n3fac3: raises 200 to 300
FDIBA2009: folds 
Uncalled bet (200) returned to s70n3fac3
s70n3fac3 collected 200 from pot
s70n3fac3: doesn't show hand 
*** SUMMARY ***
Total pot 200 | Rake 0 
Seat 1: s70n3fac3 (button) (small blind) collected (200)
Seat 2: FDIBA2009 (big blind) folded before Flop



PokerStars Home Game Hand #227250920296: {Club #4781089}  Hold'em No Limit (50/100) - 2021/06/01 23:56:32 EET [2021/06/01 16:56:32 ET]
Table 'VTPP NLHE 0106' 2-max (Play Money) Seat #2 is the button
Seat 1: s70n3fac3 (16634 in chips) 
Seat 2: FDIBA2009 (21753 in chips) 
FDIBA2009: posts small blind 50
s70n3fac3: posts big blind 100
*** HOLE CARDS ***
FDIBA2009: raises 100 to 200
s70n3fac3: folds 
Uncalled bet (100) returned to FDIBA2009
FDIBA2009 collected 200 from pot
FDIBA2009: doesn't show hand 
*** SUMMARY ***
Total pot 200 | Rake 0 
Seat 1: s70n3fac3 (big blind) folded before Flop
Seat 2: FDIBA2009 (button) (small blind) collected (200)



PokerStars Home Game Hand #227250922426: {Club #4781089}  Hold'em No Limit (50/100) - 2021/06/01 23:56:38 EET [2021/06/01 16:56:38 ET]
Table 'VTPP NLHE 0106' 2-max (Play Money) Seat #1 is the button
Seat 1: s70n3fac3 (16534 in chips) 
Seat 2: FDIBA2009 (21853 in chips) 
s70n3fac3: posts small blind 50
FDIBA2009: posts big blind 100
*** HOLE CARDS ***
s70n3fac3: raises 150 to 250
FDIBA2009: calls 150
*** FLOP *** [4c Qd Jc]
FDIBA2009: checks 
s70n3fac3: bets 300
FDIBA2009: folds 
Uncalled bet (300) returned to s70n3fac3
s70n3fac3 collected 472 from pot
s70n3fac3: doesn't show hand 
*** SUMMARY ***
Total pot 500 | Rake 28 
Board [4c Qd Jc]
Seat 1: s70n3fac3 (button) (small blind) collected (472)
Seat 2: FDIBA2009 (big blind) folded on the Flop



PokerStars Home Game Hand #227250926452: {Club #4781089}  Hold'em No Limit (50/100) - 2021/06/01 23:56:48 EET [2021/06/01 16:56:48 ET]
Table 'VTPP NLHE 0106' 2-max (Play Money) Seat #2 is the button
Seat 1: s70n3fac3 (16756 in chips) 
Seat 2: FDIBA2009 (21603 in chips) 
FDIBA2009: posts small blind 50
s70n3fac3: posts big blind 100
*** HOLE CARDS ***
FDIBA2009: raises 100 to 200
s70n3fac3: raises 600 to 800
FDIBA2009: raises 850 to 1650
s70n3fac3: calls 850
*** FLOP *** [2d Ks 6c]
s70n3fac3: checks 
FDIBA2009: bets 3118
s70n3fac3: folds 
Uncalled bet (3118) returned to FDIBA2009
FDIBA2009 collected 3118 from pot
FDIBA2009: doesn't show hand 
*** SUMMARY ***
Total pot 3300 | Rake 182 
Board [2d Ks 6c]
Seat 1: s70n3fac3 (big blind) folded on the Flop
Seat 2: FDIBA2009 (button) (small blind) collected (3118)



PokerStars Home Game Hand #227250939837: {Club #4781089}  Hold'em No Limit (50/100) - 2021/06/01 23:57:24 EET [2021/06/01 16:57:24 ET]
Table 'VTPP NLHE 0106' 2-max (Play Money) Seat #1 is the button
Seat 1: s70n3fac3 (15106 in chips) 
Seat 2: FDIBA2009 (23071 in chips) 
s70n3fac3: posts small blind 50
FDIBA2009: posts big blind 100
*** HOLE CARDS ***
s70n3fac3: raises 150 to 250
FDIBA2009: calls 150
*** FLOP *** [Jd 9c Qd]
FDIBA2009: checks 
s70n3fac3: bets 300
FDIBA2009: calls 300
*** TURN *** [Jd 9c Qd] [Tc]
FDIBA2009: checks 
s70n3fac3: checks 
*** RIVER *** [Jd 9c Qd Tc] [2c]
FDIBA2009: bets 600
s70n3fac3: folds 
Uncalled bet (600) returned to FDIBA2009
FDIBA2009 collected 1039 from pot
FDIBA2009: doesn't show hand 
*** SUMMARY ***
Total pot 1100 | Rake 61 
Board [Jd 9c Qd Tc 2c]
Seat 1: s70n3fac3 (button) (small blind) folded on the River
Seat 2: FDIBA2009 (big blind) collected (1039)



PokerStars Home Game Hand #227250949041: {Club #4781089}  Hold'em No Limit (50/100) - 2021/06/01 23:57:48 EET [2021/06/01 16:57:48 ET]
Table 'VTPP NLHE 0106' 2-max (Play Money) Seat #2 is the button
Seat 1: s70n3fac3 (14556 in chips) 
Seat 2: FDIBA2009 (23560 in chips) 
FDIBA2009: posts small blind 50
s70n3fac3: posts big blind 100
*** HOLE CARDS ***
FDIBA2009: raises 100 to 200
s70n3fac3: calls 100
*** FLOP *** [Ad 3c Jh]
s70n3fac3: checks 
FDIBA2009: checks 
*** TURN *** [Ad 3c Jh] [Jc]
s70n3fac3: checks 
FDIBA2009: checks 
*** RIVER *** [Ad 3c Jh Jc] [4h]
s70n3fac3: checks 
FDIBA2009: bets 100
s70n3fac3: folds 
Uncalled bet (100) returned to FDIBA2009
FDIBA2009 collected 378 from pot
FDIBA2009: doesn't show hand 
*** SUMMARY ***
Total pot 400 | Rake 22 
Board [Ad 3c Jh Jc 4h]
Seat 1: s70n3fac3 (big blind) folded on the River
Seat 2: FDIBA2009 (button) (small blind) collected (378)



PokerStars Home Game Hand #227250954792: {Club #4781089}  Hold'em No Limit (50/100) - 2021/06/01 23:58:03 EET [2021/06/01 16:58:03 ET]
Table 'VTPP NLHE 0106' 2-max (Play Money) Seat #1 is the button
Seat 1: s70n3fac3 (14356 in chips) 
Seat 2: FDIBA2009 (23738 in chips) 
s70n3fac3: posts small blind 50
FDIBA2009: posts big blind 100
*** HOLE CARDS ***
s70n3fac3: raises 200 to 300
FDIBA2009: folds 
Uncalled bet (200) returned to s70n3fac3
s70n3fac3 collected 200 from pot
s70n3fac3: doesn't show hand 
*** SUMMARY ***
Total pot 200 | Rake 0 
Seat 1: s70n3fac3 (button) (small blind) collected (200)
Seat 2: FDIBA2009 (big blind) folded before Flop



PokerStars Home Game Hand #227250956730: {Club #4781089}  Hold'em No Limit (50/100) - 2021/06/01 23:58:08 EET [2021/06/01 16:58:08 ET]
Table 'VTPP NLHE 0106' 2-max (Play Money) Seat #2 is the button
Seat 1: s70n3fac3 (14456 in chips) 
Seat 2: FDIBA2009 (23638 in chips) 
FDIBA2009: posts small blind 50
s70n3fac3: posts big blind 100
*** HOLE CARDS ***
FDIBA2009: raises 200 to 300
s70n3fac3: calls 200
*** FLOP *** [Kc 9s 6h]
s70n3fac3: checks 
FDIBA2009: checks 
*** TURN *** [Kc 9s 6h] [3c]
s70n3fac3: checks 
FDIBA2009: bets 350
s70n3fac3: calls 350
*** RIVER *** [Kc 9s 6h 3c] [Ac]
s70n3fac3: checks 
FDIBA2009: bets 300
s70n3fac3: calls 300
*** SHOW DOWN ***
FDIBA2009: shows [Td Ah] (a pair of Aces)
s70n3fac3: mucks hand 
FDIBA2009 collected 1795 from pot
*** SUMMARY ***
Total pot 1900 | Rake 105 
Board [Kc 9s 6h 3c Ac]
Seat 1: s70n3fac3 (big blind) mucked [Ad 4s]
Seat 2: FDIBA2009 (button) (small blind) showed [Td Ah] and won (1795) with a pair of Aces



PokerStars Home Game Hand #227250964743: {Club #4781089}  Hold'em No Limit (50/100) - 2021/06/01 23:58:29 EET [2021/06/01 16:58:29 ET]
Table 'VTPP NLHE 0106' 2-max (Play Money) Seat #1 is the button
Seat 1: s70n3fac3 (13506 in chips) 
Seat 2: FDIBA2009 (24483 in chips) 
s70n3fac3: posts small blind 50
FDIBA2009: posts big blind 100
*** HOLE CARDS ***
s70n3fac3: calls 50
FDIBA2009: checks 
*** FLOP *** [8s 4d 9d]
FDIBA2009: checks 
s70n3fac3: bets 200
FDIBA2009: raises 589 to 789
s70n3fac3: folds 
Uncalled bet (589) returned to FDIBA2009
FDIBA2009 collected 567 from pot
FDIBA2009: doesn't show hand 
*** SUMMARY ***
Total pot 600 | Rake 33 
Board [8s 4d 9d]
Seat 1: s70n3fac3 (button) (small blind) folded on the Flop
Seat 2: FDIBA2009 (big blind) collected (567)



PokerStars Home Game Hand #227250973032: {Club #4781089}  Hold'em No Limit (50/100) - 2021/06/01 23:58:51 EET [2021/06/01 16:58:51 ET]
Table 'VTPP NLHE 0106' 2-max (Play Money) Seat #2 is the button
Seat 1: s70n3fac3 (13206 in chips) 
Seat 2: FDIBA2009 (24750 in chips) 
FDIBA2009: posts small blind 50
s70n3fac3: posts big blind 100
*** HOLE CARDS ***
FDIBA2009: raises 100 to 200
s70n3fac3: calls 100
*** FLOP *** [9c As 5h]
s70n3fac3: checks 
FDIBA2009: checks 
*** TURN *** [9c As 5h] [Qc]
s70n3fac3: checks 
FDIBA2009: checks 
*** RIVER *** [9c As 5h Qc] [6s]
s70n3fac3: checks 
FDIBA2009: checks 
*** SHOW DOWN ***
s70n3fac3: shows [Jc 6c] (a pair of Sixes)
FDIBA2009: mucks hand 
s70n3fac3 collected 378 from pot
*** SUMMARY ***
Total pot 400 | Rake 22 
Board [9c As 5h Qc 6s]
Seat 1: s70n3fac3 (big blind) showed [Jc 6c] and won (378) with a pair of Sixes
Seat 2: FDIBA2009 (button) (small blind) mucked [2c Ks]



PokerStars Home Game Hand #227250978207: {Club #4781089}  Hold'em No Limit (50/100) - 2021/06/01 23:59:04 EET [2021/06/01 16:59:04 ET]
Table 'VTPP NLHE 0106' 2-max (Play Money) Seat #1 is the button
Seat 1: s70n3fac3 (13384 in chips) 
Seat 2: FDIBA2009 (24550 in chips) 
s70n3fac3: posts small blind 50
FDIBA2009: posts big blind 100
*** HOLE CARDS ***
s70n3fac3: folds 
Uncalled bet (50) returned to FDIBA2009
FDIBA2009 collected 100 from pot
FDIBA2009: doesn't show hand 
*** SUMMARY ***
Total pot 100 | Rake 0 
Seat 1: s70n3fac3 (button) (small blind) folded before Flop
Seat 2: FDIBA2009 (big blind) collected (100)



PokerStars Home Game Hand #227250979608: {Club #4781089}  Hold'em No Limit (50/100) - 2021/06/01 23:59:08 EET [2021/06/01 16:59:08 ET]
Table 'VTPP NLHE 0106' 2-max (Play Money) Seat #2 is the button
Seat 1: s70n3fac3 (13334 in chips) 
Seat 2: FDIBA2009 (24600 in chips) 
FDIBA2009: posts small blind 50
s70n3fac3: posts big blind 100
*** HOLE CARDS ***
FDIBA2009: raises 200 to 300
s70n3fac3: calls 200
*** FLOP *** [Ts Qs Kc]
s70n3fac3: checks 
FDIBA2009: checks 
*** TURN *** [Ts Qs Kc] [3c]
s70n3fac3: checks 
FDIBA2009: checks 
*** RIVER *** [Ts Qs Kc 3c] [3h]
s70n3fac3: checks 
FDIBA2009: bets 567
s70n3fac3: calls 567
*** SHOW DOWN ***
FDIBA2009: shows [Qd As] (two pair, Queens and Threes)
s70n3fac3: mucks hand 
FDIBA2009 collected 1639 from pot
*** SUMMARY ***
Total pot 1734 | Rake 95 
Board [Ts Qs Kc 3c 3h]
Seat 1: s70n3fac3 (big blind) mucked [8c 8d]
Seat 2: FDIBA2009 (button) (small blind) showed [Qd As] and won (1639) with two pair, Queens and Threes



PokerStars Home Game Hand #227250986455: {Club #4781089}  Hold'em No Limit (50/100) - 2021/06/01 23:59:26 EET [2021/06/01 16:59:26 ET]
Table 'VTPP NLHE 0106' 2-max (Play Money) Seat #1 is the button
Seat 1: s70n3fac3 (12467 in chips) 
Seat 2: FDIBA2009 (25372 in chips) 
s70n3fac3: posts small blind 50
FDIBA2009: posts big blind 100
*** HOLE CARDS ***
s70n3fac3: calls 50
FDIBA2009: raises 200 to 300
s70n3fac3: calls 200
*** FLOP *** [4d Ad 9c]
FDIBA2009: checks 
s70n3fac3: checks 
*** TURN *** [4d Ad 9c] [As]
FDIBA2009: checks 
s70n3fac3: checks 
*** RIVER *** [4d Ad 9c As] [3h]
FDIBA2009: bets 567
s70n3fac3: calls 567
*** SHOW DOWN ***
FDIBA2009: shows [9s 8c] (two pair, Aces and Nines)
s70n3fac3: mucks hand 
FDIBA2009 collected 1639 from pot
*** SUMMARY ***
Total pot 1734 | Rake 95 
Board [4d Ad 9c As 3h]
Seat 1: s70n3fac3 (button) (small blind) mucked [Kd 3s]
Seat 2: FDIBA2009 (big blind) showed [9s 8c] and won (1639) with two pair, Aces and Nines



PokerStars Home Game Hand #227250993762: {Club #4781089}  Hold'em No Limit (50/100) - 2021/06/01 23:59:45 EET [2021/06/01 16:59:45 ET]
Table 'VTPP NLHE 0106' 2-max (Play Money) Seat #2 is the button
Seat 1: s70n3fac3 (11600 in chips) 
Seat 2: FDIBA2009 (26144 in chips) 
FDIBA2009: posts small blind 50
s70n3fac3: posts big blind 100
*** HOLE CARDS ***
FDIBA2009: raises 100 to 200
s70n3fac3: calls 100
*** FLOP *** [2c Jc 4s]
s70n3fac3: checks 
FDIBA2009: checks 
*** TURN *** [2c Jc 4s] [Tc]
s70n3fac3: checks 
FDIBA2009: bets 189
s70n3fac3: raises 756 to 945
FDIBA2009: folds 
Uncalled bet (756) returned to s70n3fac3
s70n3fac3 collected 735 from pot
s70n3fac3: doesn't show hand 
*** SUMMARY ***
Total pot 778 | Rake 43 
Board [2c Jc 4s Tc]
Seat 1: s70n3fac3 (big blind) collected (735)
Seat 2: FDIBA2009 (button) (small blind) folded on the Turn



PokerStars Home Game Hand #227251000729: {Club #4781089}  Hold'em No Limit (50/100) - 2021/06/02 0:00:03 EET [2021/06/01 17:00:03 ET]
Table 'VTPP NLHE 0106' 2-max (Play Money) Seat #1 is the button
Seat 1: s70n3fac3 (11946 in chips) 
Seat 2: FDIBA2009 (25755 in chips) 
s70n3fac3: posts small blind 50
FDIBA2009: posts big blind 100
*** HOLE CARDS ***
s70n3fac3: calls 50
FDIBA2009: checks 
*** FLOP *** [Th Qh 7d]
FDIBA2009: checks 
s70n3fac3: bets 200
FDIBA2009: folds 
Uncalled bet (200) returned to s70n3fac3
s70n3fac3 collected 189 from pot
s70n3fac3: doesn't show hand 
*** SUMMARY ***
Total pot 200 | Rake 11 
Board [Th Qh 7d]
Seat 1: s70n3fac3 (button) (small blind) collected (189)
Seat 2: FDIBA2009 (big blind) folded on the Flop



PokerStars Home Game Hand #227251004590: {Club #4781089}  Hold'em No Limit (50/100) - 2021/06/02 0:00:13 EET [2021/06/01 17:00:13 ET]
Table 'VTPP NLHE 0106' 2-max (Play Money) Seat #2 is the button
Seat 1: s70n3fac3 (12035 in chips) 
Seat 2: FDIBA2009 (25655 in chips) 
FDIBA2009: posts small blind 50
s70n3fac3: posts big blind 100
*** HOLE CARDS ***
FDIBA2009: raises 200 to 300
s70n3fac3: calls 200
*** FLOP *** [4d 2d 9s]
s70n3fac3: checks 
FDIBA2009: checks 
*** TURN *** [4d 2d 9s] [Qd]
s70n3fac3: checks 
FDIBA2009: bets 300
s70n3fac3: folds 
Uncalled bet (300) returned to FDIBA2009
FDIBA2009 collected 567 from pot
FDIBA2009: doesn't show hand 
*** SUMMARY ***
Total pot 600 | Rake 33 
Board [4d 2d 9s Qd]
Seat 1: s70n3fac3 (big blind) folded on the Turn
Seat 2: FDIBA2009 (button) (small blind) collected (567)



PokerStars Home Game Hand #227251010075: {Club #4781089}  Hold'em No Limit (50/100) - 2021/06/02 0:00:26 EET [2021/06/01 17:00:26 ET]
Table 'VTPP NLHE 0106' 2-max (Play Money) Seat #1 is the button
Seat 1: s70n3fac3 (11735 in chips) 
Seat 2: FDIBA2009 (25922 in chips) 
s70n3fac3: posts small blind 50
FDIBA2009: posts big blind 100
*** HOLE CARDS ***
s70n3fac3: folds 
Uncalled bet (50) returned to FDIBA2009
FDIBA2009 collected 100 from pot
FDIBA2009: doesn't show hand 
*** SUMMARY ***
Total pot 100 | Rake 0 
Seat 1: s70n3fac3 (button) (small blind) folded before Flop
Seat 2: FDIBA2009 (big blind) collected (100)



PokerStars Home Game Hand #227251011421: {Club #4781089}  Hold'em No Limit (50/100) - 2021/06/02 0:00:30 EET [2021/06/01 17:00:30 ET]
Table 'VTPP NLHE 0106' 2-max (Play Money) Seat #2 is the button
Seat 1: s70n3fac3 (11685 in chips) 
Seat 2: FDIBA2009 (25972 in chips) 
FDIBA2009: posts small blind 50
s70n3fac3: posts big blind 100
*** HOLE CARDS ***
FDIBA2009: raises 100 to 200
s70n3fac3: folds 
Uncalled bet (100) returned to FDIBA2009
FDIBA2009 collected 200 from pot
FDIBA2009: doesn't show hand 
*** SUMMARY ***
Total pot 200 | Rake 0 
Seat 1: s70n3fac3 (big blind) folded before Flop
Seat 2: FDIBA2009 (button) (small blind) collected (200)



PokerStars Home Game Hand #227251013889: {Club #4781089}  Hold'em No Limit (50/100) - 2021/06/02 0:00:36 EET [2021/06/01 17:00:36 ET]
Table 'VTPP NLHE 0106' 2-max (Play Money) Seat #1 is the button
Seat 1: s70n3fac3 (11585 in chips) 
Seat 2: FDIBA2009 (26072 in chips) 
s70n3fac3: posts small blind 50
FDIBA2009: posts big blind 100
*** HOLE CARDS ***
s70n3fac3: raises 100 to 200
FDIBA2009: calls 100
*** FLOP *** [8d 5h 7h]
FDIBA2009: checks 
s70n3fac3: checks 
*** TURN *** [8d 5h 7h] [2d]
FDIBA2009: checks 
s70n3fac3: checks 
*** RIVER *** [8d 5h 7h 2d] [6c]
FDIBA2009: checks 
s70n3fac3: checks 
*** SHOW DOWN ***
FDIBA2009: shows [Qs 3h] (high card Queen)
s70n3fac3: shows [3d Ks] (high card King)
s70n3fac3 collected 378 from pot
*** SUMMARY ***
Total pot 400 | Rake 22 
Board [8d 5h 7h 2d 6c]
Seat 1: s70n3fac3 (button) (small blind) showed [3d Ks] and won (378) with high card King
Seat 2: FDIBA2009 (big blind) showed [Qs 3h] and lost with high card Queen



PokerStars Home Game Hand #227251020293: {Club #4781089}  Hold'em No Limit (50/100) - 2021/06/02 0:00:51 EET [2021/06/01 17:00:51 ET]
Table 'VTPP NLHE 0106' 2-max (Play Money) Seat #2 is the button
Seat 1: s70n3fac3 (11763 in chips) 
Seat 2: FDIBA2009 (25872 in chips) 
FDIBA2009: posts small blind 50
s70n3fac3: posts big blind 100
*** HOLE CARDS ***
FDIBA2009: raises 100 to 200
s70n3fac3: folds 
Uncalled bet (100) returned to FDIBA2009
FDIBA2009 collected 200 from pot
FDIBA2009: doesn't show hand 
*** SUMMARY ***
Total pot 200 | Rake 0 
Seat 1: s70n3fac3 (big blind) folded before Flop
Seat 2: FDIBA2009 (button) (small blind) collected (200)



PokerStars Home Game Hand #227251022875: {Club #4781089}  Hold'em No Limit (50/100) - 2021/06/02 0:00:57 EET [2021/06/01 17:00:57 ET]
Table 'VTPP NLHE 0106' 2-max (Play Money) Seat #1 is the button
Seat 1: s70n3fac3 (11663 in chips) 
Seat 2: FDIBA2009 (25972 in chips) 
s70n3fac3: posts small blind 50
FDIBA2009: posts big blind 100
*** HOLE CARDS ***
s70n3fac3: raises 100 to 200
FDIBA2009: raises 400 to 600
s70n3fac3: calls 400
*** FLOP *** [4h 9d Qs]
FDIBA2009: checks 
s70n3fac3: checks 
*** TURN *** [4h 9d Qs] [8h]
FDIBA2009: bets 600
s70n3fac3: calls 600
*** RIVER *** [4h 9d Qs 8h] [Td]
FDIBA2009: checks 
s70n3fac3: checks 
*** SHOW DOWN ***
FDIBA2009: shows [8c 8d] (three of a kind, Eights)
s70n3fac3: mucks hand 
FDIBA2009 collected 2268 from pot
*** SUMMARY ***
Total pot 2400 | Rake 132 
Board [4h 9d Qs 8h Td]
Seat 1: s70n3fac3 (button) (small blind) mucked [7h Ah]
Seat 2: FDIBA2009 (big blind) showed [8c 8d] and won (2268) with three of a kind, Eights



PokerStars Home Game Hand #227251032306: {Club #4781089}  Hold'em No Limit (50/100) - 2021/06/02 0:01:18 EET [2021/06/01 17:01:18 ET]
Table 'VTPP NLHE 0106' 2-max (Play Money) Seat #2 is the button
Seat 1: s70n3fac3 (10463 in chips) 
Seat 2: FDIBA2009 (27040 in chips) 
FDIBA2009: posts small blind 50
s70n3fac3: posts big blind 100
*** HOLE CARDS ***
FDIBA2009: raises 100 to 200
s70n3fac3: raises 600 to 800
FDIBA2009: calls 600
*** FLOP *** [9c Kc Kd]
s70n3fac3: checks 
FDIBA2009: checks 
*** TURN *** [9c Kc Kd] [Th]
s70n3fac3: bets 800
FDIBA2009: folds 
Uncalled bet (800) returned to s70n3fac3
s70n3fac3 collected 1512 from pot
s70n3fac3: doesn't show hand 
*** SUMMARY ***
Total pot 1600 | Rake 88 
Board [9c Kc Kd Th]
Seat 1: s70n3fac3 (big blind) collected (1512)
Seat 2: FDIBA2009 (button) (small blind) folded on the Turn



PokerStars Home Game Hand #227251044851: {Club #4781089}  Hold'em No Limit (50/100) - 2021/06/02 0:01:45 EET [2021/06/01 17:01:45 ET]
Table 'VTPP NLHE 0106' 2-max (Play Money) Seat #1 is the button
Seat 1: s70n3fac3 (11175 in chips) 
Seat 2: FDIBA2009 (26240 in chips) 
s70n3fac3: posts small blind 50
FDIBA2009: posts big blind 100
*** HOLE CARDS ***
s70n3fac3: raises 200 to 300
FDIBA2009: folds 
Uncalled bet (200) returned to s70n3fac3
s70n3fac3 collected 200 from pot
s70n3fac3: doesn't show hand 
*** SUMMARY ***
Total pot 200 | Rake 0 
Seat 1: s70n3fac3 (button) (small blind) collected (200)
Seat 2: FDIBA2009 (big blind) folded before Flop



PokerStars Home Game Hand #227251047534: {Club #4781089}  Hold'em No Limit (50/100) - 2021/06/02 0:01:50 EET [2021/06/01 17:01:50 ET]
Table 'VTPP NLHE 0106' 2-max (Play Money) Seat #2 is the button
Seat 1: s70n3fac3 (11275 in chips) 
Seat 2: FDIBA2009 (26140 in chips) 
FDIBA2009: posts small blind 50
s70n3fac3: posts big blind 100
*** HOLE CARDS ***
FDIBA2009: raises 200 to 300
s70n3fac3: calls 200
*** FLOP *** [Ts 9c 6c]
s70n3fac3: checks 
FDIBA2009: checks 
*** TURN *** [Ts 9c 6c] [3c]
s70n3fac3: checks 
FDIBA2009: bets 567
s70n3fac3: folds 
Uncalled bet (567) returned to FDIBA2009
FDIBA2009 collected 567 from pot
FDIBA2009: doesn't show hand 
*** SUMMARY ***
Total pot 600 | Rake 33 
Board [Ts 9c 6c 3c]
Seat 1: s70n3fac3 (big blind) folded on the Turn
Seat 2: FDIBA2009 (button) (small blind) collected (567)



PokerStars Home Game Hand #227251054376: {Club #4781089}  Hold'em No Limit (50/100) - 2021/06/02 0:02:04 EET [2021/06/01 17:02:04 ET]
Table 'VTPP NLHE 0106' 2-max (Play Money) Seat #1 is the button
Seat 1: s70n3fac3 (10975 in chips) 
Seat 2: FDIBA2009 (26407 in chips) 
s70n3fac3: posts small blind 50
FDIBA2009: posts big blind 100
*** HOLE CARDS ***
s70n3fac3: raises 200 to 300
FDIBA2009: calls 200
*** FLOP *** [6c Jc 7h]
FDIBA2009: bets 567
s70n3fac3: calls 567
*** TURN *** [6c Jc 7h] [5d]
FDIBA2009: bets 900
s70n3fac3: folds 
Uncalled bet (900) returned to FDIBA2009
FDIBA2009 collected 1639 from pot
FDIBA2009: doesn't show hand 
*** SUMMARY ***
Total pot 1734 | Rake 95 
Board [6c Jc 7h 5d]
Seat 1: s70n3fac3 (button) (small blind) folded on the Turn
Seat 2: FDIBA2009 (big blind) collected (1639)



PokerStars Home Game Hand #227251063147: {Club #4781089}  Hold'em No Limit (50/100) - 2021/06/02 0:02:22 EET [2021/06/01 17:02:22 ET]
Table 'VTPP NLHE 0106' 2-max (Play Money) Seat #2 is the button
Seat 1: s70n3fac3 (10108 in chips) 
Seat 2: FDIBA2009 (27179 in chips) 
FDIBA2009: posts small blind 50
s70n3fac3: posts big blind 100
*** HOLE CARDS ***
FDIBA2009: raises 100 to 200
s70n3fac3: raises 400 to 600
FDIBA2009: calls 400
*** FLOP *** [7d 5d 5s]
s70n3fac3: checks 
FDIBA2009: bets 600
s70n3fac3: calls 600
*** TURN *** [7d 5d 5s] [7c]
s70n3fac3: checks 
FDIBA2009: bets 1550
s70n3fac3: folds 
Uncalled bet (1550) returned to FDIBA2009
FDIBA2009 collected 2268 from pot
FDIBA2009: doesn't show hand 
*** SUMMARY ***
Total pot 2400 | Rake 132 
Board [7d 5d 5s 7c]
Seat 1: s70n3fac3 (big blind) folded on the Turn
Seat 2: FDIBA2009 (button) (small blind) collected (2268)



PokerStars Home Game Hand #227251079706: {Club #4781089}  Hold'em No Limit (50/100) - 2021/06/02 0:02:55 EET [2021/06/01 17:02:55 ET]
Table 'VTPP NLHE 0106' 2-max (Play Money) Seat #1 is the button
Seat 1: s70n3fac3 (8908 in chips) 
Seat 2: FDIBA2009 (28247 in chips) 
s70n3fac3: posts small blind 50
FDIBA2009: posts big blind 100
*** HOLE CARDS ***
s70n3fac3: folds 
Uncalled bet (50) returned to FDIBA2009
FDIBA2009 collected 100 from pot
FDIBA2009: doesn't show hand 
*** SUMMARY ***
Total pot 100 | Rake 0 
Seat 1: s70n3fac3 (button) (small blind) folded before Flop
Seat 2: FDIBA2009 (big blind) collected (100)



PokerStars Home Game Hand #227251081639: {Club #4781089}  Hold'em No Limit (50/100) - 2021/06/02 0:02:59 EET [2021/06/01 17:02:59 ET]
Table 'VTPP NLHE 0106' 2-max (Play Money) Seat #2 is the button
Seat 1: s70n3fac3 (8858 in chips) 
Seat 2: FDIBA2009 (28297 in chips) 
FDIBA2009: posts small blind 50
s70n3fac3: posts big blind 100
*** HOLE CARDS ***
FDIBA2009: raises 100 to 200
s70n3fac3: folds 
Uncalled bet (100) returned to FDIBA2009
FDIBA2009 collected 200 from pot
FDIBA2009: doesn't show hand 
*** SUMMARY ***
Total pot 200 | Rake 0 
Seat 1: s70n3fac3 (big blind) folded before Flop
Seat 2: FDIBA2009 (button) (small blind) collected (200)



PokerStars Home Game Hand #227251084573: {Club #4781089}  Hold'em No Limit (50/100) - 2021/06/02 0:03:05 EET [2021/06/01 17:03:05 ET]
Table 'VTPP NLHE 0106' 2-max (Play Money) Seat #1 is the button
Seat 1: s70n3fac3 (8758 in chips) 
Seat 2: FDIBA2009 (28397 in chips) 
s70n3fac3: posts small blind 50
FDIBA2009: posts big blind 100
*** HOLE CARDS ***
s70n3fac3: raises 200 to 300
FDIBA2009: calls 200
*** FLOP *** [3d 7d Th]
FDIBA2009: checks 
s70n3fac3: bets 567
FDIBA2009: calls 567
*** TURN *** [3d 7d Th] [4s]
FDIBA2009: checks 
s70n3fac3: bets 1639
FDIBA2009: folds 
Uncalled bet (1639) returned to s70n3fac3
s70n3fac3 collected 1639 from pot
s70n3fac3: doesn't show hand 
*** SUMMARY ***
Total pot 1734 | Rake 95 
Board [3d 7d Th 4s]
Seat 1: s70n3fac3 (button) (small blind) collected (1639)
Seat 2: FDIBA2009 (big blind) folded on the Turn



PokerStars Home Game Hand #227251094549: {Club #4781089}  Hold'em No Limit (50/100) - 2021/06/02 0:03:25 EET [2021/06/01 17:03:25 ET]
Table 'VTPP NLHE 0106' 2-max (Play Money) Seat #2 is the button
Seat 1: s70n3fac3 (9530 in chips) 
Seat 2: FDIBA2009 (27530 in chips) 
FDIBA2009: posts small blind 50
s70n3fac3: posts big blind 100
*** HOLE CARDS ***
FDIBA2009: raises 100 to 200
s70n3fac3: raises 400 to 600
FDIBA2009: calls 400
*** FLOP *** [Ac Ks 2c]
s70n3fac3: bets 1134
FDIBA2009: folds 
Uncalled bet (1134) returned to s70n3fac3
s70n3fac3 collected 1134 from pot
s70n3fac3: doesn't show hand 
*** SUMMARY ***
Total pot 1200 | Rake 66 
Board [Ac Ks 2c]
Seat 1: s70n3fac3 (big blind) collected (1134)
Seat 2: FDIBA2009 (button) (small blind) folded on the Flop



PokerStars Home Game Hand #227251101222: {Club #4781089}  Hold'em No Limit (50/100) - 2021/06/02 0:03:39 EET [2021/06/01 17:03:39 ET]
Table 'VTPP NLHE 0106' 2-max (Play Money) Seat #1 is the button
Seat 1: s70n3fac3 (10064 in chips) 
Seat 2: FDIBA2009 (26930 in chips) 
s70n3fac3: posts small blind 50
FDIBA2009: posts big blind 100
*** HOLE CARDS ***
s70n3fac3: raises 200 to 300
FDIBA2009: raises 26630 to 26930 and is all-in
s70n3fac3: calls 9764 and is all-in
Uncalled bet (16866) returned to FDIBA2009
*** FLOP *** [8s Jc 6c]
*** TURN *** [8s Jc 6c] [4c]
*** RIVER *** [8s Jc 6c 4c] [3s]
*** SHOW DOWN ***
FDIBA2009: shows [Qs Ad] (high card Ace)
s70n3fac3: shows [Qh Qc] (a pair of Queens)
s70n3fac3 collected 19021 from pot
*** SUMMARY ***
Total pot 20128 | Rake 1107 
Board [8s Jc 6c 4c 3s]
Seat 1: s70n3fac3 (button) (small blind) showed [Qh Qc] and won (19021) with a pair of Queens
Seat 2: FDIBA2009 (big blind) showed [Qs Ad] and lost with high card Ace



PokerStars Home Game Hand #227251108160: {Club #4781089}  Hold'em No Limit (50/100) - 2021/06/02 0:03:53 EET [2021/06/01 17:03:53 ET]
Table 'VTPP NLHE 0106' 2-max (Play Money) Seat #2 is the button
Seat 1: s70n3fac3 (19021 in chips) 
Seat 2: FDIBA2009 (16866 in chips) 
FDIBA2009: posts small blind 50
s70n3fac3: posts big blind 100
*** HOLE CARDS ***
FDIBA2009: raises 100 to 200
s70n3fac3: folds 
Uncalled bet (100) returned to FDIBA2009
FDIBA2009 collected 200 from pot
FDIBA2009: doesn't show hand 
*** SUMMARY ***
Total pot 200 | Rake 0 
Seat 1: s70n3fac3 (big blind) folded before Flop
Seat 2: FDIBA2009 (button) (small blind) collected (200)



PokerStars Home Game Hand #227251111338: {Club #4781089}  Hold'em No Limit (50/100) - 2021/06/02 0:03:59 EET [2021/06/01 17:03:59 ET]
Table 'VTPP NLHE 0106' 2-max (Play Money) Seat #1 is the button
Seat 1: s70n3fac3 (18921 in chips) 
Seat 2: FDIBA2009 (16966 in chips) 
s70n3fac3: posts small blind 50
FDIBA2009: posts big blind 100
*** HOLE CARDS ***
s70n3fac3: folds 
Uncalled bet (50) returned to FDIBA2009
FDIBA2009 collected 100 from pot
FDIBA2009: doesn't show hand 
*** SUMMARY ***
Total pot 100 | Rake 0 
Seat 1: s70n3fac3 (button) (small blind) folded before Flop
Seat 2: FDIBA2009 (big blind) collected (100)



PokerStars Home Game Hand #227251113317: {Club #4781089}  Hold'em No Limit (50/100) - 2021/06/02 0:04:03 EET [2021/06/01 17:04:03 ET]
Table 'VTPP NLHE 0106' 2-max (Play Money) Seat #2 is the button
Seat 1: s70n3fac3 (18871 in chips) 
Seat 2: FDIBA2009 (17016 in chips) 
FDIBA2009: posts small blind 50
s70n3fac3: posts big blind 100
*** HOLE CARDS ***
FDIBA2009: raises 100 to 200
s70n3fac3: calls 100
*** FLOP *** [3h Qh 9d]
s70n3fac3: checks 
FDIBA2009: bets 200
s70n3fac3: calls 200
*** TURN *** [3h Qh 9d] [7c]
s70n3fac3: checks 
FDIBA2009: bets 400
s70n3fac3: folds 
Uncalled bet (400) returned to FDIBA2009
FDIBA2009 collected 756 from pot
FDIBA2009: doesn't show hand 
*** SUMMARY ***
Total pot 800 | Rake 44 
Board [3h Qh 9d 7c]
Seat 1: s70n3fac3 (big blind) folded on the Turn
Seat 2: FDIBA2009 (button) (small blind) collected (756)



PokerStars Home Game Hand #227251121826: {Club #4781089}  Hold'em No Limit (50/100) - 2021/06/02 0:04:20 EET [2021/06/01 17:04:20 ET]
Table 'VTPP NLHE 0106' 2-max (Play Money) Seat #1 is the button
Seat 1: s70n3fac3 (18471 in chips) 
Seat 2: FDIBA2009 (17372 in chips) 
s70n3fac3: posts small blind 50
FDIBA2009: posts big blind 100
*** HOLE CARDS ***
s70n3fac3: raises 150 to 250
FDIBA2009: calls 150
*** FLOP *** [Ad Ah Jd]
FDIBA2009: checks 
s70n3fac3: bets 300
FDIBA2009: folds 
Uncalled bet (300) returned to s70n3fac3
s70n3fac3 collected 472 from pot
s70n3fac3: doesn't show hand 
*** SUMMARY ***
Total pot 500 | Rake 28 
Board [Ad Ah Jd]
Seat 1: s70n3fac3 (button) (small blind) collected (472)
Seat 2: FDIBA2009 (big blind) folded on the Flop



PokerStars Home Game Hand #227251127014: {Club #4781089}  Hold'em No Limit (50/100) - 2021/06/02 0:04:30 EET [2021/06/01 17:04:30 ET]
Table 'VTPP NLHE 0106' 2-max (Play Money) Seat #2 is the button
Seat 1: s70n3fac3 (18693 in chips) 
Seat 2: FDIBA2009 (17122 in chips) 
FDIBA2009: posts small blind 50
s70n3fac3: posts big blind 100
*** HOLE CARDS ***
FDIBA2009: raises 100 to 200
s70n3fac3: folds 
Uncalled bet (100) returned to FDIBA2009
FDIBA2009 collected 200 from pot
FDIBA2009: doesn't show hand 
*** SUMMARY ***
Total pot 200 | Rake 0 
Seat 1: s70n3fac3 (big blind) folded before Flop
Seat 2: FDIBA2009 (button) (small blind) collected (200)



PokerStars Home Game Hand #227251130334: {Club #4781089}  Hold'em No Limit (50/100) - 2021/06/02 0:04:37 EET [2021/06/01 17:04:37 ET]
Table 'VTPP NLHE 0106' 2-max (Play Money) Seat #1 is the button
Seat 1: s70n3fac3 (18593 in chips) 
Seat 2: FDIBA2009 (17222 in chips) 
s70n3fac3: posts small blind 50
FDIBA2009: posts big blind 100
*** HOLE CARDS ***
s70n3fac3: raises 150 to 250
FDIBA2009: calls 150
*** FLOP *** [6d 9s Kc]
FDIBA2009: checks 
s70n3fac3: checks 
*** TURN *** [6d 9s Kc] [5h]
FDIBA2009: bets 250
s70n3fac3: folds 
Uncalled bet (250) returned to FDIBA2009
FDIBA2009 collected 472 from pot
FDIBA2009: doesn't show hand 
*** SUMMARY ***
Total pot 500 | Rake 28 
Board [6d 9s Kc 5h]
Seat 1: s70n3fac3 (button) (small blind) folded on the Turn
Seat 2: FDIBA2009 (big blind) collected (472)



PokerStars Home Game Hand #227251137529: {Club #4781089}  Hold'em No Limit (50/100) - 2021/06/02 0:04:52 EET [2021/06/01 17:04:52 ET]
Table 'VTPP NLHE 0106' 2-max (Play Money) Seat #2 is the button
Seat 1: s70n3fac3 (18343 in chips) 
Seat 2: FDIBA2009 (17444 in chips) 
FDIBA2009: posts small blind 50
s70n3fac3: posts big blind 100
*** HOLE CARDS ***
FDIBA2009: raises 100 to 200
s70n3fac3: calls 100
*** FLOP *** [4h 9d Jh]
s70n3fac3: checks 
FDIBA2009: checks 
*** TURN *** [4h 9d Jh] [7c]
s70n3fac3: checks 
FDIBA2009: checks 
*** RIVER *** [4h 9d Jh 7c] [6d]
s70n3fac3: checks 
FDIBA2009: checks 
*** SHOW DOWN ***
s70n3fac3: shows [5h Ad] (high card Ace)
FDIBA2009: mucks hand 
s70n3fac3 collected 378 from pot
*** SUMMARY ***
Total pot 400 | Rake 22 
Board [4h 9d Jh 7c 6d]
Seat 1: s70n3fac3 (big blind) showed [5h Ad] and won (378) with high card Ace
Seat 2: FDIBA2009 (button) (small blind) mucked [Qd 3h]



PokerStars Home Game Hand #227251144821: {Club #4781089}  Hold'em No Limit (50/100) - 2021/06/02 0:05:06 EET [2021/06/01 17:05:06 ET]
Table 'VTPP NLHE 0106' 2-max (Play Money) Seat #1 is the button
Seat 1: s70n3fac3 (18521 in chips) 
Seat 2: FDIBA2009 (17244 in chips) 
s70n3fac3: posts small blind 50
FDIBA2009: posts big blind 100
*** HOLE CARDS ***
s70n3fac3: folds 
Uncalled bet (50) returned to FDIBA2009
FDIBA2009 collected 100 from pot
FDIBA2009: doesn't show hand 
*** SUMMARY ***
Total pot 100 | Rake 0 
Seat 1: s70n3fac3 (button) (small blind) folded before Flop
Seat 2: FDIBA2009 (big blind) collected (100)



PokerStars Home Game Hand #227251146728: {Club #4781089}  Hold'em No Limit (50/100) - 2021/06/02 0:05:10 EET [2021/06/01 17:05:10 ET]
Table 'VTPP NLHE 0106' 2-max (Play Money) Seat #2 is the button
Seat 1: s70n3fac3 (18471 in chips) 
Seat 2: FDIBA2009 (17294 in chips) 
FDIBA2009: posts small blind 50
s70n3fac3: posts big blind 100
*** HOLE CARDS ***
FDIBA2009: raises 100 to 200
s70n3fac3: folds 
Uncalled bet (100) returned to FDIBA2009
FDIBA2009 collected 200 from pot
FDIBA2009: doesn't show hand 
*** SUMMARY ***
Total pot 200 | Rake 0 
Seat 1: s70n3fac3 (big blind) folded before Flop
Seat 2: FDIBA2009 (button) (small blind) collected (200)



PokerStars Home Game Hand #227251150207: {Club #4781089}  Hold'em No Limit (50/100) - 2021/06/02 0:05:17 EET [2021/06/01 17:05:17 ET]
Table 'VTPP NLHE 0106' 2-max (Play Money) Seat #1 is the button
Seat 1: s70n3fac3 (18371 in chips) 
Seat 2: FDIBA2009 (17394 in chips) 
s70n3fac3: posts small blind 50
FDIBA2009: posts big blind 100
*** HOLE CARDS ***
s70n3fac3: raises 150 to 250
FDIBA2009: calls 150
*** FLOP *** [Jd 2h Kd]
FDIBA2009: checks 
s70n3fac3: bets 300
FDIBA2009: calls 300
*** TURN *** [Jd 2h Kd] [7h]
FDIBA2009: checks 
s70n3fac3: checks 
*** RIVER *** [Jd 2h Kd 7h] [4c]
FDIBA2009: bets 250
s70n3fac3: folds 
Uncalled bet (250) returned to FDIBA2009
FDIBA2009 collected 1039 from pot
FDIBA2009: doesn't show hand 
*** SUMMARY ***
Total pot 1100 | Rake 61 
Board [Jd 2h Kd 7h 4c]
Seat 1: s70n3fac3 (button) (small blind) folded on the River
Seat 2: FDIBA2009 (big blind) collected (1039)



PokerStars Home Game Hand #227251164401: {Club #4781089}  Hold'em No Limit (50/100) - 2021/06/02 0:05:46 EET [2021/06/01 17:05:46 ET]
Table 'VTPP NLHE 0106' 2-max (Play Money) Seat #2 is the button
Seat 1: s70n3fac3 (17821 in chips) 
Seat 2: FDIBA2009 (17883 in chips) 
FDIBA2009: posts small blind 50
s70n3fac3: posts big blind 100
*** HOLE CARDS ***
FDIBA2009: raises 100 to 200
s70n3fac3: calls 100
*** FLOP *** [7s 4c Tc]
s70n3fac3: checks 
FDIBA2009: checks 
*** TURN *** [7s 4c Tc] [Ad]
s70n3fac3: checks 
FDIBA2009: checks 
*** RIVER *** [7s 4c Tc Ad] [Kh]
s70n3fac3: bets 400
FDIBA2009: folds 
Uncalled bet (400) returned to s70n3fac3
s70n3fac3 collected 378 from pot
s70n3fac3: doesn't show hand 
*** SUMMARY ***
Total pot 400 | Rake 22 
Board [7s 4c Tc Ad Kh]
Seat 1: s70n3fac3 (big blind) collected (378)
Seat 2: FDIBA2009 (button) (small blind) folded on the River



PokerStars Home Game Hand #227251174374: {Club #4781089}  Hold'em No Limit (50/100) - 2021/06/02 0:06:05 EET [2021/06/01 17:06:05 ET]
Table 'VTPP NLHE 0106' 2-max (Play Money) Seat #1 is the button
Seat 1: s70n3fac3 (17999 in chips) 
Seat 2: FDIBA2009 (17683 in chips) 
s70n3fac3: posts small blind 50
FDIBA2009: posts big blind 100
*** HOLE CARDS ***
s70n3fac3: raises 150 to 250
FDIBA2009: calls 150
*** FLOP *** [8d Ac 3h]
FDIBA2009: checks 
s70n3fac3: checks 
*** TURN *** [8d Ac 3h] [Jc]
FDIBA2009: bets 250
s70n3fac3: raises 450 to 700
FDIBA2009: calls 450
*** RIVER *** [8d Ac 3h Jc] [4s]
FDIBA2009: checks 
s70n3fac3: bets 1795
FDIBA2009: calls 1795
*** SHOW DOWN ***
s70n3fac3: shows [Jh Ah] (two pair, Aces and Jacks)
FDIBA2009: mucks hand 
s70n3fac3 collected 5188 from pot
*** SUMMARY ***
Total pot 5490 | Rake 302 
Board [8d Ac 3h Jc 4s]
Seat 1: s70n3fac3 (button) (small blind) showed [Jh Ah] and won (5188) with two pair, Aces and Jacks
Seat 2: FDIBA2009 (big blind) mucked [Tc Js]



PokerStars Home Game Hand #227251196129: {Club #4781089}  Hold'em No Limit (50/100) - 2021/06/02 0:06:40 EET [2021/06/01 17:06:40 ET]
Table 'VTPP NLHE 0106' 2-max (Play Money) Seat #2 is the button
Seat 1: s70n3fac3 (20442 in chips) 
Seat 2: FDIBA2009 (14938 in chips) 
FDIBA2009: posts small blind 50
s70n3fac3: posts big blind 100
*** HOLE CARDS ***
FDIBA2009: raises 100 to 200
s70n3fac3: calls 100
*** FLOP *** [Jc Qh Kd]
s70n3fac3: checks 
FDIBA2009: bets 189
s70n3fac3: folds 
Uncalled bet (189) returned to FDIBA2009
FDIBA2009 collected 378 from pot
FDIBA2009: doesn't show hand 
*** SUMMARY ***
Total pot 400 | Rake 22 
Board [Jc Qh Kd]
Seat 1: s70n3fac3 (big blind) folded on the Flop
Seat 2: FDIBA2009 (button) (small blind) collected (378)



PokerStars Home Game Hand #227251202451: {Club #4781089}  Hold'em No Limit (50/100) - 2021/06/02 0:06:53 EET [2021/06/01 17:06:53 ET]
Table 'VTPP NLHE 0106' 2-max (Play Money) Seat #1 is the button
Seat 1: s70n3fac3 (20242 in chips) 
Seat 2: FDIBA2009 (15116 in chips) 
s70n3fac3: posts small blind 50
FDIBA2009: posts big blind 100
*** HOLE CARDS ***
s70n3fac3: folds 
Uncalled bet (50) returned to FDIBA2009
FDIBA2009 collected 100 from pot
FDIBA2009: doesn't show hand 
*** SUMMARY ***
Total pot 100 | Rake 0 
Seat 1: s70n3fac3 (button) (small blind) folded before Flop
Seat 2: FDIBA2009 (big blind) collected (100)



PokerStars Home Game Hand #227251204249: {Club #4781089}  Hold'em No Limit (50/100) - 2021/06/02 0:06:57 EET [2021/06/01 17:06:57 ET]
Table 'VTPP NLHE 0106' 2-max (Play Money) Seat #2 is the button
Seat 1: s70n3fac3 (20192 in chips) 
Seat 2: FDIBA2009 (15166 in chips) 
FDIBA2009: posts small blind 50
s70n3fac3: posts big blind 100
*** HOLE CARDS ***
FDIBA2009: raises 100 to 200
s70n3fac3: raises 400 to 600
FDIBA2009: calls 400
*** FLOP *** [Jd 6d 9c]
s70n3fac3: bets 800
FDIBA2009: folds 
Uncalled bet (800) returned to s70n3fac3
s70n3fac3 collected 1134 from pot
s70n3fac3: doesn't show hand 
*** SUMMARY ***
Total pot 1200 | Rake 66 
Board [Jd 6d 9c]
Seat 1: s70n3fac3 (big blind) collected (1134)
Seat 2: FDIBA2009 (button) (small blind) folded on the Flop



PokerStars Home Game Hand #227251210959: {Club #4781089}  Hold'em No Limit (50/100) - 2021/06/02 0:07:10 EET [2021/06/01 17:07:10 ET]
Table 'VTPP NLHE 0106' 2-max (Play Money) Seat #1 is the button
Seat 1: s70n3fac3 (20726 in chips) 
Seat 2: FDIBA2009 (14566 in chips) 
s70n3fac3: posts small blind 50
FDIBA2009: posts big blind 100
*** HOLE CARDS ***
s70n3fac3: folds 
Uncalled bet (50) returned to FDIBA2009
FDIBA2009 collected 100 from pot
FDIBA2009: doesn't show hand 
*** SUMMARY ***
Total pot 100 | Rake 0 
Seat 1: s70n3fac3 (button) (small blind) folded before Flop
Seat 2: FDIBA2009 (big blind) collected (100)



PokerStars Home Game Hand #227251212836: {Club #4781089}  Hold'em No Limit (50/100) - 2021/06/02 0:07:14 EET [2021/06/01 17:07:14 ET]
Table 'VTPP NLHE 0106' 2-max (Play Money) Seat #2 is the button
Seat 1: s70n3fac3 (20676 in chips) 
Seat 2: FDIBA2009 (14616 in chips) 
FDIBA2009: posts small blind 50
s70n3fac3: posts big blind 100
*** HOLE CARDS ***
FDIBA2009: raises 100 to 200
s70n3fac3: calls 100
*** FLOP *** [4s 4c 7s]
s70n3fac3: checks 
FDIBA2009: checks 
*** TURN *** [4s 4c 7s] [Tc]
s70n3fac3: checks 
FDIBA2009: checks 
*** RIVER *** [4s 4c 7s Tc] [2c]
s70n3fac3: checks 
FDIBA2009: checks 
*** SHOW DOWN ***
s70n3fac3: shows [5s 6s] (a pair of Fours)
FDIBA2009: shows [9d Ad] (a pair of Fours - Ace kicker)
FDIBA2009 collected 378 from pot
*** SUMMARY ***
Total pot 400 | Rake 22 
Board [4s 4c 7s Tc 2c]
Seat 1: s70n3fac3 (big blind) showed [5s 6s] and lost with a pair of Fours
Seat 2: FDIBA2009 (button) (small blind) showed [9d Ad] and won (378) with a pair of Fours



PokerStars Home Game Hand #227251220448: {Club #4781089}  Hold'em No Limit (50/100) - 2021/06/02 0:07:29 EET [2021/06/01 17:07:29 ET]
Table 'VTPP NLHE 0106' 2-max (Play Money) Seat #1 is the button
Seat 1: s70n3fac3 (20476 in chips) 
Seat 2: FDIBA2009 (14794 in chips) 
s70n3fac3: posts small blind 50
FDIBA2009: posts big blind 100
*** HOLE CARDS ***
s70n3fac3: raises 150 to 250
FDIBA2009: folds 
Uncalled bet (150) returned to s70n3fac3
s70n3fac3 collected 200 from pot
s70n3fac3: doesn't show hand 
*** SUMMARY ***
Total pot 200 | Rake 0 
Seat 1: s70n3fac3 (button) (small blind) collected (200)
Seat 2: FDIBA2009 (big blind) folded before Flop



PokerStars Home Game Hand #227251223124: {Club #4781089}  Hold'em No Limit (50/100) - 2021/06/02 0:07:35 EET [2021/06/01 17:07:35 ET]
Table 'VTPP NLHE 0106' 2-max (Play Money) Seat #2 is the button
Seat 1: s70n3fac3 (20576 in chips) 
Seat 2: FDIBA2009 (14694 in chips) 
FDIBA2009: posts small blind 50
s70n3fac3: posts big blind 100
*** HOLE CARDS ***
FDIBA2009: raises 200 to 300
s70n3fac3: calls 200
*** FLOP *** [4c Th 8s]
s70n3fac3: checks 
FDIBA2009: bets 300
s70n3fac3: calls 300
*** TURN *** [4c Th 8s] [Qc]
s70n3fac3: checks 
FDIBA2009: bets 700
s70n3fac3: folds 
Uncalled bet (700) returned to FDIBA2009
FDIBA2009 collected 1134 from pot
FDIBA2009: doesn't show hand 
*** SUMMARY ***
Total pot 1200 | Rake 66 
Board [4c Th 8s Qc]
Seat 1: s70n3fac3 (big blind) folded on the Turn
Seat 2: FDIBA2009 (button) (small blind) collected (1134)



PokerStars Home Game Hand #227251235615: {Club #4781089}  Hold'em No Limit (50/100) - 2021/06/02 0:08:00 EET [2021/06/01 17:08:00 ET]
Table 'VTPP NLHE 0106' 2-max (Play Money) Seat #1 is the button
Seat 1: s70n3fac3 (19976 in chips) 
Seat 2: FDIBA2009 (15228 in chips) 
s70n3fac3: posts small blind 50
FDIBA2009: posts big blind 100
*** HOLE CARDS ***
s70n3fac3: raises 150 to 250
FDIBA2009: folds 
Uncalled bet (150) returned to s70n3fac3
s70n3fac3 collected 200 from pot
s70n3fac3: doesn't show hand 
*** SUMMARY ***
Total pot 200 | Rake 0 
Seat 1: s70n3fac3 (button) (small blind) collected (200)
Seat 2: FDIBA2009 (big blind) folded before Flop



PokerStars Home Game Hand #227251238265: {Club #4781089}  Hold'em No Limit (50/100) - 2021/06/02 0:08:06 EET [2021/06/01 17:08:06 ET]
Table 'VTPP NLHE 0106' 2-max (Play Money) Seat #2 is the button
Seat 1: s70n3fac3 (20076 in chips) 
Seat 2: FDIBA2009 (15128 in chips) 
FDIBA2009: posts small blind 50
s70n3fac3: posts big blind 100
*** HOLE CARDS ***
FDIBA2009: raises 100 to 200
s70n3fac3: folds 
Uncalled bet (100) returned to FDIBA2009
FDIBA2009 collected 200 from pot
FDIBA2009: doesn't show hand 
*** SUMMARY ***
Total pot 200 | Rake 0 
Seat 1: s70n3fac3 (big blind) folded before Flop
Seat 2: FDIBA2009 (button) (small blind) collected (200)



PokerStars Home Game Hand #227251241215: {Club #4781089}  Hold'em No Limit (50/100) - 2021/06/02 0:08:12 EET [2021/06/01 17:08:12 ET]
Table 'VTPP NLHE 0106' 2-max (Play Money) Seat #1 is the button
Seat 1: s70n3fac3 (19976 in chips) 
Seat 2: FDIBA2009 (15228 in chips) 
s70n3fac3: posts small blind 50
FDIBA2009: posts big blind 100
*** HOLE CARDS ***
s70n3fac3: folds 
Uncalled bet (50) returned to FDIBA2009
FDIBA2009 collected 100 from pot
FDIBA2009: doesn't show hand 
*** SUMMARY ***
Total pot 100 | Rake 0 
Seat 1: s70n3fac3 (button) (small blind) folded before Flop
Seat 2: FDIBA2009 (big blind) collected (100)



PokerStars Home Game Hand #227251243005: {Club #4781089}  Hold'em No Limit (50/100) - 2021/06/02 0:08:15 EET [2021/06/01 17:08:15 ET]
Table 'VTPP NLHE 0106' 2-max (Play Money) Seat #2 is the button
Seat 1: s70n3fac3 (19926 in chips) 
Seat 2: FDIBA2009 (15278 in chips) 
FDIBA2009: posts small blind 50
s70n3fac3: posts big blind 100
*** HOLE CARDS ***
FDIBA2009: raises 200 to 300
s70n3fac3: folds 
Uncalled bet (200) returned to FDIBA2009
FDIBA2009 collected 200 from pot
FDIBA2009: doesn't show hand 
*** SUMMARY ***
Total pot 200 | Rake 0 
Seat 1: s70n3fac3 (big blind) folded before Flop
Seat 2: FDIBA2009 (button) (small blind) collected (200)



PokerStars Home Game Hand #227251246503: {Club #4781089}  Hold'em No Limit (50/100) - 2021/06/02 0:08:22 EET [2021/06/01 17:08:22 ET]
Table 'VTPP NLHE 0106' 2-max (Play Money) Seat #1 is the button
Seat 1: s70n3fac3 (19826 in chips) 
Seat 2: FDIBA2009 (15378 in chips) 
s70n3fac3: posts small blind 50
FDIBA2009: posts big blind 100
*** HOLE CARDS ***
s70n3fac3: raises 150 to 250
FDIBA2009: raises 150 to 400
s70n3fac3: calls 150
*** FLOP *** [5c As Js]
FDIBA2009: checks 
s70n3fac3: checks 
*** TURN *** [5c As Js] [Ts]
FDIBA2009: bets 450
s70n3fac3: calls 450
*** RIVER *** [5c As Js Ts] [4c]
FDIBA2009: checks 
s70n3fac3: bets 1606
FDIBA2009: folds 
Uncalled bet (1606) returned to s70n3fac3
s70n3fac3 collected 1606 from pot
s70n3fac3: doesn't show hand 
*** SUMMARY ***
Total pot 1700 | Rake 94 
Board [5c As Js Ts 4c]
Seat 1: s70n3fac3 (button) (small blind) collected (1606)
Seat 2: FDIBA2009 (big blind) folded on the River



PokerStars Home Game Hand #227251258762: {Club #4781089}  Hold'em No Limit (50/100) - 2021/06/02 0:08:48 EET [2021/06/01 17:08:48 ET]
Table 'VTPP NLHE 0106' 2-max (Play Money) Seat #2 is the button
Seat 1: s70n3fac3 (20582 in chips) 
Seat 2: FDIBA2009 (14528 in chips) 
FDIBA2009: posts small blind 50
s70n3fac3: posts big blind 100
*** HOLE CARDS ***
FDIBA2009: raises 100 to 200
s70n3fac3: raises 500 to 700
FDIBA2009: calls 500
*** FLOP *** [Jc 5s Ts]
s70n3fac3: bets 700
FDIBA2009: folds 
Uncalled bet (700) returned to s70n3fac3
s70n3fac3 collected 1323 from pot
s70n3fac3: doesn't show hand 
*** SUMMARY ***
Total pot 1400 | Rake 77 
Board [Jc 5s Ts]
Seat 1: s70n3fac3 (big blind) collected (1323)
Seat 2: FDIBA2009 (button) (small blind) folded on the Flop



PokerStars Home Game Hand #227251264815: {Club #4781089}  Hold'em No Limit (50/100) - 2021/06/02 0:09:00 EET [2021/06/01 17:09:00 ET]
Table 'VTPP NLHE 0106' 2-max (Play Money) Seat #1 is the button
Seat 1: s70n3fac3 (21205 in chips) 
Seat 2: FDIBA2009 (13828 in chips) 
s70n3fac3: posts small blind 50
FDIBA2009: posts big blind 100
*** HOLE CARDS ***
s70n3fac3: folds 
Uncalled bet (50) returned to FDIBA2009
FDIBA2009 collected 100 from pot
FDIBA2009: doesn't show hand 
*** SUMMARY ***
Total pot 100 | Rake 0 
Seat 1: s70n3fac3 (button) (small blind) folded before Flop
Seat 2: FDIBA2009 (big blind) collected (100)



PokerStars Home Game Hand #227251266811: {Club #4781089}  Hold'em No Limit (50/100) - 2021/06/02 0:09:04 EET [2021/06/01 17:09:04 ET]
Table 'VTPP NLHE 0106' 2-max (Play Money) Seat #2 is the button
Seat 1: s70n3fac3 (21155 in chips) 
Seat 2: FDIBA2009 (13878 in chips) 
FDIBA2009: posts small blind 50
s70n3fac3: posts big blind 100
*** HOLE CARDS ***
FDIBA2009: raises 100 to 200
s70n3fac3: folds 
Uncalled bet (100) returned to FDIBA2009
FDIBA2009 collected 200 from pot
FDIBA2009: doesn't show hand 
*** SUMMARY ***
Total pot 200 | Rake 0 
Seat 1: s70n3fac3 (big blind) folded before Flop
Seat 2: FDIBA2009 (button) (small blind) collected (200)



PokerStars Home Game Hand #227251269910: {Club #4781089}  Hold'em No Limit (50/100) - 2021/06/02 0:09:11 EET [2021/06/01 17:09:11 ET]
Table 'VTPP NLHE 0106' 2-max (Play Money) Seat #1 is the button
Seat 1: s70n3fac3 (21055 in chips) 
Seat 2: FDIBA2009 (13978 in chips) 
s70n3fac3: posts small blind 50
FDIBA2009: posts big blind 100
*** HOLE CARDS ***
s70n3fac3: raises 150 to 250
FDIBA2009: raises 500 to 750
s70n3fac3: calls 500
*** FLOP *** [Jh Ts 6c]
FDIBA2009: bets 850
s70n3fac3: calls 850
*** TURN *** [Jh Ts 6c] [Tc]
FDIBA2009: bets 1550
s70n3fac3: folds 
Uncalled bet (1550) returned to FDIBA2009
FDIBA2009 collected 3024 from pot
FDIBA2009: doesn't show hand 
*** SUMMARY ***
Total pot 3200 | Rake 176 
Board [Jh Ts 6c Tc]
Seat 1: s70n3fac3 (button) (small blind) folded on the Turn
Seat 2: FDIBA2009 (big blind) collected (3024)



PokerStars Home Game Hand #227251289605: {Club #4781089}  Hold'em No Limit (50/100) - 2021/06/02 0:09:41 EET [2021/06/01 17:09:41 ET]
Table 'VTPP NLHE 0106' 2-max (Play Money) Seat #2 is the button
Seat 1: s70n3fac3 (19455 in chips) 
Seat 2: FDIBA2009 (15402 in chips) 
FDIBA2009: posts small blind 50
s70n3fac3: posts big blind 100
*** HOLE CARDS ***
FDIBA2009: raises 100 to 200
s70n3fac3: folds 
Uncalled bet (100) returned to FDIBA2009
FDIBA2009 collected 200 from pot
FDIBA2009: doesn't show hand 
*** SUMMARY ***
Total pot 200 | Rake 0 
Seat 1: s70n3fac3 (big blind) folded before Flop
Seat 2: FDIBA2009 (button) (small blind) collected (200)



PokerStars Home Game Hand #227251292849: {Club #4781089}  Hold'em No Limit (50/100) - 2021/06/02 0:09:47 EET [2021/06/01 17:09:47 ET]
Table 'VTPP NLHE 0106' 2-max (Play Money) Seat #1 is the button
Seat 1: s70n3fac3 (19355 in chips) 
Seat 2: FDIBA2009 (15502 in chips) 
s70n3fac3: posts small blind 50
FDIBA2009: posts big blind 100
*** HOLE CARDS ***
s70n3fac3: folds 
Uncalled bet (50) returned to FDIBA2009
FDIBA2009 collected 100 from pot
FDIBA2009: doesn't show hand 
*** SUMMARY ***
Total pot 100 | Rake 0 
Seat 1: s70n3fac3 (button) (small blind) folded before Flop
Seat 2: FDIBA2009 (big blind) collected (100)



PokerStars Home Game Hand #227251294614: {Club #4781089}  Hold'em No Limit (50/100) - 2021/06/02 0:09:51 EET [2021/06/01 17:09:51 ET]
Table 'VTPP NLHE 0106' 2-max (Play Money) Seat #2 is the button
Seat 1: s70n3fac3 (19305 in chips) 
Seat 2: FDIBA2009 (15552 in chips) 
FDIBA2009: posts small blind 50
s70n3fac3: posts big blind 100
*** HOLE CARDS ***
FDIBA2009: folds 
Uncalled bet (50) returned to s70n3fac3
s70n3fac3 collected 100 from pot
s70n3fac3: doesn't show hand 
*** SUMMARY ***
Total pot 100 | Rake 0 
Seat 1: s70n3fac3 (big blind) collected (100)
Seat 2: FDIBA2009 (button) (small blind) folded before Flop



PokerStars Home Game Hand #227251297589: {Club #4781089}  Hold'em No Limit (50/100) - 2021/06/02 0:09:57 EET [2021/06/01 17:09:57 ET]
Table 'VTPP NLHE 0106' 2-max (Play Money) Seat #1 is the button
Seat 1: s70n3fac3 (19355 in chips) 
Seat 2: FDIBA2009 (15502 in chips) 
s70n3fac3: posts small blind 50
FDIBA2009: posts big blind 100
*** HOLE CARDS ***
s70n3fac3: raises 150 to 250
FDIBA2009: calls 150
*** FLOP *** [2h 9s 4h]
FDIBA2009: checks 
s70n3fac3: bets 300
FDIBA2009: calls 300
*** TURN *** [2h 9s 4h] [Ks]
FDIBA2009: checks 
s70n3fac3: checks 
*** RIVER *** [2h 9s 4h Ks] [3d]
FDIBA2009: bets 600
s70n3fac3: folds 
Uncalled bet (600) returned to FDIBA2009
FDIBA2009 collected 1039 from pot
FDIBA2009: doesn't show hand 
*** SUMMARY ***
Total pot 1100 | Rake 61 
Board [2h 9s 4h Ks 3d]
Seat 1: s70n3fac3 (button) (small blind) folded on the River
Seat 2: FDIBA2009 (big blind) collected (1039)



PokerStars Home Game Hand #227251311451: {Club #4781089}  Hold'em No Limit (50/100) - 2021/06/02 0:10:25 EET [2021/06/01 17:10:25 ET]
Table 'VTPP NLHE 0106' 2-max (Play Money) Seat #2 is the button
Seat 1: s70n3fac3 (18805 in chips) 
Seat 2: FDIBA2009 (15991 in chips) 
FDIBA2009: posts small blind 50
s70n3fac3: posts big blind 100
*** HOLE CARDS ***
FDIBA2009: raises 100 to 200
s70n3fac3: calls 100
*** FLOP *** [Th Td 4s]
s70n3fac3: checks 
FDIBA2009: checks 
*** TURN *** [Th Td 4s] [7d]
s70n3fac3: checks 
FDIBA2009: checks 
*** RIVER *** [Th Td 4s 7d] [9c]
s70n3fac3: checks 
FDIBA2009: checks 
*** SHOW DOWN ***
s70n3fac3: shows [3s 5c] (a pair of Tens)
FDIBA2009: shows [6h Js] (a pair of Tens - Jack kicker)
FDIBA2009 collected 378 from pot
*** SUMMARY ***
Total pot 400 | Rake 22 
Board [Th Td 4s 7d 9c]
Seat 1: s70n3fac3 (big blind) showed [3s 5c] and lost with a pair of Tens
Seat 2: FDIBA2009 (button) (small blind) showed [6h Js] and won (378) with a pair of Tens



PokerStars Home Game Hand #227251318645: {Club #4781089}  Hold'em No Limit (50/100) - 2021/06/02 0:10:39 EET [2021/06/01 17:10:39 ET]
Table 'VTPP NLHE 0106' 2-max (Play Money) Seat #1 is the button
Seat 1: s70n3fac3 (18605 in chips) 
Seat 2: FDIBA2009 (16169 in chips) 
s70n3fac3: posts small blind 50
FDIBA2009: posts big blind 100
*** HOLE CARDS ***
s70n3fac3: raises 100 to 200
FDIBA2009: raises 100 to 300
s70n3fac3: calls 100
*** FLOP *** [9h 8h 7c]
FDIBA2009: bets 300
s70n3fac3: folds 
Uncalled bet (300) returned to FDIBA2009
FDIBA2009 collected 567 from pot
FDIBA2009: doesn't show hand 
*** SUMMARY ***
Total pot 600 | Rake 33 
Board [9h 8h 7c]
Seat 1: s70n3fac3 (button) (small blind) folded on the Flop
Seat 2: FDIBA2009 (big blind) collected (567)



PokerStars Home Game Hand #227251324616: {Club #4781089}  Hold'em No Limit (50/100) - 2021/06/02 0:10:52 EET [2021/06/01 17:10:52 ET]
Table 'VTPP NLHE 0106' 2-max (Play Money) Seat #2 is the button
Seat 1: s70n3fac3 (18305 in chips) 
Seat 2: FDIBA2009 (16436 in chips) 
FDIBA2009: posts small blind 50
s70n3fac3: posts big blind 100
*** HOLE CARDS ***
FDIBA2009: raises 100 to 200
s70n3fac3: calls 100
*** FLOP *** [5h Qh Ah]
s70n3fac3: checks 
FDIBA2009: checks 
*** TURN *** [5h Qh Ah] [2d]
s70n3fac3: checks 
FDIBA2009: bets 200
s70n3fac3: calls 200
*** RIVER *** [5h Qh Ah 2d] [Tc]
s70n3fac3: checks 
FDIBA2009: bets 400
s70n3fac3: folds 
Uncalled bet (400) returned to FDIBA2009
FDIBA2009 collected 756 from pot
FDIBA2009: doesn't show hand 
*** SUMMARY ***
Total pot 800 | Rake 44 
Board [5h Qh Ah 2d Tc]
Seat 1: s70n3fac3 (big blind) folded on the River
Seat 2: FDIBA2009 (button) (small blind) collected (756)



PokerStars Home Game Hand #227251339002: {Club #4781089}  Hold'em No Limit (50/100) - 2021/06/02 0:11:21 EET [2021/06/01 17:11:21 ET]
Table 'VTPP NLHE 0106' 2-max (Play Money) Seat #1 is the button
Seat 1: s70n3fac3 (17905 in chips) 
Seat 2: FDIBA2009 (16792 in chips) 
s70n3fac3: posts small blind 50
FDIBA2009: posts big blind 100
*** HOLE CARDS ***
s70n3fac3: folds 
Uncalled bet (50) returned to FDIBA2009
FDIBA2009 collected 100 from pot
FDIBA2009: doesn't show hand 
*** SUMMARY ***
Total pot 100 | Rake 0 
Seat 1: s70n3fac3 (button) (small blind) folded before Flop
Seat 2: FDIBA2009 (big blind) collected (100)



PokerStars Home Game Hand #227251340789: {Club #4781089}  Hold'em No Limit (50/100) - 2021/06/02 0:11:24 EET [2021/06/01 17:11:24 ET]
Table 'VTPP NLHE 0106' 2-max (Play Money) Seat #2 is the button
Seat 1: s70n3fac3 (17855 in chips) 
Seat 2: FDIBA2009 (16842 in chips) 
FDIBA2009: posts small blind 50
s70n3fac3: posts big blind 100
*** HOLE CARDS ***
FDIBA2009: raises 100 to 200
s70n3fac3: raises 400 to 600
FDIBA2009: folds 
Uncalled bet (400) returned to s70n3fac3
s70n3fac3 collected 400 from pot
s70n3fac3: doesn't show hand 
*** SUMMARY ***
Total pot 400 | Rake 0 
Seat 1: s70n3fac3 (big blind) collected (400)
Seat 2: FDIBA2009 (button) (small blind) folded before Flop



PokerStars Home Game Hand #227251344435: {Club #4781089}  Hold'em No Limit (50/100) - 2021/06/02 0:11:32 EET [2021/06/01 17:11:32 ET]
Table 'VTPP NLHE 0106' 2-max (Play Money) Seat #1 is the button
Seat 1: s70n3fac3 (18055 in chips) 
Seat 2: FDIBA2009 (16642 in chips) 
s70n3fac3: posts small blind 50
FDIBA2009: posts big blind 100
*** HOLE CARDS ***
s70n3fac3: raises 150 to 250
FDIBA2009: calls 150
*** FLOP *** [Ah Qd 3h]
FDIBA2009: checks 
s70n3fac3: bets 300
FDIBA2009: folds 
Uncalled bet (300) returned to s70n3fac3
s70n3fac3 collected 472 from pot
s70n3fac3: doesn't show hand 
*** SUMMARY ***
Total pot 500 | Rake 28 
Board [Ah Qd 3h]
Seat 1: s70n3fac3 (button) (small blind) collected (472)
Seat 2: FDIBA2009 (big blind) folded on the Flop



PokerStars Home Game Hand #227251349481: {Club #4781089}  Hold'em No Limit (50/100) - 2021/06/02 0:11:43 EET [2021/06/01 17:11:43 ET]
Table 'VTPP NLHE 0106' 2-max (Play Money) Seat #2 is the button
Seat 1: s70n3fac3 (18277 in chips) 
Seat 2: FDIBA2009 (16392 in chips) 
FDIBA2009: posts small blind 50
s70n3fac3: posts big blind 100
*** HOLE CARDS ***
FDIBA2009: raises 100 to 200
s70n3fac3: folds 
Uncalled bet (100) returned to FDIBA2009
FDIBA2009 collected 200 from pot
FDIBA2009: doesn't show hand 
*** SUMMARY ***
Total pot 200 | Rake 0 
Seat 1: s70n3fac3 (big blind) folded before Flop
Seat 2: FDIBA2009 (button) (small blind) collected (200)



PokerStars Home Game Hand #227251352614: {Club #4781089}  Hold'em No Limit (50/100) - 2021/06/02 0:11:49 EET [2021/06/01 17:11:49 ET]
Table 'VTPP NLHE 0106' 2-max (Play Money) Seat #1 is the button
Seat 1: s70n3fac3 (18177 in chips) 
Seat 2: FDIBA2009 (16492 in chips) 
s70n3fac3: posts small blind 50
FDIBA2009: posts big blind 100
*** HOLE CARDS ***
s70n3fac3: folds 
Uncalled bet (50) returned to FDIBA2009
FDIBA2009 collected 100 from pot
FDIBA2009: doesn't show hand 
*** SUMMARY ***
Total pot 100 | Rake 0 
Seat 1: s70n3fac3 (button) (small blind) folded before Flop
Seat 2: FDIBA2009 (big blind) collected (100)



PokerStars Home Game Hand #227251354542: {Club #4781089}  Hold'em No Limit (50/100) - 2021/06/02 0:11:53 EET [2021/06/01 17:11:53 ET]
Table 'VTPP NLHE 0106' 2-max (Play Money) Seat #2 is the button
Seat 1: s70n3fac3 (18127 in chips) 
Seat 2: FDIBA2009 (16542 in chips) 
FDIBA2009: posts small blind 50
s70n3fac3: posts big blind 100
*** HOLE CARDS ***
FDIBA2009: raises 100 to 200
s70n3fac3: calls 100
*** FLOP *** [4h Kd 7s]
s70n3fac3: checks 
FDIBA2009: checks 
*** TURN *** [4h Kd 7s] [Ks]
s70n3fac3: checks 
FDIBA2009: bets 378
s70n3fac3: folds 
Uncalled bet (378) returned to FDIBA2009
FDIBA2009 collected 378 from pot
FDIBA2009: doesn't show hand 
*** SUMMARY ***
Total pot 400 | Rake 22 
Board [4h Kd 7s Ks]
Seat 1: s70n3fac3 (big blind) folded on the Turn
Seat 2: FDIBA2009 (button) (small blind) collected (378)



PokerStars Home Game Hand #227251361107: {Club #4781089}  Hold'em No Limit (50/100) - 2021/06/02 0:12:06 EET [2021/06/01 17:12:06 ET]
Table 'VTPP NLHE 0106' 2-max (Play Money) Seat #1 is the button
Seat 1: s70n3fac3 (17927 in chips) 
Seat 2: FDIBA2009 (16720 in chips) 
s70n3fac3: posts small blind 50
FDIBA2009: posts big blind 100
*** HOLE CARDS ***
s70n3fac3: folds 
Uncalled bet (50) returned to FDIBA2009
FDIBA2009 collected 100 from pot
FDIBA2009: doesn't show hand 
*** SUMMARY ***
Total pot 100 | Rake 0 
Seat 1: s70n3fac3 (button) (small blind) folded before Flop
Seat 2: FDIBA2009 (big blind) collected (100)



PokerStars Home Game Hand #227251363100: {Club #4781089}  Hold'em No Limit (50/100) - 2021/06/02 0:12:11 EET [2021/06/01 17:12:11 ET]
Table 'VTPP NLHE 0106' 2-max (Play Money) Seat #2 is the button
Seat 1: s70n3fac3 (17877 in chips) 
Seat 2: FDIBA2009 (16770 in chips) 
FDIBA2009: posts small blind 50
s70n3fac3: posts big blind 100
*** HOLE CARDS ***
FDIBA2009: raises 100 to 200
s70n3fac3: calls 100
*** FLOP *** [Ac Ks 2c]
s70n3fac3: checks 
FDIBA2009: checks 
*** TURN *** [Ac Ks 2c] [Tc]
s70n3fac3: checks 
FDIBA2009: bets 200
s70n3fac3: calls 200
*** RIVER *** [Ac Ks 2c Tc] [9h]
s70n3fac3: checks 
FDIBA2009: checks 
*** SHOW DOWN ***
s70n3fac3: shows [8c Qh] (high card Ace)
FDIBA2009: shows [Qc 3d] (high card Ace)
s70n3fac3 collected 378 from pot
FDIBA2009 collected 378 from pot
*** SUMMARY ***
Total pot 800 | Rake 44 
Board [Ac Ks 2c Tc 9h]
Seat 1: s70n3fac3 (big blind) showed [8c Qh] and won (378) with high card Ace
Seat 2: FDIBA2009 (button) (small blind) showed [Qc 3d] and won (378) with high card Ace



PokerStars Home Game Hand #227251370977: {Club #4781089}  Hold'em No Limit (50/100) - 2021/06/02 0:12:27 EET [2021/06/01 17:12:27 ET]
Table 'VTPP NLHE 0106' 2-max (Play Money) Seat #1 is the button
Seat 1: s70n3fac3 (17855 in chips) 
Seat 2: FDIBA2009 (16748 in chips) 
s70n3fac3: posts small blind 50
FDIBA2009: posts big blind 100
*** HOLE CARDS ***
s70n3fac3: calls 50
FDIBA2009: raises 250 to 350
s70n3fac3: calls 250
*** FLOP *** [Jd 7s 9d]
FDIBA2009: checks 
s70n3fac3: checks 
*** TURN *** [Jd 7s 9d] [4d]
FDIBA2009: bets 400
s70n3fac3: calls 400
*** RIVER *** [Jd 7s 9d 4d] [3h]
FDIBA2009: checks 
s70n3fac3: checks 
*** SHOW DOWN ***
FDIBA2009: shows [Ad Ks] (high card Ace)
s70n3fac3: shows [5d 7h] (a pair of Sevens)
s70n3fac3 collected 1417 from pot
*** SUMMARY ***
Total pot 1500 | Rake 83 
Board [Jd 7s 9d 4d 3h]
Seat 1: s70n3fac3 (button) (small blind) showed [5d 7h] and won (1417) with a pair of Sevens
Seat 2: FDIBA2009 (big blind) showed [Ad Ks] and lost with high card Ace



PokerStars Home Game Hand #227251380528: {Club #4781089}  Hold'em No Limit (50/100) - 2021/06/02 0:12:46 EET [2021/06/01 17:12:46 ET]
Table 'VTPP NLHE 0106' 2-max (Play Money) Seat #2 is the button
Seat 1: s70n3fac3 (18522 in chips) 
Seat 2: FDIBA2009 (15998 in chips) 
FDIBA2009: posts small blind 50
s70n3fac3: posts big blind 100
*** HOLE CARDS ***
FDIBA2009: raises 100 to 200
s70n3fac3: folds 
Uncalled bet (100) returned to FDIBA2009
FDIBA2009 collected 200 from pot
FDIBA2009: doesn't show hand 
*** SUMMARY ***
Total pot 200 | Rake 0 
Seat 1: s70n3fac3 (big blind) folded before Flop
Seat 2: FDIBA2009 (button) (small blind) collected (200)



PokerStars Home Game Hand #227251383637: {Club #4781089}  Hold'em No Limit (50/100) - 2021/06/02 0:12:53 EET [2021/06/01 17:12:53 ET]
Table 'VTPP NLHE 0106' 2-max (Play Money) Seat #1 is the button
Seat 1: s70n3fac3 (18422 in chips) 
Seat 2: FDIBA2009 (16098 in chips) 
s70n3fac3: posts small blind 50
FDIBA2009: posts big blind 100
*** HOLE CARDS ***
s70n3fac3: raises 100 to 200
FDIBA2009: calls 100
*** FLOP *** [Ad 5d Tc]
FDIBA2009: checks 
s70n3fac3: bets 200
FDIBA2009: folds 
Uncalled bet (200) returned to s70n3fac3
s70n3fac3 collected 378 from pot
s70n3fac3: doesn't show hand 
*** SUMMARY ***
Total pot 400 | Rake 22 
Board [Ad 5d Tc]
Seat 1: s70n3fac3 (button) (small blind) collected (378)
Seat 2: FDIBA2009 (big blind) folded on the Flop



PokerStars Home Game Hand #227251389156: {Club #4781089}  Hold'em No Limit (50/100) - 2021/06/02 0:13:04 EET [2021/06/01 17:13:04 ET]
Table 'VTPP NLHE 0106' 2-max (Play Money) Seat #2 is the button
Seat 1: s70n3fac3 (18600 in chips) 
Seat 2: FDIBA2009 (15898 in chips) 
FDIBA2009: posts small blind 50
s70n3fac3: posts big blind 100
*** HOLE CARDS ***
FDIBA2009: raises 100 to 200
s70n3fac3: folds 
Uncalled bet (100) returned to FDIBA2009
FDIBA2009 collected 200 from pot
FDIBA2009: doesn't show hand 
*** SUMMARY ***
Total pot 200 | Rake 0 
Seat 1: s70n3fac3 (big blind) folded before Flop
Seat 2: FDIBA2009 (button) (small blind) collected (200)



PokerStars Home Game Hand #227251392073: {Club #4781089}  Hold'em No Limit (50/100) - 2021/06/02 0:13:10 EET [2021/06/01 17:13:10 ET]
Table 'VTPP NLHE 0106' 2-max (Play Money) Seat #1 is the button
Seat 1: s70n3fac3 (18500 in chips) 
Seat 2: FDIBA2009 (15998 in chips) 
s70n3fac3: posts small blind 50
FDIBA2009: posts big blind 100
*** HOLE CARDS ***
s70n3fac3: calls 50
FDIBA2009: raises 200 to 300
s70n3fac3: calls 200
*** FLOP *** [Th 2h Td]
FDIBA2009: checks 
s70n3fac3: checks 
*** TURN *** [Th 2h Td] [2c]
FDIBA2009: checks 
s70n3fac3: checks 
*** RIVER *** [Th 2h Td 2c] [7d]
FDIBA2009: bets 3000
s70n3fac3: folds 
Uncalled bet (3000) returned to FDIBA2009
FDIBA2009 collected 567 from pot
FDIBA2009: doesn't show hand 
*** SUMMARY ***
Total pot 600 | Rake 33 
Board [Th 2h Td 2c 7d]
Seat 1: s70n3fac3 (button) (small blind) folded on the River
Seat 2: FDIBA2009 (big blind) collected (567)



PokerStars Home Game Hand #227251404952: {Club #4781089}  Hold'em No Limit (50/100) - 2021/06/02 0:13:37 EET [2021/06/01 17:13:37 ET]
Table 'VTPP NLHE 0106' 2-max (Play Money) Seat #2 is the button
Seat 1: s70n3fac3 (18200 in chips) 
Seat 2: FDIBA2009 (16265 in chips) 
FDIBA2009: posts small blind 50
s70n3fac3: posts big blind 100
*** HOLE CARDS ***
FDIBA2009: raises 100 to 200
s70n3fac3: calls 100
*** FLOP *** [9d 5s Kd]
s70n3fac3: checks 
FDIBA2009: bets 378
s70n3fac3: folds 
Uncalled bet (378) returned to FDIBA2009
FDIBA2009 collected 378 from pot
FDIBA2009: doesn't show hand 
*** SUMMARY ***
Total pot 400 | Rake 22 
Board [9d 5s Kd]
Seat 1: s70n3fac3 (big blind) folded on the Flop
Seat 2: FDIBA2009 (button) (small blind) collected (378)



PokerStars Home Game Hand #227251410212: {Club #4781089}  Hold'em No Limit (50/100) - 2021/06/02 0:13:48 EET [2021/06/01 17:13:48 ET]
Table 'VTPP NLHE 0106' 2-max (Play Money) Seat #1 is the button
Seat 1: s70n3fac3 (18000 in chips) 
Seat 2: FDIBA2009 (16443 in chips) 
s70n3fac3: posts small blind 50
FDIBA2009: posts big blind 100
*** HOLE CARDS ***
s70n3fac3: folds 
Uncalled bet (50) returned to FDIBA2009
FDIBA2009 collected 100 from pot
FDIBA2009: doesn't show hand 
*** SUMMARY ***
Total pot 100 | Rake 0 
Seat 1: s70n3fac3 (button) (small blind) folded before Flop
Seat 2: FDIBA2009 (big blind) collected (100)



PokerStars Home Game Hand #227251412744: {Club #4781089}  Hold'em No Limit (50/100) - 2021/06/02 0:13:53 EET [2021/06/01 17:13:53 ET]
Table 'VTPP NLHE 0106' 2-max (Play Money) Seat #2 is the button
Seat 1: s70n3fac3 (17950 in chips) 
Seat 2: FDIBA2009 (16493 in chips) 
FDIBA2009: posts small blind 50
s70n3fac3: posts big blind 100
*** HOLE CARDS ***
FDIBA2009: raises 100 to 200
s70n3fac3: calls 100
*** FLOP *** [Kh Ac Ad]
s70n3fac3: checks 
FDIBA2009: bets 189
s70n3fac3: calls 189
*** TURN *** [Kh Ac Ad] [4c]
s70n3fac3: checks 
FDIBA2009: checks 
*** RIVER *** [Kh Ac Ad 4c] [4h]
s70n3fac3: checks 
FDIBA2009: bets 400
s70n3fac3: calls 400
*** SHOW DOWN ***
FDIBA2009: shows [Kd Jd] (two pair, Aces and Kings)
s70n3fac3: mucks hand 
FDIBA2009 collected 1491 from pot
*** SUMMARY ***
Total pot 1578 | Rake 87 
Board [Kh Ac Ad 4c 4h]
Seat 1: s70n3fac3 (big blind) mucked [9d Qs]
Seat 2: FDIBA2009 (button) (small blind) showed [Kd Jd] and won (1491) with two pair, Aces and Kings



PokerStars Home Game Hand #227251424078: {Club #4781089}  Hold'em No Limit (50/100) - 2021/06/02 0:14:16 EET [2021/06/01 17:14:16 ET]
Table 'VTPP NLHE 0106' 2-max (Play Money) Seat #1 is the button
Seat 1: s70n3fac3 (17161 in chips) 
Seat 2: FDIBA2009 (17195 in chips) 
s70n3fac3: posts small blind 50
FDIBA2009: posts big blind 100
*** HOLE CARDS ***
s70n3fac3: raises 150 to 250
FDIBA2009: calls 150
*** FLOP *** [Ah 2c 8d]
FDIBA2009: checks 
s70n3fac3: bets 400
FDIBA2009: folds 
Uncalled bet (400) returned to s70n3fac3
s70n3fac3 collected 472 from pot
s70n3fac3: doesn't show hand 
*** SUMMARY ***
Total pot 500 | Rake 28 
Board [Ah 2c 8d]
Seat 1: s70n3fac3 (button) (small blind) collected (472)
Seat 2: FDIBA2009 (big blind) folded on the Flop



PokerStars Home Game Hand #227251431274: {Club #4781089}  Hold'em No Limit (50/100) - 2021/06/02 0:14:31 EET [2021/06/01 17:14:31 ET]
Table 'VTPP NLHE 0106' 2-max (Play Money) Seat #2 is the button
Seat 1: s70n3fac3 (17383 in chips) 
Seat 2: FDIBA2009 (16945 in chips) 
FDIBA2009: posts small blind 50
s70n3fac3: posts big blind 100
*** HOLE CARDS ***
FDIBA2009: raises 100 to 200
s70n3fac3: raises 500 to 700
FDIBA2009: folds 
Uncalled bet (500) returned to s70n3fac3
s70n3fac3 collected 400 from pot
s70n3fac3: doesn't show hand 
*** SUMMARY ***
Total pot 400 | Rake 0 
Seat 1: s70n3fac3 (big blind) collected (400)
Seat 2: FDIBA2009 (button) (small blind) folded before Flop



PokerStars Home Game Hand #227251435228: {Club #4781089}  Hold'em No Limit (50/100) - 2021/06/02 0:14:39 EET [2021/06/01 17:14:39 ET]
Table 'VTPP NLHE 0106' 2-max (Play Money) Seat #1 is the button
Seat 1: s70n3fac3 (17583 in chips) 
Seat 2: FDIBA2009 (16745 in chips) 
s70n3fac3: posts small blind 50
FDIBA2009: posts big blind 100
*** HOLE CARDS ***
s70n3fac3: raises 150 to 250
FDIBA2009: folds 
Uncalled bet (150) returned to s70n3fac3
s70n3fac3 collected 200 from pot
s70n3fac3: doesn't show hand 
*** SUMMARY ***
Total pot 200 | Rake 0 
Seat 1: s70n3fac3 (button) (small blind) collected (200)
Seat 2: FDIBA2009 (big blind) folded before Flop



PokerStars Home Game Hand #227251437722: {Club #4781089}  Hold'em No Limit (50/100) - 2021/06/02 0:14:45 EET [2021/06/01 17:14:45 ET]
Table 'VTPP NLHE 0106' 2-max (Play Money) Seat #2 is the button
Seat 1: s70n3fac3 (17683 in chips) 
Seat 2: FDIBA2009 (16645 in chips) 
FDIBA2009: posts small blind 50
s70n3fac3: posts big blind 100
*** HOLE CARDS ***
FDIBA2009: raises 100 to 200
s70n3fac3: raises 500 to 700
FDIBA2009: calls 500
*** FLOP *** [3s Kc Jc]
s70n3fac3: bets 700
FDIBA2009: folds 
Uncalled bet (700) returned to s70n3fac3
s70n3fac3 collected 1323 from pot
s70n3fac3: doesn't show hand 
*** SUMMARY ***
Total pot 1400 | Rake 77 
Board [3s Kc Jc]
Seat 1: s70n3fac3 (big blind) collected (1323)
Seat 2: FDIBA2009 (button) (small blind) folded on the Flop



PokerStars Home Game Hand #227251446233: {Club #4781089}  Hold'em No Limit (50/100) - 2021/06/02 0:15:01 EET [2021/06/01 17:15:01 ET]
Table 'VTPP NLHE 0106' 2-max (Play Money) Seat #1 is the button
Seat 1: s70n3fac3 (18306 in chips) 
Seat 2: FDIBA2009 (15945 in chips) 
s70n3fac3: posts small blind 50
FDIBA2009: posts big blind 100
*** HOLE CARDS ***
s70n3fac3: raises 150 to 250
FDIBA2009: raises 800 to 1050
s70n3fac3: folds 
Uncalled bet (800) returned to FDIBA2009
FDIBA2009 collected 500 from pot
FDIBA2009: doesn't show hand 
*** SUMMARY ***
Total pot 500 | Rake 0 
Seat 1: s70n3fac3 (button) (small blind) folded before Flop
Seat 2: FDIBA2009 (big blind) collected (500)



PokerStars Home Game Hand #227251451932: {Club #4781089}  Hold'em No Limit (50/100) - 2021/06/02 0:15:13 EET [2021/06/01 17:15:13 ET]
Table 'VTPP NLHE 0106' 2-max (Play Money) Seat #2 is the button
Seat 1: s70n3fac3 (18056 in chips) 
Seat 2: FDIBA2009 (16195 in chips) 
FDIBA2009: posts small blind 50
s70n3fac3: posts big blind 100
*** HOLE CARDS ***
FDIBA2009: raises 100 to 200
s70n3fac3: calls 100
*** FLOP *** [4s Ts Tc]
s70n3fac3: checks 
FDIBA2009: checks 
*** TURN *** [4s Ts Tc] [Kc]
s70n3fac3: checks 
FDIBA2009: bets 378
s70n3fac3: folds 
Uncalled bet (378) returned to FDIBA2009
FDIBA2009 collected 378 from pot
FDIBA2009: doesn't show hand 
*** SUMMARY ***
Total pot 400 | Rake 22 
Board [4s Ts Tc Kc]
Seat 1: s70n3fac3 (big blind) folded on the Turn
Seat 2: FDIBA2009 (button) (small blind) collected (378)



PokerStars Home Game Hand #227251459514: {Club #4781089}  Hold'em No Limit (50/100) - 2021/06/02 0:15:29 EET [2021/06/01 17:15:29 ET]
Table 'VTPP NLHE 0106' 2-max (Play Money) Seat #1 is the button
Seat 1: s70n3fac3 (17856 in chips) 
Seat 2: FDIBA2009 (16373 in chips) 
s70n3fac3: posts small blind 50
FDIBA2009: posts big blind 100
*** HOLE CARDS ***
s70n3fac3: raises 150 to 250
FDIBA2009: folds 
Uncalled bet (150) returned to s70n3fac3
s70n3fac3 collected 200 from pot
s70n3fac3: doesn't show hand 
*** SUMMARY ***
Total pot 200 | Rake 0 
Seat 1: s70n3fac3 (button) (small blind) collected (200)
Seat 2: FDIBA2009 (big blind) folded before Flop



PokerStars Home Game Hand #227251462154: {Club #4781089}  Hold'em No Limit (50/100) - 2021/06/02 0:15:34 EET [2021/06/01 17:15:34 ET]
Table 'VTPP NLHE 0106' 2-max (Play Money) Seat #2 is the button
Seat 1: s70n3fac3 (17956 in chips) 
Seat 2: FDIBA2009 (16273 in chips) 
FDIBA2009: posts small blind 50
s70n3fac3: posts big blind 100
*** HOLE CARDS ***
FDIBA2009: raises 100 to 200
s70n3fac3: calls 100
*** FLOP *** [8h 3s Kc]
s70n3fac3: checks 
FDIBA2009: checks 
*** TURN *** [8h 3s Kc] [Jh]
s70n3fac3: checks 
FDIBA2009: bets 378
s70n3fac3: calls 378
*** RIVER *** [8h 3s Kc Jh] [2h]
s70n3fac3: checks 
FDIBA2009: bets 546
s70n3fac3: folds 
Uncalled bet (546) returned to FDIBA2009
FDIBA2009 collected 1092 from pot
FDIBA2009: doesn't show hand 
*** SUMMARY ***
Total pot 1156 | Rake 64 
Board [8h 3s Kc Jh 2h]
Seat 1: s70n3fac3 (big blind) folded on the River
Seat 2: FDIBA2009 (button) (small blind) collected (1092)



PokerStars Home Game Hand #227251474053: {Club #4781089}  Hold'em No Limit (50/100) - 2021/06/02 0:15:58 EET [2021/06/01 17:15:58 ET]
Table 'VTPP NLHE 0106' 2-max (Play Money) Seat #1 is the button
Seat 1: s70n3fac3 (17378 in chips) 
Seat 2: FDIBA2009 (16787 in chips) 
s70n3fac3: posts small blind 50
FDIBA2009: posts big blind 100
*** HOLE CARDS ***
s70n3fac3: raises 150 to 250
FDIBA2009: folds 
Uncalled bet (150) returned to s70n3fac3
s70n3fac3 collected 200 from pot
s70n3fac3: doesn't show hand 
*** SUMMARY ***
Total pot 200 | Rake 0 
Seat 1: s70n3fac3 (button) (small blind) collected (200)
Seat 2: FDIBA2009 (big blind) folded before Flop



PokerStars Home Game Hand #227251476728: {Club #4781089}  Hold'em No Limit (50/100) - 2021/06/02 0:16:04 EET [2021/06/01 17:16:04 ET]
Table 'VTPP NLHE 0106' 2-max (Play Money) Seat #2 is the button
Seat 1: s70n3fac3 (17478 in chips) 
Seat 2: FDIBA2009 (16687 in chips) 
FDIBA2009: posts small blind 50
s70n3fac3: posts big blind 100
*** HOLE CARDS ***
FDIBA2009: raises 100 to 200
s70n3fac3: calls 100
*** FLOP *** [9s Ad 6h]
s70n3fac3: checks 
FDIBA2009: bets 378
s70n3fac3: folds 
Uncalled bet (378) returned to FDIBA2009
FDIBA2009 collected 378 from pot
FDIBA2009: doesn't show hand 
*** SUMMARY ***
Total pot 400 | Rake 22 
Board [9s Ad 6h]
Seat 1: s70n3fac3 (big blind) folded on the Flop
Seat 2: FDIBA2009 (button) (small blind) collected (378)



PokerStars Home Game Hand #227251482457: {Club #4781089}  Hold'em No Limit (50/100) - 2021/06/02 0:16:16 EET [2021/06/01 17:16:16 ET]
Table 'VTPP NLHE 0106' 2-max (Play Money) Seat #1 is the button
Seat 1: s70n3fac3 (17278 in chips) 
Seat 2: FDIBA2009 (16865 in chips) 
s70n3fac3: posts small blind 50
FDIBA2009: posts big blind 100
*** HOLE CARDS ***
s70n3fac3: raises 150 to 250
FDIBA2009: raises 500 to 750
s70n3fac3: raises 950 to 1700
FDIBA2009: folds 
Uncalled bet (950) returned to s70n3fac3
s70n3fac3 collected 1500 from pot
s70n3fac3: doesn't show hand 
*** SUMMARY ***
Total pot 1500 | Rake 0 
Seat 1: s70n3fac3 (button) (small blind) collected (1500)
Seat 2: FDIBA2009 (big blind) folded before Flop



PokerStars Home Game Hand #227251489904: {Club #4781089}  Hold'em No Limit (50/100) - 2021/06/02 0:16:31 EET [2021/06/01 17:16:31 ET]
Table 'VTPP NLHE 0106' 2-max (Play Money) Seat #2 is the button
Seat 1: s70n3fac3 (18028 in chips) 
Seat 2: FDIBA2009 (16115 in chips) 
FDIBA2009: posts small blind 50
s70n3fac3: posts big blind 100
*** HOLE CARDS ***
FDIBA2009: raises 100 to 200
s70n3fac3: folds 
Uncalled bet (100) returned to FDIBA2009
FDIBA2009 collected 200 from pot
FDIBA2009: doesn't show hand 
*** SUMMARY ***
Total pot 200 | Rake 0 
Seat 1: s70n3fac3 (big blind) folded before Flop
Seat 2: FDIBA2009 (button) (small blind) collected (200)



PokerStars Home Game Hand #227251492889: {Club #4781089}  Hold'em No Limit (50/100) - 2021/06/02 0:16:37 EET [2021/06/01 17:16:37 ET]
Table 'VTPP NLHE 0106' 2-max (Play Money) Seat #1 is the button
Seat 1: s70n3fac3 (17928 in chips) 
Seat 2: FDIBA2009 (16215 in chips) 
s70n3fac3: posts small blind 50
FDIBA2009: posts big blind 100
*** HOLE CARDS ***
s70n3fac3: raises 150 to 250
FDIBA2009: raises 700 to 950
s70n3fac3: calls 700
*** FLOP *** [5d Tc 6s]
FDIBA2009: checks 
s70n3fac3: bets 600
FDIBA2009: calls 600
*** TURN *** [5d Tc 6s] [7d]
FDIBA2009: checks 
s70n3fac3: bets 1100
FDIBA2009: calls 1100
*** RIVER *** [5d Tc 6s 7d] [3h]
FDIBA2009: checks 
s70n3fac3: checks 
*** SHOW DOWN ***
FDIBA2009: shows [Ah Ks] (high card Ace)
s70n3fac3: shows [Td Kc] (a pair of Tens)
s70n3fac3 collected 5008 from pot
*** SUMMARY ***
Total pot 5300 | Rake 292 
Board [5d Tc 6s 7d 3h]
Seat 1: s70n3fac3 (button) (small blind) showed [Td Kc] and won (5008) with a pair of Tens
Seat 2: FDIBA2009 (big blind) showed [Ah Ks] and lost with high card Ace



PokerStars Home Game Hand #227251509712: {Club #4781089}  Hold'em No Limit (50/100) - 2021/06/02 0:17:11 EET [2021/06/01 17:17:11 ET]
Table 'VTPP NLHE 0106' 2-max (Play Money) Seat #2 is the button
Seat 1: s70n3fac3 (20286 in chips) 
Seat 2: FDIBA2009 (13565 in chips) 
FDIBA2009: posts small blind 50
s70n3fac3: posts big blind 100
*** HOLE CARDS ***
FDIBA2009: folds 
Uncalled bet (50) returned to s70n3fac3
s70n3fac3 collected 100 from pot
s70n3fac3: doesn't show hand 
*** SUMMARY ***
Total pot 100 | Rake 0 
Seat 1: s70n3fac3 (big blind) collected (100)
Seat 2: FDIBA2009 (button) (small blind) folded before Flop



PokerStars Home Game Hand #227251512046: {Club #4781089}  Hold'em No Limit (50/100) - 2021/06/02 0:17:16 EET [2021/06/01 17:17:16 ET]
Table 'VTPP NLHE 0106' 2-max (Play Money) Seat #1 is the button
Seat 1: s70n3fac3 (20336 in chips) 
Seat 2: FDIBA2009 (13515 in chips) 
s70n3fac3: posts small blind 50
FDIBA2009: posts big blind 100
*** HOLE CARDS ***
s70n3fac3: raises 150 to 250
FDIBA2009: calls 150
*** FLOP *** [Jh 9s Kd]
FDIBA2009: checks 
s70n3fac3: bets 300
FDIBA2009: folds 
Uncalled bet (300) returned to s70n3fac3
s70n3fac3 collected 472 from pot
s70n3fac3: doesn't show hand 
*** SUMMARY ***
Total pot 500 | Rake 28 
Board [Jh 9s Kd]
Seat 1: s70n3fac3 (button) (small blind) collected (472)
Seat 2: FDIBA2009 (big blind) folded on the Flop



PokerStars Home Game Hand #227251517128: {Club #4781089}  Hold'em No Limit (50/100) - 2021/06/02 0:17:26 EET [2021/06/01 17:17:26 ET]
Table 'VTPP NLHE 0106' 2-max (Play Money) Seat #2 is the button
Seat 1: s70n3fac3 (20558 in chips) 
Seat 2: FDIBA2009 (13265 in chips) 
FDIBA2009: posts small blind 50
s70n3fac3: posts big blind 100
*** HOLE CARDS ***
FDIBA2009: raises 200 to 300
s70n3fac3: folds 
Uncalled bet (200) returned to FDIBA2009
FDIBA2009 collected 200 from pot
FDIBA2009: doesn't show hand 
*** SUMMARY ***
Total pot 200 | Rake 0 
Seat 1: s70n3fac3 (big blind) folded before Flop
Seat 2: FDIBA2009 (button) (small blind) collected (200)



PokerStars Home Game Hand #227251520336: {Club #4781089}  Hold'em No Limit (50/100) - 2021/06/02 0:17:33 EET [2021/06/01 17:17:33 ET]
Table 'VTPP NLHE 0106' 2-max (Play Money) Seat #1 is the button
Seat 1: s70n3fac3 (20458 in chips) 
Seat 2: FDIBA2009 (13365 in chips) 
s70n3fac3: posts small blind 50
FDIBA2009: posts big blind 100
*** HOLE CARDS ***
s70n3fac3: raises 150 to 250
FDIBA2009: raises 500 to 750
s70n3fac3: calls 500
*** FLOP *** [Qh 5h Jh]
FDIBA2009: bets 1417
s70n3fac3: folds 
Uncalled bet (1417) returned to FDIBA2009
FDIBA2009 collected 1417 from pot
FDIBA2009: doesn't show hand 
*** SUMMARY ***
Total pot 1500 | Rake 83 
Board [Qh 5h Jh]
Seat 1: s70n3fac3 (button) (small blind) folded on the Flop
Seat 2: FDIBA2009 (big blind) collected (1417)



PokerStars Home Game Hand #227251530167: {Club #4781089}  Hold'em No Limit (50/100) - 2021/06/02 0:17:53 EET [2021/06/01 17:17:53 ET]
Table 'VTPP NLHE 0106' 2-max (Play Money) Seat #2 is the button
Seat 1: s70n3fac3 (19708 in chips) 
Seat 2: FDIBA2009 (14032 in chips) 
FDIBA2009: posts small blind 50
s70n3fac3: posts big blind 100
*** HOLE CARDS ***
FDIBA2009: raises 100 to 200
s70n3fac3: calls 100
*** FLOP *** [Ks 5c Jc]
s70n3fac3: checks 
FDIBA2009: bets 378
s70n3fac3: calls 378
*** TURN *** [Ks 5c Jc] [4h]
s70n3fac3: checks 
FDIBA2009: checks 
*** RIVER *** [Ks 5c Jc 4h] [8c]
s70n3fac3: bets 400
FDIBA2009: calls 400
*** SHOW DOWN ***
s70n3fac3: shows [Jd 6c] (a pair of Jacks)
FDIBA2009: mucks hand 
s70n3fac3 collected 1848 from pot
*** SUMMARY ***
Total pot 1956 | Rake 108 
Board [Ks 5c Jc 4h 8c]
Seat 1: s70n3fac3 (big blind) showed [Jd 6c] and won (1848) with a pair of Jacks
Seat 2: FDIBA2009 (button) (small blind) mucked [2h Js]



PokerStars Home Game Hand #227251538260: {Club #4781089}  Hold'em No Limit (50/100) - 2021/06/02 0:18:09 EET [2021/06/01 17:18:09 ET]
Table 'VTPP NLHE 0106' 2-max (Play Money) Seat #1 is the button
Seat 1: s70n3fac3 (20578 in chips) 
Seat 2: FDIBA2009 (13054 in chips) 
s70n3fac3: posts small blind 50
FDIBA2009: posts big blind 100
*** HOLE CARDS ***
s70n3fac3: folds 
Uncalled bet (50) returned to FDIBA2009
FDIBA2009 collected 100 from pot
FDIBA2009: doesn't show hand 
*** SUMMARY ***
Total pot 100 | Rake 0 
Seat 1: s70n3fac3 (button) (small blind) folded before Flop
Seat 2: FDIBA2009 (big blind) collected (100)



PokerStars Home Game Hand #227251540983: {Club #4781089}  Hold'em No Limit (50/100) - 2021/06/02 0:18:15 EET [2021/06/01 17:18:15 ET]
Table 'VTPP NLHE 0106' 2-max (Play Money) Seat #2 is the button
Seat 1: s70n3fac3 (20528 in chips) 
Seat 2: FDIBA2009 (13104 in chips) 
FDIBA2009: posts small blind 50
s70n3fac3: posts big blind 100
*** HOLE CARDS ***
FDIBA2009: folds 
Uncalled bet (50) returned to s70n3fac3
s70n3fac3 collected 100 from pot
s70n3fac3: doesn't show hand 
*** SUMMARY ***
Total pot 100 | Rake 0 
Seat 1: s70n3fac3 (big blind) collected (100)
Seat 2: FDIBA2009 (button) (small blind) folded before Flop



PokerStars Home Game Hand #227251543780: {Club #4781089}  Hold'em No Limit (50/100) - 2021/06/02 0:18:20 EET [2021/06/01 17:18:20 ET]
Table 'VTPP NLHE 0106' 2-max (Play Money) Seat #1 is the button
Seat 1: s70n3fac3 (20578 in chips) 
Seat 2: FDIBA2009 (13054 in chips) 
s70n3fac3: posts small blind 50
FDIBA2009: posts big blind 100
*** HOLE CARDS ***
s70n3fac3: raises 150 to 250
FDIBA2009: calls 150
*** FLOP *** [2h 2c 5s]
FDIBA2009: checks 
s70n3fac3: bets 300
FDIBA2009: raises 1100 to 1400
s70n3fac3: calls 1100
*** TURN *** [2h 2c 5s] [9d]
FDIBA2009: bets 3118
s70n3fac3: folds 
Uncalled bet (3118) returned to FDIBA2009
FDIBA2009 collected 3118 from pot
FDIBA2009: doesn't show hand 
*** SUMMARY ***
Total pot 3300 | Rake 182 
Board [2h 2c 5s 9d]
Seat 1: s70n3fac3 (button) (small blind) folded on the Turn
Seat 2: FDIBA2009 (big blind) collected (3118)



PokerStars Home Game Hand #227251561870: {Club #4781089}  Hold'em No Limit (50/100) - 2021/06/02 0:18:57 EET [2021/06/01 17:18:57 ET]
Table 'VTPP NLHE 0106' 2-max (Play Money) Seat #2 is the button
Seat 1: s70n3fac3 (18928 in chips) 
Seat 2: FDIBA2009 (14522 in chips) 
FDIBA2009: posts small blind 50
s70n3fac3: posts big blind 100
*** HOLE CARDS ***
FDIBA2009: raises 250 to 350
s70n3fac3: calls 250
*** FLOP *** [As Ts Jh]
s70n3fac3: checks 
FDIBA2009: bets 330
s70n3fac3: calls 330
*** TURN *** [As Ts Jh] [Jc]
s70n3fac3: checks 
FDIBA2009: checks 
*** RIVER *** [As Ts Jh Jc] [9h]
s70n3fac3: checks 
FDIBA2009: bets 650
s70n3fac3: calls 650
*** SHOW DOWN ***
FDIBA2009: shows [Kc Ac] (two pair, Aces and Jacks)
s70n3fac3: mucks hand 
FDIBA2009 collected 2514 from pot
*** SUMMARY ***
Total pot 2660 | Rake 146 
Board [As Ts Jh Jc 9h]
Seat 1: s70n3fac3 (big blind) mucked [Qs Th]
Seat 2: FDIBA2009 (button) (small blind) showed [Kc Ac] and won (2514) with two pair, Aces and Jacks



PokerStars Home Game Hand #227251581636: {Club #4781089}  Hold'em No Limit (50/100) - 2021/06/02 0:19:25 EET [2021/06/01 17:19:25 ET]
Table 'VTPP NLHE 0106' 2-max (Play Money) Seat #1 is the button
Seat 1: s70n3fac3 (17598 in chips) 
Seat 2: FDIBA2009 (15706 in chips) 
s70n3fac3: posts small blind 50
FDIBA2009: posts big blind 100
*** HOLE CARDS ***
s70n3fac3: folds 
Uncalled bet (50) returned to FDIBA2009
FDIBA2009 collected 100 from pot
FDIBA2009: doesn't show hand 
*** SUMMARY ***
Total pot 100 | Rake 0 
Seat 1: s70n3fac3 (button) (small blind) folded before Flop
Seat 2: FDIBA2009 (big blind) collected (100)



PokerStars Home Game Hand #227251583504: {Club #4781089}  Hold'em No Limit (50/100) - 2021/06/02 0:19:29 EET [2021/06/01 17:19:29 ET]
Table 'VTPP NLHE 0106' 2-max (Play Money) Seat #2 is the button
Seat 1: s70n3fac3 (17548 in chips) 
Seat 2: FDIBA2009 (15756 in chips) 
FDIBA2009: posts small blind 50
s70n3fac3: posts big blind 100
*** HOLE CARDS ***
FDIBA2009: raises 100 to 200
s70n3fac3: calls 100
*** FLOP *** [9c 3c Jd]
s70n3fac3: checks 
FDIBA2009: bets 200
s70n3fac3: calls 200
*** TURN *** [9c 3c Jd] [Ks]
s70n3fac3: checks 
FDIBA2009: bets 450
s70n3fac3: folds 
Uncalled bet (450) returned to FDIBA2009
FDIBA2009 collected 756 from pot
FDIBA2009: doesn't show hand 
*** SUMMARY ***
Total pot 800 | Rake 44 
Board [9c 3c Jd Ks]
Seat 1: s70n3fac3 (big blind) folded on the Turn
Seat 2: FDIBA2009 (button) (small blind) collected (756)



PokerStars Home Game Hand #227251599299: {Club #4781089}  Hold'em No Limit (50/100) - 2021/06/02 0:19:48 EET [2021/06/01 17:19:48 ET]
Table 'VTPP NLHE 0106' 2-max (Play Money) Seat #1 is the button
Seat 1: s70n3fac3 (17148 in chips) 
Seat 2: FDIBA2009 (16112 in chips) 
s70n3fac3: posts small blind 50
FDIBA2009: posts big blind 100
*** HOLE CARDS ***
s70n3fac3: folds 
Uncalled bet (50) returned to FDIBA2009
FDIBA2009 collected 100 from pot
FDIBA2009: doesn't show hand 
*** SUMMARY ***
Total pot 100 | Rake 0 
Seat 1: s70n3fac3 (button) (small blind) folded before Flop
Seat 2: FDIBA2009 (big blind) collected (100)



PokerStars Home Game Hand #227251601154: {Club #4781089}  Hold'em No Limit (50/100) - 2021/06/02 0:19:52 EET [2021/06/01 17:19:52 ET]
Table 'VTPP NLHE 0106' 2-max (Play Money) Seat #2 is the button
Seat 1: s70n3fac3 (17098 in chips) 
Seat 2: FDIBA2009 (16162 in chips) 
FDIBA2009: posts small blind 50
s70n3fac3: posts big blind 100
*** HOLE CARDS ***
FDIBA2009: raises 100 to 200
s70n3fac3: calls 100
*** FLOP *** [Js 2d 6s]
s70n3fac3: checks 
FDIBA2009: bets 250
s70n3fac3: folds 
Uncalled bet (250) returned to FDIBA2009
FDIBA2009 collected 378 from pot
FDIBA2009: doesn't show hand 
*** SUMMARY ***
Total pot 400 | Rake 22 
Board [Js 2d 6s]
Seat 1: s70n3fac3 (big blind) folded on the Flop
Seat 2: FDIBA2009 (button) (small blind) collected (378)



PokerStars Home Game Hand #227251606723: {Club #4781089}  Hold'em No Limit (50/100) - 2021/06/02 0:20:03 EET [2021/06/01 17:20:03 ET]
Table 'VTPP NLHE 0106' 2-max (Play Money) Seat #1 is the button
Seat 1: s70n3fac3 (16898 in chips) 
Seat 2: FDIBA2009 (16340 in chips) 
s70n3fac3: posts small blind 50
FDIBA2009: posts big blind 100
*** HOLE CARDS ***
s70n3fac3: raises 150 to 250
FDIBA2009: calls 150
*** FLOP *** [8s 3s Kh]
FDIBA2009: checks 
s70n3fac3: bets 200
FDIBA2009: folds 
Uncalled bet (200) returned to s70n3fac3
s70n3fac3 collected 472 from pot
s70n3fac3: doesn't show hand 
*** SUMMARY ***
Total pot 500 | Rake 28 
Board [8s 3s Kh]
Seat 1: s70n3fac3 (button) (small blind) collected (472)
Seat 2: FDIBA2009 (big blind) folded on the Flop



PokerStars Home Game Hand #227251612220: {Club #4781089}  Hold'em No Limit (50/100) - 2021/06/02 0:20:15 EET [2021/06/01 17:20:15 ET]
Table 'VTPP NLHE 0106' 2-max (Play Money) Seat #2 is the button
Seat 1: s70n3fac3 (17120 in chips) 
Seat 2: FDIBA2009 (16090 in chips) 
FDIBA2009: posts small blind 50
s70n3fac3: posts big blind 100
*** HOLE CARDS ***
FDIBA2009: raises 200 to 300
s70n3fac3: folds 
Uncalled bet (200) returned to FDIBA2009
FDIBA2009 collected 200 from pot
FDIBA2009: doesn't show hand 
*** SUMMARY ***
Total pot 200 | Rake 0 
Seat 1: s70n3fac3 (big blind) folded before Flop
Seat 2: FDIBA2009 (button) (small blind) collected (200)



PokerStars Home Game Hand #227251615318: {Club #4781089}  Hold'em No Limit (50/100) - 2021/06/02 0:20:21 EET [2021/06/01 17:20:21 ET]
Table 'VTPP NLHE 0106' 2-max (Play Money) Seat #1 is the button
Seat 1: s70n3fac3 (17020 in chips) 
Seat 2: FDIBA2009 (16190 in chips) 
s70n3fac3: posts small blind 50
FDIBA2009: posts big blind 100
*** HOLE CARDS ***
s70n3fac3: raises 150 to 250
FDIBA2009: calls 150
*** FLOP *** [9c 6s 5s]
FDIBA2009: checks 
s70n3fac3: checks 
*** TURN *** [9c 6s 5s] [8c]
FDIBA2009: checks 
s70n3fac3: checks 
*** RIVER *** [9c 6s 5s 8c] [Qd]
FDIBA2009: bets 472
s70n3fac3: folds 
Uncalled bet (472) returned to FDIBA2009
FDIBA2009 collected 472 from pot
FDIBA2009: doesn't show hand 
*** SUMMARY ***
Total pot 500 | Rake 28 
Board [9c 6s 5s 8c Qd]
Seat 1: s70n3fac3 (button) (small blind) folded on the River
Seat 2: FDIBA2009 (big blind) collected (472)



PokerStars Home Game Hand #227251623997: {Club #4781089}  Hold'em No Limit (50/100) - 2021/06/02 0:20:39 EET [2021/06/01 17:20:39 ET]
Table 'VTPP NLHE 0106' 2-max (Play Money) Seat #2 is the button
Seat 1: s70n3fac3 (16770 in chips) 
Seat 2: FDIBA2009 (16412 in chips) 
FDIBA2009: posts small blind 50
s70n3fac3: posts big blind 100
*** HOLE CARDS ***
FDIBA2009: raises 200 to 300
s70n3fac3: folds 
Uncalled bet (200) returned to FDIBA2009
FDIBA2009 collected 200 from pot
FDIBA2009: doesn't show hand 
*** SUMMARY ***
Total pot 200 | Rake 0 
Seat 1: s70n3fac3 (big blind) folded before Flop
Seat 2: FDIBA2009 (button) (small blind) collected (200)



PokerStars Home Game Hand #227251627380: {Club #4781089}  Hold'em No Limit (50/100) - 2021/06/02 0:20:46 EET [2021/06/01 17:20:46 ET]
Table 'VTPP NLHE 0106' 2-max (Play Money) Seat #1 is the button
Seat 1: s70n3fac3 (16670 in chips) 
Seat 2: FDIBA2009 (16512 in chips) 
s70n3fac3: posts small blind 50
FDIBA2009: posts big blind 100
*** HOLE CARDS ***
s70n3fac3: calls 50
FDIBA2009: raises 200 to 300
s70n3fac3: calls 200
*** FLOP *** [Ad 3d 5d]
FDIBA2009: checks 
s70n3fac3: checks 
*** TURN *** [Ad 3d 5d] [9s]
FDIBA2009: bets 567
s70n3fac3: calls 567
*** RIVER *** [Ad 3d 5d 9s] [Jd]
FDIBA2009: checks 
s70n3fac3: bets 1639
FDIBA2009: calls 1639
*** SHOW DOWN ***
s70n3fac3: shows [6c Td] (a flush, Ace high)
FDIBA2009: mucks hand 
s70n3fac3 collected 4736 from pot
*** SUMMARY ***
Total pot 5012 | Rake 276 
Board [Ad 3d 5d 9s Jd]
Seat 1: s70n3fac3 (button) (small blind) showed [6c Td] and won (4736) with a flush, Ace high
Seat 2: FDIBA2009 (big blind) mucked [4h 4d]



PokerStars Home Game Hand #227251638126: {Club #4781089}  Hold'em No Limit (50/100) - 2021/06/02 0:21:08 EET [2021/06/01 17:21:08 ET]
Table 'VTPP NLHE 0106' 2-max (Play Money) Seat #2 is the button
Seat 1: s70n3fac3 (18900 in chips) 
Seat 2: FDIBA2009 (14006 in chips) 
FDIBA2009: posts small blind 50
s70n3fac3: posts big blind 100
*** HOLE CARDS ***
FDIBA2009: raises 100 to 200
s70n3fac3: calls 100
*** FLOP *** [Ad 8c 3c]
s70n3fac3: checks 
FDIBA2009: bets 378
s70n3fac3: calls 378
*** TURN *** [Ad 8c 3c] [8d]
s70n3fac3: checks 
FDIBA2009: checks 
*** RIVER *** [Ad 8c 3c 8d] [Kc]
s70n3fac3: checks 
FDIBA2009: bets 1092
s70n3fac3: folds 
Uncalled bet (1092) returned to FDIBA2009
FDIBA2009 collected 1092 from pot
FDIBA2009: doesn't show hand 
*** SUMMARY ***
Total pot 1156 | Rake 64 
Board [Ad 8c 3c 8d Kc]
Seat 1: s70n3fac3 (big blind) folded on the River
Seat 2: FDIBA2009 (button) (small blind) collected (1092)



PokerStars Home Game Hand #227251649996: {Club #4781089}  Hold'em No Limit (50/100) - 2021/06/02 0:21:33 EET [2021/06/01 17:21:33 ET]
Table 'VTPP NLHE 0106' 2-max (Play Money) Seat #1 is the button
Seat 1: s70n3fac3 (18322 in chips) 
Seat 2: FDIBA2009 (14520 in chips) 
s70n3fac3: posts small blind 50
FDIBA2009: posts big blind 100
*** HOLE CARDS ***
s70n3fac3: raises 100 to 200
FDIBA2009: raises 100 to 300
s70n3fac3: calls 100
*** FLOP *** [Kh Td Js]
FDIBA2009: bets 567
s70n3fac3: folds 
Uncalled bet (567) returned to FDIBA2009
FDIBA2009 collected 567 from pot
FDIBA2009: doesn't show hand 
*** SUMMARY ***
Total pot 600 | Rake 33 
Board [Kh Td Js]
Seat 1: s70n3fac3 (button) (small blind) folded on the Flop
Seat 2: FDIBA2009 (big blind) collected (567)



PokerStars Home Game Hand #227251658805: {Club #4781089}  Hold'em No Limit (50/100) - 2021/06/02 0:21:51 EET [2021/06/01 17:21:51 ET]
Table 'VTPP NLHE 0106' 2-max (Play Money) Seat #2 is the button
Seat 1: s70n3fac3 (18022 in chips) 
Seat 2: FDIBA2009 (14787 in chips) 
FDIBA2009: posts small blind 50
s70n3fac3: posts big blind 100
*** HOLE CARDS ***
FDIBA2009: raises 100 to 200
s70n3fac3: folds 
Uncalled bet (100) returned to FDIBA2009
FDIBA2009 collected 200 from pot
FDIBA2009: doesn't show hand 
*** SUMMARY ***
Total pot 200 | Rake 0 
Seat 1: s70n3fac3 (big blind) folded before Flop
Seat 2: FDIBA2009 (button) (small blind) collected (200)



PokerStars Home Game Hand #227251661622: {Club #4781089}  Hold'em No Limit (50/100) - 2021/06/02 0:21:56 EET [2021/06/01 17:21:56 ET]
Table 'VTPP NLHE 0106' 2-max (Play Money) Seat #1 is the button
Seat 1: s70n3fac3 (17922 in chips) 
Seat 2: FDIBA2009 (14887 in chips) 
s70n3fac3: posts small blind 50
FDIBA2009: posts big blind 100
*** HOLE CARDS ***
s70n3fac3: raises 150 to 250
FDIBA2009: raises 550 to 800
s70n3fac3: folds 
Uncalled bet (550) returned to FDIBA2009
FDIBA2009 collected 500 from pot
FDIBA2009: doesn't show hand 
*** SUMMARY ***
Total pot 500 | Rake 0 
Seat 1: s70n3fac3 (button) (small blind) folded before Flop
Seat 2: FDIBA2009 (big blind) collected (500)



PokerStars Home Game Hand #227251667161: {Club #4781089}  Hold'em No Limit (50/100) - 2021/06/02 0:22:08 EET [2021/06/01 17:22:08 ET]
Table 'VTPP NLHE 0106' 2-max (Play Money) Seat #2 is the button
Seat 1: s70n3fac3 (17672 in chips) 
Seat 2: FDIBA2009 (15137 in chips) 
FDIBA2009: posts small blind 50
s70n3fac3: posts big blind 100
*** HOLE CARDS ***
FDIBA2009: raises 100 to 200
s70n3fac3: calls 100
*** FLOP *** [Td 2c 8c]
s70n3fac3: checks 
FDIBA2009: bets 378
s70n3fac3: calls 378
*** TURN *** [Td 2c 8c] [5h]
s70n3fac3: checks 
FDIBA2009: bets 850
s70n3fac3: calls 850
*** RIVER *** [Td 2c 8c 5h] [Tc]
s70n3fac3: checks 
FDIBA2009: bets 2700
s70n3fac3: folds 
Uncalled bet (2700) returned to FDIBA2009
FDIBA2009 collected 2699 from pot
FDIBA2009: doesn't show hand 
*** SUMMARY ***
Total pot 2856 | Rake 157 
Board [Td 2c 8c 5h Tc]
Seat 1: s70n3fac3 (big blind) folded on the River
Seat 2: FDIBA2009 (button) (small blind) collected (2699)



PokerStars Home Game Hand #227251687498: {Club #4781089}  Hold'em No Limit (50/100) - 2021/06/02 0:22:49 EET [2021/06/01 17:22:49 ET]
Table 'VTPP NLHE 0106' 2-max (Play Money) Seat #1 is the button
Seat 1: s70n3fac3 (16244 in chips) 
Seat 2: FDIBA2009 (16408 in chips) 
s70n3fac3: posts small blind 50
FDIBA2009: posts big blind 100
*** HOLE CARDS ***
s70n3fac3: folds 
Uncalled bet (50) returned to FDIBA2009
FDIBA2009 collected 100 from pot
FDIBA2009: doesn't show hand 
*** SUMMARY ***
Total pot 100 | Rake 0 
Seat 1: s70n3fac3 (button) (small blind) folded before Flop
Seat 2: FDIBA2009 (big blind) collected (100)



PokerStars Home Game Hand #227251689401: {Club #4781089}  Hold'em No Limit (50/100) - 2021/06/02 0:22:53 EET [2021/06/01 17:22:53 ET]
Table 'VTPP NLHE 0106' 2-max (Play Money) Seat #2 is the button
Seat 1: s70n3fac3 (16194 in chips) 
Seat 2: FDIBA2009 (16458 in chips) 
FDIBA2009: posts small blind 50
s70n3fac3: posts big blind 100
*** HOLE CARDS ***
FDIBA2009: raises 100 to 200
s70n3fac3: calls 100
*** FLOP *** [5c 6c 3h]
s70n3fac3: checks 
FDIBA2009: checks 
*** TURN *** [5c 6c 3h] [Qh]
s70n3fac3: checks 
FDIBA2009: checks 
*** RIVER *** [5c 6c 3h Qh] [7d]
s70n3fac3: checks 
FDIBA2009: checks 
*** SHOW DOWN ***
s70n3fac3: shows [Jh 6s] (a pair of Sixes)
FDIBA2009: mucks hand 
s70n3fac3 collected 378 from pot
*** SUMMARY ***
Total pot 400 | Rake 22 
Board [5c 6c 3h Qh 7d]
Seat 1: s70n3fac3 (big blind) showed [Jh 6s] and won (378) with a pair of Sixes
Seat 2: FDIBA2009 (button) (small blind) mucked [Ts Js]



PokerStars Home Game Hand #227251696255: {Club #4781089}  Hold'em No Limit (50/100) - 2021/06/02 0:23:07 EET [2021/06/01 17:23:07 ET]
Table 'VTPP NLHE 0106' 2-max (Play Money) Seat #1 is the button
Seat 1: s70n3fac3 (16372 in chips) 
Seat 2: FDIBA2009 (16258 in chips) 
s70n3fac3: posts small blind 50
FDIBA2009: posts big blind 100
*** HOLE CARDS ***
s70n3fac3: raises 150 to 250
FDIBA2009: calls 150
*** FLOP *** [2h 4d 5s]
FDIBA2009: checks 
s70n3fac3: checks 
*** TURN *** [2h 4d 5s] [5d]
FDIBA2009: bets 250
s70n3fac3: calls 250
*** RIVER *** [2h 4d 5s 5d] [8c]
FDIBA2009: checks 
s70n3fac3: bets 500
FDIBA2009: raises 1000 to 1500
s70n3fac3: calls 1000
*** SHOW DOWN ***
FDIBA2009: shows [Ac 3s] (a straight, Ace to Five)
s70n3fac3: mucks hand 
FDIBA2009 collected 3780 from pot
*** SUMMARY ***
Total pot 4000 | Rake 220 
Board [2h 4d 5s 5d 8c]
Seat 1: s70n3fac3 (button) (small blind) mucked [8d Td]
Seat 2: FDIBA2009 (big blind) showed [Ac 3s] and won (3780) with a straight, Ace to Five



PokerStars Home Game Hand #227251712269: {Club #4781089}  Hold'em No Limit (50/100) - 2021/06/02 0:23:41 EET [2021/06/01 17:23:41 ET]
Table 'VTPP NLHE 0106' 2-max (Play Money) Seat #2 is the button
Seat 1: s70n3fac3 (14372 in chips) 
Seat 2: FDIBA2009 (18038 in chips) 
FDIBA2009: posts small blind 50
s70n3fac3: posts big blind 100
*** HOLE CARDS ***
FDIBA2009: folds 
Uncalled bet (50) returned to s70n3fac3
s70n3fac3 collected 100 from pot
s70n3fac3: doesn't show hand 
*** SUMMARY ***
Total pot 100 | Rake 0 
Seat 1: s70n3fac3 (big blind) collected (100)
Seat 2: FDIBA2009 (button) (small blind) folded before Flop



PokerStars Home Game Hand #227251715384: {Club #4781089}  Hold'em No Limit (50/100) - 2021/06/02 0:23:47 EET [2021/06/01 17:23:47 ET]
Table 'VTPP NLHE 0106' 2-max (Play Money) Seat #1 is the button
Seat 1: s70n3fac3 (14422 in chips) 
Seat 2: FDIBA2009 (17988 in chips) 
s70n3fac3: posts small blind 50
FDIBA2009: posts big blind 100
*** HOLE CARDS ***
s70n3fac3: folds 
Uncalled bet (50) returned to FDIBA2009
FDIBA2009 collected 100 from pot
FDIBA2009: doesn't show hand 
*** SUMMARY ***
Total pot 100 | Rake 0 
Seat 1: s70n3fac3 (button) (small blind) folded before Flop
Seat 2: FDIBA2009 (big blind) collected (100)



PokerStars Home Game Hand #227251717136: {Club #4781089}  Hold'em No Limit (50/100) - 2021/06/02 0:23:51 EET [2021/06/01 17:23:51 ET]
Table 'VTPP NLHE 0106' 2-max (Play Money) Seat #2 is the button
Seat 1: s70n3fac3 (14372 in chips) 
Seat 2: FDIBA2009 (18038 in chips) 
FDIBA2009: posts small blind 50
s70n3fac3: posts big blind 100
*** HOLE CARDS ***
FDIBA2009: raises 100 to 200
s70n3fac3: calls 100
*** FLOP *** [2d 4d 5d]
s70n3fac3: checks 
FDIBA2009: checks 
*** TURN *** [2d 4d 5d] [2h]
s70n3fac3: checks 
FDIBA2009: checks 
*** RIVER *** [2d 4d 5d 2h] [4s]
s70n3fac3: bets 300
FDIBA2009: folds 
Uncalled bet (300) returned to s70n3fac3
s70n3fac3 collected 378 from pot
s70n3fac3: doesn't show hand 
*** SUMMARY ***
Total pot 400 | Rake 22 
Board [2d 4d 5d 2h 4s]
Seat 1: s70n3fac3 (big blind) collected (378)
Seat 2: FDIBA2009 (button) (small blind) folded on the River



PokerStars Home Game Hand #227251724075: {Club #4781089}  Hold'em No Limit (50/100) - 2021/06/02 0:24:05 EET [2021/06/01 17:24:05 ET]
Table 'VTPP NLHE 0106' 2-max (Play Money) Seat #1 is the button
Seat 1: s70n3fac3 (14550 in chips) 
Seat 2: FDIBA2009 (17838 in chips) 
s70n3fac3: posts small blind 50
FDIBA2009: posts big blind 100
*** HOLE CARDS ***
s70n3fac3: raises 150 to 250
FDIBA2009: folds 
Uncalled bet (150) returned to s70n3fac3
s70n3fac3 collected 200 from pot
s70n3fac3: doesn't show hand 
*** SUMMARY ***
Total pot 200 | Rake 0 
Seat 1: s70n3fac3 (button) (small blind) collected (200)
Seat 2: FDIBA2009 (big blind) folded before Flop



PokerStars Home Game Hand #227251726557: {Club #4781089}  Hold'em No Limit (50/100) - 2021/06/02 0:24:10 EET [2021/06/01 17:24:10 ET]
Table 'VTPP NLHE 0106' 2-max (Play Money) Seat #2 is the button
Seat 1: s70n3fac3 (14650 in chips) 
Seat 2: FDIBA2009 (17738 in chips) 
FDIBA2009: posts small blind 50
s70n3fac3: posts big blind 100
*** HOLE CARDS ***
FDIBA2009: folds 
Uncalled bet (50) returned to s70n3fac3
s70n3fac3 collected 100 from pot
s70n3fac3: doesn't show hand 
*** SUMMARY ***
Total pot 100 | Rake 0 
Seat 1: s70n3fac3 (big blind) collected (100)
Seat 2: FDIBA2009 (button) (small blind) folded before Flop



PokerStars Home Game Hand #227251728833: {Club #4781089}  Hold'em No Limit (50/100) - 2021/06/02 0:24:15 EET [2021/06/01 17:24:15 ET]
Table 'VTPP NLHE 0106' 2-max (Play Money) Seat #1 is the button
Seat 1: s70n3fac3 (14700 in chips) 
Seat 2: FDIBA2009 (17688 in chips) 
s70n3fac3: posts small blind 50
FDIBA2009: posts big blind 100
*** HOLE CARDS ***
s70n3fac3: raises 150 to 250
FDIBA2009: folds 
Uncalled bet (150) returned to s70n3fac3
s70n3fac3 collected 200 from pot
s70n3fac3: doesn't show hand 
*** SUMMARY ***
Total pot 200 | Rake 0 
Seat 1: s70n3fac3 (button) (small blind) collected (200)
Seat 2: FDIBA2009 (big blind) folded before Flop



PokerStars Home Game Hand #227251731895: {Club #4781089}  Hold'em No Limit (50/100) - 2021/06/02 0:24:22 EET [2021/06/01 17:24:22 ET]
Table 'VTPP NLHE 0106' 2-max (Play Money) Seat #2 is the button
Seat 1: s70n3fac3 (14800 in chips) 
Seat 2: FDIBA2009 (17588 in chips) 
FDIBA2009: posts small blind 50
s70n3fac3: posts big blind 100
*** HOLE CARDS ***
FDIBA2009: raises 100 to 200
s70n3fac3: folds 
Uncalled bet (100) returned to FDIBA2009
FDIBA2009 collected 200 from pot
FDIBA2009: doesn't show hand 
*** SUMMARY ***
Total pot 200 | Rake 0 
Seat 1: s70n3fac3 (big blind) folded before Flop
Seat 2: FDIBA2009 (button) (small blind) collected (200)



PokerStars Home Game Hand #227251734572: {Club #4781089}  Hold'em No Limit (50/100) - 2021/06/02 0:24:27 EET [2021/06/01 17:24:27 ET]
Table 'VTPP NLHE 0106' 2-max (Play Money) Seat #1 is the button
Seat 1: s70n3fac3 (14700 in chips) 
Seat 2: FDIBA2009 (17688 in chips) 
s70n3fac3: posts small blind 50
FDIBA2009: posts big blind 100
*** HOLE CARDS ***
s70n3fac3: folds 
Uncalled bet (50) returned to FDIBA2009
FDIBA2009 collected 100 from pot
FDIBA2009: doesn't show hand 
*** SUMMARY ***
Total pot 100 | Rake 0 
Seat 1: s70n3fac3 (button) (small blind) folded before Flop
Seat 2: FDIBA2009 (big blind) collected (100)



PokerStars Home Game Hand #227251736386: {Club #4781089}  Hold'em No Limit (50/100) - 2021/06/02 0:24:31 EET [2021/06/01 17:24:31 ET]
Table 'VTPP NLHE 0106' 2-max (Play Money) Seat #2 is the button
Seat 1: s70n3fac3 (14650 in chips) 
Seat 2: FDIBA2009 (17738 in chips) 
FDIBA2009: posts small blind 50
s70n3fac3: posts big blind 100
*** HOLE CARDS ***
FDIBA2009: raises 100 to 200
s70n3fac3: folds 
Uncalled bet (100) returned to FDIBA2009
FDIBA2009 collected 200 from pot
FDIBA2009: doesn't show hand 
*** SUMMARY ***
Total pot 200 | Rake 0 
Seat 1: s70n3fac3 (big blind) folded before Flop
Seat 2: FDIBA2009 (button) (small blind) collected (200)



PokerStars Home Game Hand #227251739175: {Club #4781089}  Hold'em No Limit (50/100) - 2021/06/02 0:24:37 EET [2021/06/01 17:24:37 ET]
Table 'VTPP NLHE 0106' 2-max (Play Money) Seat #1 is the button
Seat 1: s70n3fac3 (14550 in chips) 
Seat 2: FDIBA2009 (17838 in chips) 
s70n3fac3: posts small blind 50
FDIBA2009: posts big blind 100
*** HOLE CARDS ***
s70n3fac3: folds 
Uncalled bet (50) returned to FDIBA2009
FDIBA2009 collected 100 from pot
FDIBA2009: doesn't show hand 
*** SUMMARY ***
Total pot 100 | Rake 0 
Seat 1: s70n3fac3 (button) (small blind) folded before Flop
Seat 2: FDIBA2009 (big blind) collected (100)



PokerStars Home Game Hand #227251740988: {Club #4781089}  Hold'em No Limit (50/100) - 2021/06/02 0:24:40 EET [2021/06/01 17:24:40 ET]
Table 'VTPP NLHE 0106' 2-max (Play Money) Seat #2 is the button
Seat 1: s70n3fac3 (14500 in chips) 
Seat 2: FDIBA2009 (17888 in chips) 
FDIBA2009: posts small blind 50
s70n3fac3: posts big blind 100
*** HOLE CARDS ***
FDIBA2009: raises 100 to 200
s70n3fac3: calls 100
*** FLOP *** [9s 5h 3c]
s70n3fac3: checks 
FDIBA2009: bets 200
s70n3fac3: calls 200
*** TURN *** [9s 5h 3c] [8s]
s70n3fac3: checks 
FDIBA2009: checks 
*** RIVER *** [9s 5h 3c 8s] [4s]
s70n3fac3: bets 400
FDIBA2009: folds 
Uncalled bet (400) returned to s70n3fac3
s70n3fac3 collected 756 from pot
s70n3fac3: doesn't show hand 
*** SUMMARY ***
Total pot 800 | Rake 44 
Board [9s 5h 3c 8s 4s]
Seat 1: s70n3fac3 (big blind) collected (756)
Seat 2: FDIBA2009 (button) (small blind) folded on the River



PokerStars Home Game Hand #227251749446: {Club #4781089}  Hold'em No Limit (50/100) - 2021/06/02 0:24:58 EET [2021/06/01 17:24:58 ET]
Table 'VTPP NLHE 0106' 2-max (Play Money) Seat #1 is the button
Seat 1: s70n3fac3 (14856 in chips) 
Seat 2: FDIBA2009 (17488 in chips) 
s70n3fac3: posts small blind 50
FDIBA2009: posts big blind 100
*** HOLE CARDS ***
s70n3fac3: raises 150 to 250
FDIBA2009: calls 150
*** FLOP *** [6d Qs 6h]
FDIBA2009: checks 
s70n3fac3: checks 
*** TURN *** [6d Qs 6h] [Ks]
FDIBA2009: bets 236
s70n3fac3: calls 236
*** RIVER *** [6d Qs 6h Ks] [Qh]
FDIBA2009: checks 
s70n3fac3: bets 400
FDIBA2009: folds 
Uncalled bet (400) returned to s70n3fac3
s70n3fac3 collected 919 from pot
s70n3fac3: doesn't show hand 
*** SUMMARY ***
Total pot 972 | Rake 53 
Board [6d Qs 6h Ks Qh]
Seat 1: s70n3fac3 (button) (small blind) collected (919)
Seat 2: FDIBA2009 (big blind) folded on the River



PokerStars Home Game Hand #227251759655: {Club #4781089}  Hold'em No Limit (50/100) - 2021/06/02 0:25:19 EET [2021/06/01 17:25:19 ET]
Table 'VTPP NLHE 0106' 2-max (Play Money) Seat #2 is the button
Seat 1: s70n3fac3 (15289 in chips) 
Seat 2: FDIBA2009 (17002 in chips) 
FDIBA2009: posts small blind 50
s70n3fac3: posts big blind 100
*** HOLE CARDS ***
FDIBA2009: raises 100 to 200
s70n3fac3: calls 100
*** FLOP *** [6s 8c 3d]
s70n3fac3: checks 
FDIBA2009: bets 378
s70n3fac3: calls 378
*** TURN *** [6s 8c 3d] [3h]
s70n3fac3: checks 
FDIBA2009: checks 
*** RIVER *** [6s 8c 3d 3h] [8d]
s70n3fac3: checks 
FDIBA2009: checks 
*** SHOW DOWN ***
s70n3fac3: shows [4h 7c] (two pair, Eights and Threes)
FDIBA2009: shows [9s 4s] (two pair, Eights and Threes - Nine kicker)
FDIBA2009 collected 1092 from pot
*** SUMMARY ***
Total pot 1156 | Rake 64 
Board [6s 8c 3d 3h 8d]
Seat 1: s70n3fac3 (big blind) showed [4h 7c] and lost with two pair, Eights and Threes
Seat 2: FDIBA2009 (button) (small blind) showed [9s 4s] and won (1092) with two pair, Eights and Threes



PokerStars Home Game Hand #227251769042: {Club #4781089}  Hold'em No Limit (50/100) - 2021/06/02 0:25:39 EET [2021/06/01 17:25:39 ET]
Table 'VTPP NLHE 0106' 2-max (Play Money) Seat #1 is the button
Seat 1: s70n3fac3 (14711 in chips) 
Seat 2: FDIBA2009 (17516 in chips) 
s70n3fac3: posts small blind 50
FDIBA2009: posts big blind 100
*** HOLE CARDS ***
s70n3fac3: raises 150 to 250
FDIBA2009: raises 150 to 400
s70n3fac3: calls 150
*** FLOP *** [Js Jh 2c]
FDIBA2009: checks 
s70n3fac3: checks 
*** TURN *** [Js Jh 2c] [8c]
FDIBA2009: bets 450
s70n3fac3: raises 650 to 1100
FDIBA2009: folds 
Uncalled bet (650) returned to s70n3fac3
s70n3fac3 collected 1606 from pot
s70n3fac3: doesn't show hand 
*** SUMMARY ***
Total pot 1700 | Rake 94 
Board [Js Jh 2c 8c]
Seat 1: s70n3fac3 (button) (small blind) collected (1606)
Seat 2: FDIBA2009 (big blind) folded on the Turn



PokerStars Home Game Hand #227251779968: {Club #4781089}  Hold'em No Limit (50/100) - 2021/06/02 0:26:01 EET [2021/06/01 17:26:01 ET]
Table 'VTPP NLHE 0106' 2-max (Play Money) Seat #2 is the button
Seat 1: s70n3fac3 (15467 in chips) 
Seat 2: FDIBA2009 (16666 in chips) 
FDIBA2009: posts small blind 50
s70n3fac3: posts big blind 100
*** HOLE CARDS ***
FDIBA2009: raises 200 to 300
s70n3fac3: folds 
Uncalled bet (200) returned to FDIBA2009
FDIBA2009 collected 200 from pot
FDIBA2009: doesn't show hand 
*** SUMMARY ***
Total pot 200 | Rake 0 
Seat 1: s70n3fac3 (big blind) folded before Flop
Seat 2: FDIBA2009 (button) (small blind) collected (200)



PokerStars Home Game Hand #227251783137: {Club #4781089}  Hold'em No Limit (50/100) - 2021/06/02 0:26:08 EET [2021/06/01 17:26:08 ET]
Table 'VTPP NLHE 0106' 2-max (Play Money) Seat #1 is the button
Seat 1: s70n3fac3 (15367 in chips) 
Seat 2: FDIBA2009 (16766 in chips) 
s70n3fac3: posts small blind 50
FDIBA2009: posts big blind 100
*** HOLE CARDS ***
s70n3fac3: folds 
Uncalled bet (50) returned to FDIBA2009
FDIBA2009 collected 100 from pot
FDIBA2009: doesn't show hand 
*** SUMMARY ***
Total pot 100 | Rake 0 
Seat 1: s70n3fac3 (button) (small blind) folded before Flop
Seat 2: FDIBA2009 (big blind) collected (100)



PokerStars Home Game Hand #227251785049: {Club #4781089}  Hold'em No Limit (50/100) - 2021/06/02 0:26:12 EET [2021/06/01 17:26:12 ET]
Table 'VTPP NLHE 0106' 2-max (Play Money) Seat #2 is the button
Seat 1: s70n3fac3 (15317 in chips) 
Seat 2: FDIBA2009 (16816 in chips) 
FDIBA2009: posts small blind 50
s70n3fac3: posts big blind 100
*** HOLE CARDS ***
FDIBA2009: raises 100 to 200
s70n3fac3: calls 100
*** FLOP *** [4h 3h 4c]
s70n3fac3: checks 
FDIBA2009: checks 
*** TURN *** [4h 3h 4c] [Ah]
s70n3fac3: checks 
FDIBA2009: bets 200
s70n3fac3: calls 200
*** RIVER *** [4h 3h 4c Ah] [9s]
s70n3fac3: checks 
FDIBA2009: checks 
*** SHOW DOWN ***
s70n3fac3: shows [6h 9c] (two pair, Nines and Fours)
FDIBA2009: mucks hand 
s70n3fac3 collected 756 from pot
*** SUMMARY ***
Total pot 800 | Rake 44 
Board [4h 3h 4c Ah 9s]
Seat 1: s70n3fac3 (big blind) showed [6h 9c] and won (756) with two pair, Nines and Fours
Seat 2: FDIBA2009 (button) (small blind) mucked [8s 2s]



PokerStars Home Game Hand #227251792929: {Club #4781089}  Hold'em No Limit (50/100) - 2021/06/02 0:26:28 EET [2021/06/01 17:26:28 ET]
Table 'VTPP NLHE 0106' 2-max (Play Money) Seat #1 is the button
Seat 1: s70n3fac3 (15673 in chips) 
Seat 2: FDIBA2009 (16416 in chips) 
s70n3fac3: posts small blind 50
FDIBA2009: posts big blind 100
*** HOLE CARDS ***
s70n3fac3: folds 
Uncalled bet (50) returned to FDIBA2009
FDIBA2009 collected 100 from pot
FDIBA2009: doesn't show hand 
*** SUMMARY ***
Total pot 100 | Rake 0 
Seat 1: s70n3fac3 (button) (small blind) folded before Flop
Seat 2: FDIBA2009 (big blind) collected (100)



PokerStars Home Game Hand #227251794673: {Club #4781089}  Hold'em No Limit (50/100) - 2021/06/02 0:26:32 EET [2021/06/01 17:26:32 ET]
Table 'VTPP NLHE 0106' 2-max (Play Money) Seat #2 is the button
Seat 1: s70n3fac3 (15623 in chips) 
Seat 2: FDIBA2009 (16466 in chips) 
FDIBA2009: posts small blind 50
s70n3fac3: posts big blind 100
*** HOLE CARDS ***
FDIBA2009: raises 100 to 200
s70n3fac3: raises 400 to 600
FDIBA2009: folds 
Uncalled bet (400) returned to s70n3fac3
s70n3fac3 collected 400 from pot
s70n3fac3: doesn't show hand 
*** SUMMARY ***
Total pot 400 | Rake 0 
Seat 1: s70n3fac3 (big blind) collected (400)
Seat 2: FDIBA2009 (button) (small blind) folded before Flop



PokerStars Home Game Hand #227251799170: {Club #4781089}  Hold'em No Limit (50/100) - 2021/06/02 0:26:41 EET [2021/06/01 17:26:41 ET]
Table 'VTPP NLHE 0106' 2-max (Play Money) Seat #1 is the button
Seat 1: s70n3fac3 (15823 in chips) 
Seat 2: FDIBA2009 (16266 in chips) 
s70n3fac3: posts small blind 50
FDIBA2009: posts big blind 100
*** HOLE CARDS ***
s70n3fac3: raises 150 to 250
FDIBA2009: calls 150
*** FLOP *** [2s 6h 4s]
FDIBA2009: checks 
s70n3fac3: checks 
*** TURN *** [2s 6h 4s] [8h]
FDIBA2009: checks 
s70n3fac3: bets 300
FDIBA2009: calls 300
*** RIVER *** [2s 6h 4s 8h] [5c]
FDIBA2009: bets 1100
s70n3fac3: folds 
Uncalled bet (1100) returned to FDIBA2009
FDIBA2009 collected 1039 from pot
FDIBA2009: doesn't show hand 
*** SUMMARY ***
Total pot 1100 | Rake 61 
Board [2s 6h 4s 8h 5c]
Seat 1: s70n3fac3 (button) (small blind) folded on the River
Seat 2: FDIBA2009 (big blind) collected (1039)



PokerStars Home Game Hand #227251809700: {Club #4781089}  Hold'em No Limit (50/100) - 2021/06/02 0:27:03 EET [2021/06/01 17:27:03 ET]
Table 'VTPP NLHE 0106' 2-max (Play Money) Seat #2 is the button
Seat 1: s70n3fac3 (15273 in chips) 
Seat 2: FDIBA2009 (16755 in chips) 
FDIBA2009: posts small blind 50
s70n3fac3: posts big blind 100
*** HOLE CARDS ***
FDIBA2009: raises 100 to 200
s70n3fac3: folds 
Uncalled bet (100) returned to FDIBA2009
FDIBA2009 collected 200 from pot
FDIBA2009: doesn't show hand 
*** SUMMARY ***
Total pot 200 | Rake 0 
Seat 1: s70n3fac3 (big blind) folded before Flop
Seat 2: FDIBA2009 (button) (small blind) collected (200)



PokerStars Home Game Hand #227251813442: {Club #4781089}  Hold'em No Limit (50/100) - 2021/06/02 0:27:11 EET [2021/06/01 17:27:11 ET]
Table 'VTPP NLHE 0106' 2-max (Play Money) Seat #1 is the button
Seat 1: s70n3fac3 (15173 in chips) 
Seat 2: FDIBA2009 (16855 in chips) 
s70n3fac3: posts small blind 50
FDIBA2009: posts big blind 100
*** HOLE CARDS ***
s70n3fac3: calls 50
FDIBA2009: checks 
*** FLOP *** [Kh 4h 9c]
FDIBA2009: checks 
s70n3fac3: checks 
*** TURN *** [Kh 4h 9c] [6h]
FDIBA2009: checks 
s70n3fac3: checks 
*** RIVER *** [Kh 4h 9c 6h] [3d]
FDIBA2009: checks 
s70n3fac3: checks 
*** SHOW DOWN ***
FDIBA2009: shows [Qd Js] (high card King)
s70n3fac3: mucks hand 
FDIBA2009 collected 189 from pot
*** SUMMARY ***
Total pot 200 | Rake 11 
Board [Kh 4h 9c 6h 3d]
Seat 1: s70n3fac3 (button) (small blind) mucked [Jc 8d]
Seat 2: FDIBA2009 (big blind) showed [Qd Js] and won (189) with high card King



PokerStars Home Game Hand #227251821558: {Club #4781089}  Hold'em No Limit (50/100) - 2021/06/02 0:27:28 EET [2021/06/01 17:27:28 ET]
Table 'VTPP NLHE 0106' 2-max (Play Money) Seat #2 is the button
Seat 1: s70n3fac3 (15073 in chips) 
Seat 2: FDIBA2009 (16944 in chips) 
FDIBA2009: posts small blind 50
s70n3fac3: posts big blind 100
*** HOLE CARDS ***
FDIBA2009: raises 100 to 200
s70n3fac3: raises 400 to 600
FDIBA2009: folds 
Uncalled bet (400) returned to s70n3fac3
s70n3fac3 collected 400 from pot
s70n3fac3: doesn't show hand 
*** SUMMARY ***
Total pot 400 | Rake 0 
Seat 1: s70n3fac3 (big blind) collected (400)
Seat 2: FDIBA2009 (button) (small blind) folded before Flop



PokerStars Home Game Hand #227251824969: {Club #4781089}  Hold'em No Limit (50/100) - 2021/06/02 0:27:35 EET [2021/06/01 17:27:35 ET]
Table 'VTPP NLHE 0106' 2-max (Play Money) Seat #1 is the button
Seat 1: s70n3fac3 (15273 in chips) 
Seat 2: FDIBA2009 (16744 in chips) 
s70n3fac3: posts small blind 50
FDIBA2009: posts big blind 100
*** HOLE CARDS ***
s70n3fac3: raises 150 to 250
FDIBA2009: calls 150
*** FLOP *** [2h 3c Qc]
FDIBA2009: checks 
s70n3fac3: checks 
*** TURN *** [2h 3c Qc] [4d]
FDIBA2009: checks 
s70n3fac3: bets 300
FDIBA2009: calls 300
*** RIVER *** [2h 3c Qc 4d] [6s]
FDIBA2009: checks 
s70n3fac3: checks 
*** SHOW DOWN ***
FDIBA2009: shows [Th Kc] (high card King)
s70n3fac3: shows [9d Ah] (high card Ace)
s70n3fac3 collected 1039 from pot
*** SUMMARY ***
Total pot 1100 | Rake 61 
Board [2h 3c Qc 4d 6s]
Seat 1: s70n3fac3 (button) (small blind) showed [9d Ah] and won (1039) with high card Ace
Seat 2: FDIBA2009 (big blind) showed [Th Kc] and lost with high card King



PokerStars Home Game Hand #227251834152: {Club #4781089}  Hold'em No Limit (50/100) - 2021/06/02 0:27:54 EET [2021/06/01 17:27:54 ET]
Table 'VTPP NLHE 0106' 2-max (Play Money) Seat #2 is the button
Seat 1: s70n3fac3 (15762 in chips) 
Seat 2: FDIBA2009 (16194 in chips) 
FDIBA2009: posts small blind 50
s70n3fac3: posts big blind 100
*** HOLE CARDS ***
FDIBA2009: folds 
Uncalled bet (50) returned to s70n3fac3
s70n3fac3 collected 100 from pot
s70n3fac3: doesn't show hand 
*** SUMMARY ***
Total pot 100 | Rake 0 
Seat 1: s70n3fac3 (big blind) collected (100)
Seat 2: FDIBA2009 (button) (small blind) folded before Flop



PokerStars Home Game Hand #227251836479: {Club #4781089}  Hold'em No Limit (50/100) - 2021/06/02 0:27:59 EET [2021/06/01 17:27:59 ET]
Table 'VTPP NLHE 0106' 2-max (Play Money) Seat #1 is the button
Seat 1: s70n3fac3 (15812 in chips) 
Seat 2: FDIBA2009 (16144 in chips) 
s70n3fac3: posts small blind 50
FDIBA2009: posts big blind 100
*** HOLE CARDS ***
s70n3fac3: folds 
Uncalled bet (50) returned to FDIBA2009
FDIBA2009 collected 100 from pot
FDIBA2009: doesn't show hand 
*** SUMMARY ***
Total pot 100 | Rake 0 
Seat 1: s70n3fac3 (button) (small blind) folded before Flop
Seat 2: FDIBA2009 (big blind) collected (100)



PokerStars Home Game Hand #227251838202: {Club #4781089}  Hold'em No Limit (50/100) - 2021/06/02 0:28:03 EET [2021/06/01 17:28:03 ET]
Table 'VTPP NLHE 0106' 2-max (Play Money) Seat #2 is the button
Seat 1: s70n3fac3 (15762 in chips) 
Seat 2: FDIBA2009 (16194 in chips) 
FDIBA2009: posts small blind 50
s70n3fac3: posts big blind 100
*** HOLE CARDS ***
FDIBA2009: raises 200 to 300
s70n3fac3: calls 200
*** FLOP *** [7s 3h Jc]
s70n3fac3: checks 
FDIBA2009: checks 
*** TURN *** [7s 3h Jc] [6c]
s70n3fac3: checks 
FDIBA2009: bets 567
s70n3fac3: folds 
Uncalled bet (567) returned to FDIBA2009
FDIBA2009 collected 567 from pot
FDIBA2009: doesn't show hand 
*** SUMMARY ***
Total pot 600 | Rake 33 
Board [7s 3h Jc 6c]
Seat 1: s70n3fac3 (big blind) folded on the Turn
Seat 2: FDIBA2009 (button) (small blind) collected (567)



PokerStars Home Game Hand #227251845004: {Club #4781089}  Hold'em No Limit (50/100) - 2021/06/02 0:28:17 EET [2021/06/01 17:28:17 ET]
Table 'VTPP NLHE 0106' 2-max (Play Money) Seat #1 is the button
Seat 1: s70n3fac3 (15462 in chips) 
Seat 2: FDIBA2009 (16461 in chips) 
s70n3fac3: posts small blind 50
FDIBA2009: posts big blind 100
*** HOLE CARDS ***
s70n3fac3: raises 150 to 250
FDIBA2009: raises 500 to 750
s70n3fac3: calls 500
*** FLOP *** [8s Qd Tc]
FDIBA2009: checks 
s70n3fac3: bets 500
FDIBA2009: raises 2450 to 2950
s70n3fac3: calls 2450
*** TURN *** [8s Qd Tc] [8h]
FDIBA2009: bets 6993
s70n3fac3: folds 
Uncalled bet (6993) returned to FDIBA2009
FDIBA2009 collected 6993 from pot
FDIBA2009: doesn't show hand 
*** SUMMARY ***
Total pot 7400 | Rake 407 
Board [8s Qd Tc 8h]
Seat 1: s70n3fac3 (button) (small blind) folded on the Turn
Seat 2: FDIBA2009 (big blind) collected (6993)



PokerStars Home Game Hand #227251868813: {Club #4781089}  Hold'em No Limit (50/100) - 2021/06/02 0:29:08 EET [2021/06/01 17:29:08 ET]
Table 'VTPP NLHE 0106' 2-max (Play Money) Seat #2 is the button
Seat 1: s70n3fac3 (11762 in chips) 
Seat 2: FDIBA2009 (19754 in chips) 
FDIBA2009: posts small blind 50
s70n3fac3: posts big blind 100
*** HOLE CARDS ***
FDIBA2009: raises 100 to 200
s70n3fac3: folds 
Uncalled bet (100) returned to FDIBA2009
FDIBA2009 collected 200 from pot
FDIBA2009: doesn't show hand 
*** SUMMARY ***
Total pot 200 | Rake 0 
Seat 1: s70n3fac3 (big blind) folded before Flop
Seat 2: FDIBA2009 (button) (small blind) collected (200)



PokerStars Home Game Hand #227251872454: {Club #4781089}  Hold'em No Limit (50/100) - 2021/06/02 0:29:16 EET [2021/06/01 17:29:16 ET]
Table 'VTPP NLHE 0106' 2-max (Play Money) Seat #1 is the button
Seat 1: s70n3fac3 (11662 in chips) 
Seat 2: FDIBA2009 (19854 in chips) 
s70n3fac3: posts small blind 50
FDIBA2009: posts big blind 100
*** HOLE CARDS ***
s70n3fac3: raises 150 to 250
FDIBA2009: calls 150
*** FLOP *** [9s Th 5h]
FDIBA2009: checks 
s70n3fac3: checks 
*** TURN *** [9s Th 5h] [Js]
FDIBA2009: checks 
s70n3fac3: bets 200
FDIBA2009: calls 200
*** RIVER *** [9s Th 5h Js] [8d]
FDIBA2009: checks 
s70n3fac3: bets 400
FDIBA2009: folds 
Uncalled bet (400) returned to s70n3fac3
s70n3fac3 collected 850 from pot
s70n3fac3: doesn't show hand 
*** SUMMARY ***
Total pot 900 | Rake 50 
Board [9s Th 5h Js 8d]
Seat 1: s70n3fac3 (button) (small blind) collected (850)
Seat 2: FDIBA2009 (big blind) folded on the River



PokerStars Home Game Hand #227251883648: {Club #4781089}  Hold'em No Limit (50/100) - 2021/06/02 0:29:39 EET [2021/06/01 17:29:39 ET]
Table 'VTPP NLHE 0106' 2-max (Play Money) Seat #2 is the button
Seat 1: s70n3fac3 (12062 in chips) 
Seat 2: FDIBA2009 (19404 in chips) 
FDIBA2009: posts small blind 50
s70n3fac3: posts big blind 100
*** HOLE CARDS ***
FDIBA2009: raises 100 to 200
s70n3fac3: calls 100
*** FLOP *** [9s 2h 5s]
s70n3fac3: checks 
FDIBA2009: checks 
*** TURN *** [9s 2h 5s] [Ks]
s70n3fac3: checks 
FDIBA2009: checks 
*** RIVER *** [9s 2h 5s Ks] [Ts]
s70n3fac3: checks 
FDIBA2009: bets 100
s70n3fac3: folds 
Uncalled bet (100) returned to FDIBA2009
FDIBA2009 collected 378 from pot
FDIBA2009: doesn't show hand 
*** SUMMARY ***
Total pot 400 | Rake 22 
Board [9s 2h 5s Ks Ts]
Seat 1: s70n3fac3 (big blind) folded on the River
Seat 2: FDIBA2009 (button) (small blind) collected (378)



PokerStars Home Game Hand #227251890623: {Club #4781089}  Hold'em No Limit (50/100) - 2021/06/02 0:29:53 EET [2021/06/01 17:29:53 ET]
Table 'VTPP NLHE 0106' 2-max (Play Money) Seat #1 is the button
Seat 1: s70n3fac3 (11862 in chips) 
Seat 2: FDIBA2009 (19582 in chips) 
s70n3fac3: posts small blind 50
FDIBA2009: posts big blind 100
*** HOLE CARDS ***
s70n3fac3: raises 150 to 250
FDIBA2009: calls 150
*** FLOP *** [Th 5d 9h]
FDIBA2009: checks 
s70n3fac3: bets 200
FDIBA2009: calls 200
*** TURN *** [Th 5d 9h] [Js]
FDIBA2009: checks 
s70n3fac3: bets 300
FDIBA2009: calls 300
*** RIVER *** [Th 5d 9h Js] [4h]
FDIBA2009: checks 
s70n3fac3: bets 500
FDIBA2009: folds 
Uncalled bet (500) returned to s70n3fac3
s70n3fac3 collected 1417 from pot
s70n3fac3: doesn't show hand 
*** SUMMARY ***
Total pot 1500 | Rake 83 
Board [Th 5d 9h Js 4h]
Seat 1: s70n3fac3 (button) (small blind) collected (1417)
Seat 2: FDIBA2009 (big blind) folded on the River



PokerStars Home Game Hand #227251903751: {Club #4781089}  Hold'em No Limit (50/100) - 2021/06/02 0:30:21 EET [2021/06/01 17:30:21 ET]
Table 'VTPP NLHE 0106' 2-max (Play Money) Seat #2 is the button
Seat 1: s70n3fac3 (12529 in chips) 
Seat 2: FDIBA2009 (18832 in chips) 
FDIBA2009: posts small blind 50
s70n3fac3: posts big blind 100
*** HOLE CARDS ***
FDIBA2009: raises 200 to 300
s70n3fac3: raises 600 to 900
FDIBA2009: folds 
Uncalled bet (600) returned to s70n3fac3
s70n3fac3 collected 600 from pot
s70n3fac3: doesn't show hand 
*** SUMMARY ***
Total pot 600 | Rake 0 
Seat 1: s70n3fac3 (big blind) collected (600)
Seat 2: FDIBA2009 (button) (small blind) folded before Flop



PokerStars Home Game Hand #227251908548: {Club #4781089}  Hold'em No Limit (50/100) - 2021/06/02 0:30:31 EET [2021/06/01 17:30:31 ET]
Table 'VTPP NLHE 0106' 2-max (Play Money) Seat #1 is the button
Seat 1: s70n3fac3 (12829 in chips) 
Seat 2: FDIBA2009 (18532 in chips) 
s70n3fac3: posts small blind 50
FDIBA2009: posts big blind 100
*** HOLE CARDS ***
s70n3fac3: raises 150 to 250
FDIBA2009: folds 
Uncalled bet (150) returned to s70n3fac3
s70n3fac3 collected 200 from pot
s70n3fac3: doesn't show hand 
*** SUMMARY ***
Total pot 200 | Rake 0 
Seat 1: s70n3fac3 (button) (small blind) collected (200)
Seat 2: FDIBA2009 (big blind) folded before Flop



PokerStars Home Game Hand #227251910986: {Club #4781089}  Hold'em No Limit (50/100) - 2021/06/02 0:30:36 EET [2021/06/01 17:30:36 ET]
Table 'VTPP NLHE 0106' 2-max (Play Money) Seat #2 is the button
Seat 1: s70n3fac3 (12929 in chips) 
Seat 2: FDIBA2009 (18432 in chips) 
FDIBA2009: posts small blind 50
s70n3fac3: posts big blind 100
*** HOLE CARDS ***
FDIBA2009: raises 200 to 300
s70n3fac3: folds 
Uncalled bet (200) returned to FDIBA2009
FDIBA2009 collected 200 from pot
FDIBA2009: doesn't show hand 
*** SUMMARY ***
Total pot 200 | Rake 0 
Seat 1: s70n3fac3 (big blind) folded before Flop
Seat 2: FDIBA2009 (button) (small blind) collected (200)



PokerStars Home Game Hand #227251914585: {Club #4781089}  Hold'em No Limit (50/100) - 2021/06/02 0:30:44 EET [2021/06/01 17:30:44 ET]
Table 'VTPP NLHE 0106' 2-max (Play Money) Seat #1 is the button
Seat 1: s70n3fac3 (12829 in chips) 
Seat 2: FDIBA2009 (18532 in chips) 
s70n3fac3: posts small blind 50
FDIBA2009: posts big blind 100
*** HOLE CARDS ***
s70n3fac3: folds 
Uncalled bet (50) returned to FDIBA2009
FDIBA2009 collected 100 from pot
FDIBA2009: doesn't show hand 
*** SUMMARY ***
Total pot 100 | Rake 0 
Seat 1: s70n3fac3 (button) (small blind) folded before Flop
Seat 2: FDIBA2009 (big blind) collected (100)



PokerStars Home Game Hand #227251916464: {Club #4781089}  Hold'em No Limit (50/100) - 2021/06/02 0:30:47 EET [2021/06/01 17:30:47 ET]
Table 'VTPP NLHE 0106' 2-max (Play Money) Seat #2 is the button
Seat 1: s70n3fac3 (12779 in chips) 
Seat 2: FDIBA2009 (18582 in chips) 
FDIBA2009: posts small blind 50
s70n3fac3: posts big blind 100
*** HOLE CARDS ***
FDIBA2009: folds 
Uncalled bet (50) returned to s70n3fac3
s70n3fac3 collected 100 from pot
s70n3fac3: doesn't show hand 
*** SUMMARY ***
Total pot 100 | Rake 0 
Seat 1: s70n3fac3 (big blind) collected (100)
Seat 2: FDIBA2009 (button) (small blind) folded before Flop



PokerStars Home Game Hand #227251919825: {Club #4781089}  Hold'em No Limit (50/100) - 2021/06/02 0:30:54 EET [2021/06/01 17:30:54 ET]
Table 'VTPP NLHE 0106' 2-max (Play Money) Seat #1 is the button
Seat 1: s70n3fac3 (12829 in chips) 
Seat 2: FDIBA2009 (18532 in chips) 
s70n3fac3: posts small blind 50
FDIBA2009: posts big blind 100
*** HOLE CARDS ***
s70n3fac3: raises 150 to 250
FDIBA2009: raises 150 to 400
s70n3fac3: calls 150
*** FLOP *** [Js Ts 3h]
FDIBA2009: bets 550
s70n3fac3: folds 
Uncalled bet (550) returned to FDIBA2009
FDIBA2009 collected 756 from pot
FDIBA2009: doesn't show hand 
*** SUMMARY ***
Total pot 800 | Rake 44 
Board [Js Ts 3h]
Seat 1: s70n3fac3 (button) (small blind) folded on the Flop
Seat 2: FDIBA2009 (big blind) collected (756)



PokerStars Home Game Hand #227251926689: {Club #4781089}  Hold'em No Limit (50/100) - 2021/06/02 0:31:09 EET [2021/06/01 17:31:09 ET]
Table 'VTPP NLHE 0106' 2-max (Play Money) Seat #2 is the button
Seat 1: s70n3fac3 (12429 in chips) 
Seat 2: FDIBA2009 (18888 in chips) 
FDIBA2009: posts small blind 50
s70n3fac3: posts big blind 100
*** HOLE CARDS ***
FDIBA2009: raises 100 to 200
s70n3fac3: calls 100
*** FLOP *** [Qc 9h As]
s70n3fac3: checks 
FDIBA2009: checks 
*** TURN *** [Qc 9h As] [7s]
s70n3fac3: checks 
FDIBA2009: checks 
*** RIVER *** [Qc 9h As 7s] [6h]
s70n3fac3: checks 
FDIBA2009: checks 
*** SHOW DOWN ***
s70n3fac3: shows [5s 6c] (a pair of Sixes)
FDIBA2009: mucks hand 
s70n3fac3 collected 378 from pot
*** SUMMARY ***
Total pot 400 | Rake 22 
Board [Qc 9h As 7s 6h]
Seat 1: s70n3fac3 (big blind) showed [5s 6c] and won (378) with a pair of Sixes
Seat 2: FDIBA2009 (button) (small blind) mucked [Kd 2h]



PokerStars Home Game Hand #227251933455: {Club #4781089}  Hold'em No Limit (50/100) - 2021/06/02 0:31:23 EET [2021/06/01 17:31:23 ET]
Table 'VTPP NLHE 0106' 2-max (Play Money) Seat #1 is the button
Seat 1: s70n3fac3 (12607 in chips) 
Seat 2: FDIBA2009 (18688 in chips) 
s70n3fac3: posts small blind 50
FDIBA2009: posts big blind 100
*** HOLE CARDS ***
s70n3fac3: calls 50
FDIBA2009: checks 
*** FLOP *** [4h 7c 3s]
FDIBA2009: bets 100
s70n3fac3: calls 100
*** TURN *** [4h 7c 3s] [3h]
FDIBA2009: bets 100
s70n3fac3: calls 100
*** RIVER *** [4h 7c 3s 3h] [Qs]
FDIBA2009: checks 
s70n3fac3: bets 500
FDIBA2009: folds 
Uncalled bet (500) returned to s70n3fac3
s70n3fac3 collected 567 from pot
s70n3fac3: doesn't show hand 
*** SUMMARY ***
Total pot 600 | Rake 33 
Board [4h 7c 3s 3h Qs]
Seat 1: s70n3fac3 (button) (small blind) collected (567)
Seat 2: FDIBA2009 (big blind) folded on the River



PokerStars Home Game Hand #227251943073: {Club #4781089}  Hold'em No Limit (50/100) - 2021/06/02 0:31:43 EET [2021/06/01 17:31:43 ET]
Table 'VTPP NLHE 0106' 2-max (Play Money) Seat #2 is the button
Seat 1: s70n3fac3 (12874 in chips) 
Seat 2: FDIBA2009 (18388 in chips) 
FDIBA2009: posts small blind 50
s70n3fac3: posts big blind 100
*** HOLE CARDS ***
FDIBA2009: raises 100 to 200
s70n3fac3: calls 100
*** FLOP *** [Kc Th 7d]
s70n3fac3: checks 
FDIBA2009: checks 
*** TURN *** [Kc Th 7d] [Tc]
s70n3fac3: checks 
FDIBA2009: checks 
*** RIVER *** [Kc Th 7d Tc] [Qh]
s70n3fac3: checks 
FDIBA2009: bets 378
s70n3fac3: folds 
Uncalled bet (378) returned to FDIBA2009
FDIBA2009 collected 378 from pot
FDIBA2009: doesn't show hand 
*** SUMMARY ***
Total pot 400 | Rake 22 
Board [Kc Th 7d Tc Qh]
Seat 1: s70n3fac3 (big blind) folded on the River
Seat 2: FDIBA2009 (button) (small blind) collected (378)



PokerStars Home Game Hand #227251950645: {Club #4781089}  Hold'em No Limit (50/100) - 2021/06/02 0:31:59 EET [2021/06/01 17:31:59 ET]
Table 'VTPP NLHE 0106' 2-max (Play Money) Seat #1 is the button
Seat 1: s70n3fac3 (12674 in chips) 
Seat 2: FDIBA2009 (18566 in chips) 
s70n3fac3: posts small blind 50
FDIBA2009: posts big blind 100
*** HOLE CARDS ***
s70n3fac3: raises 150 to 250
FDIBA2009: calls 150
*** FLOP *** [3c 2d Tc]
FDIBA2009: checks 
s70n3fac3: checks 
*** TURN *** [3c 2d Tc] [Kd]
FDIBA2009: checks 
s70n3fac3: bets 300
FDIBA2009: folds 
Uncalled bet (300) returned to s70n3fac3
s70n3fac3 collected 472 from pot
s70n3fac3: doesn't show hand 
*** SUMMARY ***
Total pot 500 | Rake 28 
Board [3c 2d Tc Kd]
Seat 1: s70n3fac3 (button) (small blind) collected (472)
Seat 2: FDIBA2009 (big blind) folded on the Turn



PokerStars Home Game Hand #227251958212: {Club #4781089}  Hold'em No Limit (50/100) - 2021/06/02 0:32:15 EET [2021/06/01 17:32:15 ET]
Table 'VTPP NLHE 0106' 2-max (Play Money) Seat #2 is the button
Seat 1: s70n3fac3 (12896 in chips) 
Seat 2: FDIBA2009 (18316 in chips) 
FDIBA2009: posts small blind 50
s70n3fac3: posts big blind 100
*** HOLE CARDS ***
FDIBA2009: raises 100 to 200
s70n3fac3: calls 100
*** FLOP *** [5d 5s 9c]
s70n3fac3: checks 
FDIBA2009: checks 
*** TURN *** [5d 5s 9c] [3s]
s70n3fac3: checks 
FDIBA2009: checks 
*** RIVER *** [5d 5s 9c 3s] [Qd]
s70n3fac3: bets 300
FDIBA2009: folds 
Uncalled bet (300) returned to s70n3fac3
s70n3fac3 collected 378 from pot
s70n3fac3: doesn't show hand 
*** SUMMARY ***
Total pot 400 | Rake 22 
Board [5d 5s 9c 3s Qd]
Seat 1: s70n3fac3 (big blind) collected (378)
Seat 2: FDIBA2009 (button) (small blind) folded on the River



PokerStars Home Game Hand #227251965263: {Club #4781089}  Hold'em No Limit (50/100) - 2021/06/02 0:32:30 EET [2021/06/01 17:32:30 ET]
Table 'VTPP NLHE 0106' 2-max (Play Money) Seat #1 is the button
Seat 1: s70n3fac3 (13074 in chips) 
Seat 2: FDIBA2009 (18116 in chips) 
s70n3fac3: posts small blind 50
FDIBA2009: posts big blind 100
*** HOLE CARDS ***
s70n3fac3: folds 
Uncalled bet (50) returned to FDIBA2009
FDIBA2009 collected 100 from pot
FDIBA2009: doesn't show hand 
*** SUMMARY ***
Total pot 100 | Rake 0 
Seat 1: s70n3fac3 (button) (small blind) folded before Flop
Seat 2: FDIBA2009 (big blind) collected (100)



PokerStars Home Game Hand #227251967024: {Club #4781089}  Hold'em No Limit (50/100) - 2021/06/02 0:32:34 EET [2021/06/01 17:32:34 ET]
Table 'VTPP NLHE 0106' 2-max (Play Money) Seat #2 is the button
Seat 1: s70n3fac3 (13024 in chips) 
Seat 2: FDIBA2009 (18166 in chips) 
FDIBA2009: posts small blind 50
s70n3fac3: posts big blind 100
*** HOLE CARDS ***
FDIBA2009: raises 100 to 200
s70n3fac3: calls 100
*** FLOP *** [9h 2h Ks]
s70n3fac3: checks 
FDIBA2009: bets 200
s70n3fac3: calls 200
*** TURN *** [9h 2h Ks] [7s]
s70n3fac3: checks 
FDIBA2009: checks 
*** RIVER *** [9h 2h Ks 7s] [7c]
s70n3fac3: checks 
FDIBA2009: checks 
*** SHOW DOWN ***
s70n3fac3: shows [3s Ts] (a pair of Sevens)
FDIBA2009: shows [Ad Js] (a pair of Sevens - Ace kicker)
FDIBA2009 collected 756 from pot
*** SUMMARY ***
Total pot 800 | Rake 44 
Board [9h 2h Ks 7s 7c]
Seat 1: s70n3fac3 (big blind) showed [3s Ts] and lost with a pair of Sevens
Seat 2: FDIBA2009 (button) (small blind) showed [Ad Js] and won (756) with a pair of Sevens



PokerStars Home Game Hand #227251974764: {Club #4781089}  Hold'em No Limit (50/100) - 2021/06/02 0:32:50 EET [2021/06/01 17:32:50 ET]
Table 'VTPP NLHE 0106' 2-max (Play Money) Seat #1 is the button
Seat 1: s70n3fac3 (12624 in chips) 
Seat 2: FDIBA2009 (18522 in chips) 
s70n3fac3: posts small blind 50
FDIBA2009: posts big blind 100
*** HOLE CARDS ***
s70n3fac3: raises 150 to 250
FDIBA2009: raises 500 to 750
s70n3fac3: calls 500
*** FLOP *** [Jc 7d 9d]
FDIBA2009: checks 
s70n3fac3: checks 
*** TURN *** [Jc 7d 9d] [8c]
FDIBA2009: bets 1000
s70n3fac3: calls 1000
*** RIVER *** [Jc 7d 9d 8c] [Jd]
FDIBA2009: bets 1800
s70n3fac3: raises 3050 to 4850
FDIBA2009: folds 
Uncalled bet (3050) returned to s70n3fac3
s70n3fac3 collected 6709 from pot
s70n3fac3: doesn't show hand 
*** SUMMARY ***
Total pot 7100 | Rake 391 
Board [Jc 7d 9d 8c Jd]
Seat 1: s70n3fac3 (button) (small blind) collected (6709)
Seat 2: FDIBA2009 (big blind) folded on the River



PokerStars Home Game Hand #227251998045: {Club #4781089}  Hold'em No Limit (50/100) - 2021/06/02 0:33:39 EET [2021/06/01 17:33:39 ET]
Table 'VTPP NLHE 0106' 2-max (Play Money) Seat #2 is the button
Seat 1: s70n3fac3 (15783 in chips) 
Seat 2: FDIBA2009 (14972 in chips) 
FDIBA2009: posts small blind 50
s70n3fac3: posts big blind 100
*** HOLE CARDS ***
FDIBA2009: raises 200 to 300
s70n3fac3: calls 200
*** FLOP *** [Kh 8s 6c]
s70n3fac3: checks 
FDIBA2009: checks 
*** TURN *** [Kh 8s 6c] [Td]
s70n3fac3: checks 
FDIBA2009: bets 567
s70n3fac3: folds 
Uncalled bet (567) returned to FDIBA2009
FDIBA2009 collected 567 from pot
FDIBA2009: doesn't show hand 
*** SUMMARY ***
Total pot 600 | Rake 33 
Board [Kh 8s 6c Td]
Seat 1: s70n3fac3 (big blind) folded on the Turn
Seat 2: FDIBA2009 (button) (small blind) collected (567)



PokerStars Home Game Hand #227252005180: {Club #4781089}  Hold'em No Limit (50/100) - 2021/06/02 0:33:54 EET [2021/06/01 17:33:54 ET]
Table 'VTPP NLHE 0106' 2-max (Play Money) Seat #1 is the button
Seat 1: s70n3fac3 (15483 in chips) 
Seat 2: FDIBA2009 (15239 in chips) 
s70n3fac3: posts small blind 50
FDIBA2009: posts big blind 100
*** HOLE CARDS ***
s70n3fac3: folds 
Uncalled bet (50) returned to FDIBA2009
FDIBA2009 collected 100 from pot
FDIBA2009: doesn't show hand 
*** SUMMARY ***
Total pot 100 | Rake 0 
Seat 1: s70n3fac3 (button) (small blind) folded before Flop
Seat 2: FDIBA2009 (big blind) collected (100)



PokerStars Home Game Hand #227252006910: {Club #4781089}  Hold'em No Limit (50/100) - 2021/06/02 0:33:58 EET [2021/06/01 17:33:58 ET]
Table 'VTPP NLHE 0106' 2-max (Play Money) Seat #2 is the button
Seat 1: s70n3fac3 (15433 in chips) 
Seat 2: FDIBA2009 (15289 in chips) 
FDIBA2009: posts small blind 50
s70n3fac3: posts big blind 100
*** HOLE CARDS ***
FDIBA2009: raises 100 to 200
s70n3fac3: folds 
Uncalled bet (100) returned to FDIBA2009
FDIBA2009 collected 200 from pot
FDIBA2009: doesn't show hand 
*** SUMMARY ***
Total pot 200 | Rake 0 
Seat 1: s70n3fac3 (big blind) folded before Flop
Seat 2: FDIBA2009 (button) (small blind) collected (200)



PokerStars Home Game Hand #227252009934: {Club #4781089}  Hold'em No Limit (50/100) - 2021/06/02 0:34:04 EET [2021/06/01 17:34:04 ET]
Table 'VTPP NLHE 0106' 2-max (Play Money) Seat #1 is the button
Seat 1: s70n3fac3 (15333 in chips) 
Seat 2: FDIBA2009 (15389 in chips) 
s70n3fac3: posts small blind 50
FDIBA2009: posts big blind 100
*** HOLE CARDS ***
s70n3fac3: raises 150 to 250
FDIBA2009: folds 
Uncalled bet (150) returned to s70n3fac3
s70n3fac3 collected 200 from pot
s70n3fac3: doesn't show hand 
*** SUMMARY ***
Total pot 200 | Rake 0 
Seat 1: s70n3fac3 (button) (small blind) collected (200)
Seat 2: FDIBA2009 (big blind) folded before Flop



PokerStars Home Game Hand #227252012294: {Club #4781089}  Hold'em No Limit (50/100) - 2021/06/02 0:34:09 EET [2021/06/01 17:34:09 ET]
Table 'VTPP NLHE 0106' 2-max (Play Money) Seat #2 is the button
Seat 1: s70n3fac3 (15433 in chips) 
Seat 2: FDIBA2009 (15289 in chips) 
FDIBA2009: posts small blind 50
s70n3fac3: posts big blind 100
*** HOLE CARDS ***
FDIBA2009: raises 100 to 200
s70n3fac3: folds 
Uncalled bet (100) returned to FDIBA2009
FDIBA2009 collected 200 from pot
FDIBA2009: doesn't show hand 
*** SUMMARY ***
Total pot 200 | Rake 0 
Seat 1: s70n3fac3 (big blind) folded before Flop
Seat 2: FDIBA2009 (button) (small blind) collected (200)



PokerStars Home Game Hand #227252015296: {Club #4781089}  Hold'em No Limit (50/100) - 2021/06/02 0:34:15 EET [2021/06/01 17:34:15 ET]
Table 'VTPP NLHE 0106' 2-max (Play Money) Seat #1 is the button
Seat 1: s70n3fac3 (15333 in chips) 
Seat 2: FDIBA2009 (15389 in chips) 
s70n3fac3: posts small blind 50
FDIBA2009: posts big blind 100
*** HOLE CARDS ***
s70n3fac3: raises 150 to 250
FDIBA2009: folds 
Uncalled bet (150) returned to s70n3fac3
s70n3fac3 collected 200 from pot
s70n3fac3: doesn't show hand 
*** SUMMARY ***
Total pot 200 | Rake 0 
Seat 1: s70n3fac3 (button) (small blind) collected (200)
Seat 2: FDIBA2009 (big blind) folded before Flop



PokerStars Home Game Hand #227252018322: {Club #4781089}  Hold'em No Limit (50/100) - 2021/06/02 0:34:21 EET [2021/06/01 17:34:21 ET]
Table 'VTPP NLHE 0106' 2-max (Play Money) Seat #2 is the button
Seat 1: s70n3fac3 (15433 in chips) 
Seat 2: FDIBA2009 (15289 in chips) 
FDIBA2009: posts small blind 50
s70n3fac3: posts big blind 100
*** HOLE CARDS ***
FDIBA2009: raises 100 to 200
s70n3fac3: calls 100
*** FLOP *** [Qs Tc 7h]
s70n3fac3: checks 
FDIBA2009: checks 
*** TURN *** [Qs Tc 7h] [4h]
s70n3fac3: bets 200
FDIBA2009: folds 
Uncalled bet (200) returned to s70n3fac3
s70n3fac3 collected 378 from pot
s70n3fac3: doesn't show hand 
*** SUMMARY ***
Total pot 400 | Rake 22 
Board [Qs Tc 7h 4h]
Seat 1: s70n3fac3 (big blind) collected (378)
Seat 2: FDIBA2009 (button) (small blind) folded on the Turn



PokerStars Home Game Hand #227252024079: {Club #4781089}  Hold'em No Limit (50/100) - 2021/06/02 0:34:34 EET [2021/06/01 17:34:34 ET]
Table 'VTPP NLHE 0106' 2-max (Play Money) Seat #1 is the button
Seat 1: s70n3fac3 (15611 in chips) 
Seat 2: FDIBA2009 (15089 in chips) 
s70n3fac3: posts small blind 50
FDIBA2009: posts big blind 100
*** HOLE CARDS ***
s70n3fac3: raises 150 to 250
FDIBA2009: folds 
Uncalled bet (150) returned to s70n3fac3
s70n3fac3 collected 200 from pot
s70n3fac3: doesn't show hand 
*** SUMMARY ***
Total pot 200 | Rake 0 
Seat 1: s70n3fac3 (button) (small blind) collected (200)
Seat 2: FDIBA2009 (big blind) folded before Flop



PokerStars Home Game Hand #227252026645: {Club #4781089}  Hold'em No Limit (50/100) - 2021/06/02 0:34:39 EET [2021/06/01 17:34:39 ET]
Table 'VTPP NLHE 0106' 2-max (Play Money) Seat #2 is the button
Seat 1: s70n3fac3 (15711 in chips) 
Seat 2: FDIBA2009 (14989 in chips) 
FDIBA2009: posts small blind 50
s70n3fac3: posts big blind 100
*** HOLE CARDS ***
FDIBA2009: raises 100 to 200
s70n3fac3: calls 100
*** FLOP *** [7h 9c 5s]
s70n3fac3: checks 
FDIBA2009: checks 
*** TURN *** [7h 9c 5s] [Ah]
s70n3fac3: checks 
FDIBA2009: checks 
*** RIVER *** [7h 9c 5s Ah] [Kc]
s70n3fac3: checks 
FDIBA2009: checks 
*** SHOW DOWN ***
s70n3fac3: shows [Ts 7c] (a pair of Sevens)
FDIBA2009: mucks hand 
s70n3fac3 collected 378 from pot
*** SUMMARY ***
Total pot 400 | Rake 22 
Board [7h 9c 5s Ah Kc]
Seat 1: s70n3fac3 (big blind) showed [Ts 7c] and won (378) with a pair of Sevens
Seat 2: FDIBA2009 (button) (small blind) mucked [Qd 3s]



PokerStars Home Game Hand #227252033566: {Club #4781089}  Hold'em No Limit (50/100) - 2021/06/02 0:34:54 EET [2021/06/01 17:34:54 ET]
Table 'VTPP NLHE 0106' 2-max (Play Money) Seat #1 is the button
Seat 1: s70n3fac3 (15889 in chips) 
Seat 2: FDIBA2009 (14789 in chips) 
s70n3fac3: posts small blind 50
FDIBA2009: posts big blind 100
*** HOLE CARDS ***
s70n3fac3: raises 150 to 250
FDIBA2009: raises 150 to 400
s70n3fac3: raises 1000 to 1400
FDIBA2009: folds 
Uncalled bet (1000) returned to s70n3fac3
s70n3fac3 collected 800 from pot
s70n3fac3: doesn't show hand 
*** SUMMARY ***
Total pot 800 | Rake 0 
Seat 1: s70n3fac3 (button) (small blind) collected (800)
Seat 2: FDIBA2009 (big blind) folded before Flop



PokerStars Home Game Hand #227252038777: {Club #4781089}  Hold'em No Limit (50/100) - 2021/06/02 0:35:05 EET [2021/06/01 17:35:05 ET]
Table 'VTPP NLHE 0106' 2-max (Play Money) Seat #2 is the button
Seat 1: s70n3fac3 (16289 in chips) 
Seat 2: FDIBA2009 (14389 in chips) 
FDIBA2009: posts small blind 50
s70n3fac3: posts big blind 100
*** HOLE CARDS ***
FDIBA2009: raises 200 to 300
s70n3fac3: calls 200
*** FLOP *** [6c 2s Jd]
s70n3fac3: checks 
FDIBA2009: checks 
*** TURN *** [6c 2s Jd] [Ks]
s70n3fac3: checks 
FDIBA2009: bets 300
s70n3fac3: calls 300
*** RIVER *** [6c 2s Jd Ks] [3h]
s70n3fac3: checks 
FDIBA2009: bets 600
s70n3fac3: folds 
Uncalled bet (600) returned to FDIBA2009
FDIBA2009 collected 1134 from pot
FDIBA2009: doesn't show hand 
*** SUMMARY ***
Total pot 1200 | Rake 66 
Board [6c 2s Jd Ks 3h]
Seat 1: s70n3fac3 (big blind) folded on the River
Seat 2: FDIBA2009 (button) (small blind) collected (1134)



PokerStars Home Game Hand #227252050635: {Club #4781089}  Hold'em No Limit (50/100) - 2021/06/02 0:35:30 EET [2021/06/01 17:35:30 ET]
Table 'VTPP NLHE 0106' 2-max (Play Money) Seat #1 is the button
Seat 1: s70n3fac3 (15689 in chips) 
Seat 2: FDIBA2009 (14923 in chips) 
s70n3fac3: posts small blind 50
FDIBA2009: posts big blind 100
*** HOLE CARDS ***
s70n3fac3: raises 150 to 250
FDIBA2009: calls 150
*** FLOP *** [6h Ts As]
FDIBA2009: checks 
s70n3fac3: bets 300
FDIBA2009: folds 
Uncalled bet (300) returned to s70n3fac3
s70n3fac3 collected 472 from pot
s70n3fac3: doesn't show hand 
*** SUMMARY ***
Total pot 500 | Rake 28 
Board [6h Ts As]
Seat 1: s70n3fac3 (button) (small blind) collected (472)
Seat 2: FDIBA2009 (big blind) folded on the Flop



PokerStars Home Game Hand #227252058088: {Club #4781089}  Hold'em No Limit (50/100) - 2021/06/02 0:35:46 EET [2021/06/01 17:35:46 ET]
Table 'VTPP NLHE 0106' 2-max (Play Money) Seat #2 is the button
Seat 1: s70n3fac3 (15911 in chips) 
Seat 2: FDIBA2009 (14673 in chips) 
FDIBA2009: posts small blind 50
s70n3fac3: posts big blind 100
*** HOLE CARDS ***
FDIBA2009: raises 200 to 300
s70n3fac3: calls 200
*** FLOP *** [9c Js 9d]
s70n3fac3: checks 
FDIBA2009: bets 567
s70n3fac3: calls 567
*** TURN *** [9c Js 9d] [Ac]
s70n3fac3: checks 
FDIBA2009: bets 1639
s70n3fac3: folds 
Uncalled bet (1639) returned to FDIBA2009
FDIBA2009 collected 1639 from pot
FDIBA2009: doesn't show hand 
*** SUMMARY ***
Total pot 1734 | Rake 95 
Board [9c Js 9d Ac]
Seat 1: s70n3fac3 (big blind) folded on the Turn
Seat 2: FDIBA2009 (button) (small blind) collected (1639)



PokerStars Home Game Hand #227252069362: {Club #4781089}  Hold'em No Limit (50/100) - 2021/06/02 0:36:09 EET [2021/06/01 17:36:09 ET]
Table 'VTPP NLHE 0106' 2-max (Play Money) Seat #1 is the button
Seat 1: s70n3fac3 (15044 in chips) 
Seat 2: FDIBA2009 (15445 in chips) 
s70n3fac3: posts small blind 50
FDIBA2009: posts big blind 100
*** HOLE CARDS ***
s70n3fac3: raises 150 to 250
FDIBA2009: calls 150
*** FLOP *** [Qd 5c 2s]
FDIBA2009: checks 
s70n3fac3: checks 
*** TURN *** [Qd 5c 2s] [Qc]
FDIBA2009: checks 
s70n3fac3: bets 300
FDIBA2009: calls 300
*** RIVER *** [Qd 5c 2s Qc] [Js]
FDIBA2009: checks 
s70n3fac3: bets 600
FDIBA2009: folds 
Uncalled bet (600) returned to s70n3fac3
s70n3fac3 collected 1039 from pot
s70n3fac3: doesn't show hand 
*** SUMMARY ***
Total pot 1100 | Rake 61 
Board [Qd 5c 2s Qc Js]
Seat 1: s70n3fac3 (button) (small blind) collected (1039)
Seat 2: FDIBA2009 (big blind) folded on the River



PokerStars Home Game Hand #227252078009: {Club #4781089}  Hold'em No Limit (50/100) - 2021/06/02 0:36:27 EET [2021/06/01 17:36:27 ET]
Table 'VTPP NLHE 0106' 2-max (Play Money) Seat #2 is the button
Seat 1: s70n3fac3 (15533 in chips) 
Seat 2: FDIBA2009 (14895 in chips) 
FDIBA2009: posts small blind 50
s70n3fac3: posts big blind 100
*** HOLE CARDS ***
FDIBA2009: raises 200 to 300
s70n3fac3: calls 200
*** FLOP *** [Th 2s 6s]
s70n3fac3: checks 
FDIBA2009: bets 567
s70n3fac3: raises 833 to 1400
FDIBA2009: calls 833
*** TURN *** [Th 2s 6s] [7c]
s70n3fac3: checks 
FDIBA2009: checks 
*** RIVER *** [Th 2s 6s 7c] [Qh]
s70n3fac3: checks 
FDIBA2009: bets 3213
s70n3fac3: calls 3213
*** SHOW DOWN ***
FDIBA2009: shows [Qs 6h] (two pair, Queens and Sixes)
s70n3fac3: mucks hand 
FDIBA2009 collected 9286 from pot
*** SUMMARY ***
Total pot 9826 | Rake 540 
Board [Th 2s 6s 7c Qh]
Seat 1: s70n3fac3 (big blind) mucked [Jd Ts]
Seat 2: FDIBA2009 (button) (small blind) showed [Qs 6h] and won (9286) with two pair, Queens and Sixes



PokerStars Home Game Hand #227252088817: {Club #4781089}  Hold'em No Limit (50/100) - 2021/06/02 0:36:50 EET [2021/06/01 17:36:50 ET]
Table 'VTPP NLHE 0106' 2-max (Play Money) Seat #1 is the button
Seat 1: s70n3fac3 (10620 in chips) 
Seat 2: FDIBA2009 (19268 in chips) 
s70n3fac3: posts small blind 50
FDIBA2009: posts big blind 100
*** HOLE CARDS ***
s70n3fac3: calls 50
FDIBA2009: raises 100 to 200
s70n3fac3: calls 100
*** FLOP *** [8c 7c 3d]
FDIBA2009: bets 378
s70n3fac3: calls 378
*** TURN *** [8c 7c 3d] [Js]
FDIBA2009: bets 1092
s70n3fac3: calls 1092
*** RIVER *** [8c 7c 3d Js] [8h]
FDIBA2009: checks 
s70n3fac3: checks 
*** SHOW DOWN ***
FDIBA2009: shows [Qs Qc] (two pair, Queens and Eights)
s70n3fac3: mucks hand 
FDIBA2009 collected 3156 from pot
*** SUMMARY ***
Total pot 3340 | Rake 184 
Board [8c 7c 3d Js 8h]
Seat 1: s70n3fac3 (button) (small blind) mucked [4c Tc]
Seat 2: FDIBA2009 (big blind) showed [Qs Qc] and won (3156) with two pair, Queens and Eights



PokerStars Home Game Hand #227252104099: {Club #4781089}  Hold'em No Limit (50/100) - 2021/06/02 0:37:23 EET [2021/06/01 17:37:23 ET]
Table 'VTPP NLHE 0106' 2-max (Play Money) Seat #2 is the button
Seat 1: s70n3fac3 (8950 in chips) 
Seat 2: FDIBA2009 (20754 in chips) 
FDIBA2009: posts small blind 50
s70n3fac3: posts big blind 100
*** HOLE CARDS ***
FDIBA2009: raises 100 to 200
s70n3fac3: folds 
Uncalled bet (100) returned to FDIBA2009
FDIBA2009 collected 200 from pot
FDIBA2009: doesn't show hand 
*** SUMMARY ***
Total pot 200 | Rake 0 
Seat 1: s70n3fac3 (big blind) folded before Flop
Seat 2: FDIBA2009 (button) (small blind) collected (200)



PokerStars Home Game Hand #227252108032: {Club #4781089}  Hold'em No Limit (50/100) - 2021/06/02 0:37:31 EET [2021/06/01 17:37:31 ET]
Table 'VTPP NLHE 0106' 2-max (Play Money) Seat #1 is the button
Seat 1: s70n3fac3 (8850 in chips) 
Seat 2: FDIBA2009 (20854 in chips) 
s70n3fac3: posts small blind 50
FDIBA2009: posts big blind 100
*** HOLE CARDS ***
s70n3fac3: calls 50
FDIBA2009: checks 
*** FLOP *** [Ts 7s Kd]
FDIBA2009: checks 
s70n3fac3: checks 
*** TURN *** [Ts 7s Kd] [4c]
FDIBA2009: checks 
s70n3fac3: checks 
*** RIVER *** [Ts 7s Kd 4c] [9h]
FDIBA2009: checks 
s70n3fac3: checks 
*** SHOW DOWN ***
FDIBA2009: shows [5c Qh] (high card King)
s70n3fac3: shows [3c Ad] (high card Ace)
s70n3fac3 collected 189 from pot
*** SUMMARY ***
Total pot 200 | Rake 11 
Board [Ts 7s Kd 4c 9h]
Seat 1: s70n3fac3 (button) (small blind) showed [3c Ad] and won (189) with high card Ace
Seat 2: FDIBA2009 (big blind) showed [5c Qh] and lost with high card King



PokerStars Home Game Hand #227252115756: {Club #4781089}  Hold'em No Limit (50/100) - 2021/06/02 0:37:47 EET [2021/06/01 17:37:47 ET]
Table 'VTPP NLHE 0106' 2-max (Play Money) Seat #2 is the button
Seat 1: s70n3fac3 (8939 in chips) 
Seat 2: FDIBA2009 (20754 in chips) 
FDIBA2009: posts small blind 50
s70n3fac3: posts big blind 100
*** HOLE CARDS ***
FDIBA2009: raises 100 to 200
s70n3fac3: calls 100
*** FLOP *** [6s Ad 4s]
s70n3fac3: checks 
FDIBA2009: checks 
*** TURN *** [6s Ad 4s] [Ks]
s70n3fac3: checks 
FDIBA2009: checks 
*** RIVER *** [6s Ad 4s Ks] [6d]
s70n3fac3: checks 
FDIBA2009: bets 378
s70n3fac3: folds 
Uncalled bet (378) returned to FDIBA2009
FDIBA2009 collected 378 from pot
FDIBA2009: doesn't show hand 
*** SUMMARY ***
Total pot 400 | Rake 22 
Board [6s Ad 4s Ks 6d]
Seat 1: s70n3fac3 (big blind) folded on the River
Seat 2: FDIBA2009 (button) (small blind) collected (378)



PokerStars Home Game Hand #227252122408: {Club #4781089}  Hold'em No Limit (50/100) - 2021/06/02 0:38:01 EET [2021/06/01 17:38:01 ET]
Table 'VTPP NLHE 0106' 2-max (Play Money) Seat #1 is the button
Seat 1: s70n3fac3 (8739 in chips) 
Seat 2: FDIBA2009 (20932 in chips) 
s70n3fac3: posts small blind 50
FDIBA2009: posts big blind 100
*** HOLE CARDS ***
s70n3fac3: calls 50
FDIBA2009: checks 
*** FLOP *** [9h Qh Ah]
FDIBA2009: checks 
s70n3fac3: bets 200
FDIBA2009: raises 589 to 789
s70n3fac3: folds 
Uncalled bet (589) returned to FDIBA2009
FDIBA2009 collected 567 from pot
FDIBA2009: doesn't show hand 
*** SUMMARY ***
Total pot 600 | Rake 33 
Board [9h Qh Ah]
Seat 1: s70n3fac3 (button) (small blind) folded on the Flop
Seat 2: FDIBA2009 (big blind) collected (567)



PokerStars Home Game Hand #227252129033: {Club #4781089}  Hold'em No Limit (50/100) - 2021/06/02 0:38:16 EET [2021/06/01 17:38:16 ET]
Table 'VTPP NLHE 0106' 2-max (Play Money) Seat #2 is the button
Seat 1: s70n3fac3 (8439 in chips) 
Seat 2: FDIBA2009 (21199 in chips) 
FDIBA2009: posts small blind 50
s70n3fac3: posts big blind 100
*** HOLE CARDS ***
FDIBA2009: raises 200 to 300
s70n3fac3: folds 
Uncalled bet (200) returned to FDIBA2009
FDIBA2009 collected 200 from pot
FDIBA2009: doesn't show hand 
*** SUMMARY ***
Total pot 200 | Rake 0 
Seat 1: s70n3fac3 (big blind) folded before Flop
Seat 2: FDIBA2009 (button) (small blind) collected (200)



PokerStars Home Game Hand #227252132048: {Club #4781089}  Hold'em No Limit (50/100) - 2021/06/02 0:38:22 EET [2021/06/01 17:38:22 ET]
Table 'VTPP NLHE 0106' 2-max (Play Money) Seat #1 is the button
Seat 1: s70n3fac3 (8339 in chips) 
Seat 2: FDIBA2009 (21299 in chips) 
s70n3fac3: posts small blind 50
FDIBA2009: posts big blind 100
*** HOLE CARDS ***
s70n3fac3: folds 
Uncalled bet (50) returned to FDIBA2009
FDIBA2009 collected 100 from pot
FDIBA2009: doesn't show hand 
*** SUMMARY ***
Total pot 100 | Rake 0 
Seat 1: s70n3fac3 (button) (small blind) folded before Flop
Seat 2: FDIBA2009 (big blind) collected (100)



PokerStars Home Game Hand #227252133892: {Club #4781089}  Hold'em No Limit (50/100) - 2021/06/02 0:38:26 EET [2021/06/01 17:38:26 ET]
Table 'VTPP NLHE 0106' 2-max (Play Money) Seat #2 is the button
Seat 1: s70n3fac3 (8289 in chips) 
Seat 2: FDIBA2009 (21349 in chips) 
FDIBA2009: posts small blind 50
s70n3fac3: posts big blind 100
*** HOLE CARDS ***
FDIBA2009: raises 200 to 300
s70n3fac3: folds 
Uncalled bet (200) returned to FDIBA2009
FDIBA2009 collected 200 from pot
FDIBA2009: doesn't show hand 
*** SUMMARY ***
Total pot 200 | Rake 0 
Seat 1: s70n3fac3 (big blind) folded before Flop
Seat 2: FDIBA2009 (button) (small blind) collected (200)



PokerStars Home Game Hand #227252136946: {Club #4781089}  Hold'em No Limit (50/100) - 2021/06/02 0:38:32 EET [2021/06/01 17:38:32 ET]
Table 'VTPP NLHE 0106' 2-max (Play Money) Seat #1 is the button
Seat 1: s70n3fac3 (8189 in chips) 
Seat 2: FDIBA2009 (21449 in chips) 
s70n3fac3: posts small blind 50
FDIBA2009: posts big blind 100
*** HOLE CARDS ***
s70n3fac3: raises 150 to 250
FDIBA2009: raises 500 to 750
s70n3fac3: calls 500
*** FLOP *** [9h Jh Qh]
FDIBA2009: checks 
s70n3fac3: checks 
*** TURN *** [9h Jh Qh] [9c]
FDIBA2009: bets 1417
s70n3fac3: folds 
Uncalled bet (1417) returned to FDIBA2009
FDIBA2009 collected 1417 from pot
FDIBA2009: doesn't show hand 
*** SUMMARY ***
Total pot 1500 | Rake 83 
Board [9h Jh Qh 9c]
Seat 1: s70n3fac3 (button) (small blind) folded on the Turn
Seat 2: FDIBA2009 (big blind) collected (1417)



PokerStars Home Game Hand #227252146478: {Club #4781089}  Hold'em No Limit (50/100) - 2021/06/02 0:38:53 EET [2021/06/01 17:38:53 ET]
Table 'VTPP NLHE 0106' 2-max (Play Money) Seat #2 is the button
Seat 1: s70n3fac3 (7439 in chips) 
Seat 2: FDIBA2009 (22116 in chips) 
FDIBA2009: posts small blind 50
s70n3fac3: posts big blind 100
*** HOLE CARDS ***
FDIBA2009: raises 100 to 200
s70n3fac3: raises 400 to 600
FDIBA2009: calls 400
*** FLOP *** [6h 4c 9c]
s70n3fac3: checks 
FDIBA2009: bets 1134
s70n3fac3: folds 
Uncalled bet (1134) returned to FDIBA2009
FDIBA2009 collected 1134 from pot
FDIBA2009: doesn't show hand 
*** SUMMARY ***
Total pot 1200 | Rake 66 
Board [6h 4c 9c]
Seat 1: s70n3fac3 (big blind) folded on the Flop
Seat 2: FDIBA2009 (button) (small blind) collected (1134)



PokerStars Home Game Hand #227252162678: {Club #4781089}  Hold'em No Limit (50/100) - 2021/06/02 0:39:13 EET [2021/06/01 17:39:13 ET]
Table 'VTPP NLHE 0106' 2-max (Play Money) Seat #1 is the button
Seat 1: s70n3fac3 (6839 in chips) 
Seat 2: FDIBA2009 (22650 in chips) 
s70n3fac3: posts small blind 50
FDIBA2009: posts big blind 100
*** HOLE CARDS ***
s70n3fac3: raises 150 to 250
FDIBA2009: calls 150
*** FLOP *** [6c Tc 9c]
FDIBA2009: checks 
s70n3fac3: bets 300
FDIBA2009: raises 1072 to 1372
s70n3fac3: calls 1072
*** TURN *** [6c Tc 9c] [5s]
FDIBA2009: bets 21028 and is all-in
s70n3fac3: folds 
Uncalled bet (21028) returned to FDIBA2009
FDIBA2009 collected 3066 from pot
FDIBA2009: doesn't show hand 
*** SUMMARY ***
Total pot 3244 | Rake 178 
Board [6c Tc 9c 5s]
Seat 1: s70n3fac3 (button) (small blind) folded on the Turn
Seat 2: FDIBA2009 (big blind) collected (3066)



PokerStars Home Game Hand #227252174608: {Club #4781089}  Hold'em No Limit (50/100) - 2021/06/02 0:39:38 EET [2021/06/01 17:39:38 ET]
Table 'VTPP NLHE 0106' 2-max (Play Money) Seat #2 is the button
Seat 1: s70n3fac3 (5217 in chips) 
Seat 2: FDIBA2009 (24094 in chips) 
FDIBA2009: posts small blind 50
s70n3fac3: posts big blind 100
*** HOLE CARDS ***
FDIBA2009: raises 100 to 200
s70n3fac3: calls 100
*** FLOP *** [Qc 4h 4s]
s70n3fac3: checks 
FDIBA2009: bets 378
s70n3fac3: calls 378
*** TURN *** [Qc 4h 4s] [8d]
s70n3fac3: checks 
FDIBA2009: checks 
*** RIVER *** [Qc 4h 4s 8d] [Ad]
s70n3fac3: bets 500
FDIBA2009: calls 500
*** SHOW DOWN ***
s70n3fac3: shows [2c As] (two pair, Aces and Fours)
FDIBA2009: mucks hand 
s70n3fac3 collected 2037 from pot
*** SUMMARY ***
Total pot 2156 | Rake 119 
Board [Qc 4h 4s 8d Ad]
Seat 1: s70n3fac3 (big blind) showed [2c As] and won (2037) with two pair, Aces and Fours
Seat 2: FDIBA2009 (button) (small blind) mucked [Ts Qd]



PokerStars Home Game Hand #227252184018: {Club #4781089}  Hold'em No Limit (50/100) - 2021/06/02 0:39:57 EET [2021/06/01 17:39:57 ET]
Table 'VTPP NLHE 0106' 2-max (Play Money) Seat #1 is the button
Seat 1: s70n3fac3 (6176 in chips) 
Seat 2: FDIBA2009 (23016 in chips) 
s70n3fac3: posts small blind 50
FDIBA2009: posts big blind 100
*** HOLE CARDS ***
s70n3fac3: folds 
Uncalled bet (50) returned to FDIBA2009
FDIBA2009 collected 100 from pot
FDIBA2009: doesn't show hand 
*** SUMMARY ***
Total pot 100 | Rake 0 
Seat 1: s70n3fac3 (button) (small blind) folded before Flop
Seat 2: FDIBA2009 (big blind) collected (100)



PokerStars Home Game Hand #227252185725: {Club #4781089}  Hold'em No Limit (50/100) - 2021/06/02 0:40:01 EET [2021/06/01 17:40:01 ET]
Table 'VTPP NLHE 0106' 2-max (Play Money) Seat #2 is the button
Seat 1: s70n3fac3 (6126 in chips) 
Seat 2: FDIBA2009 (23066 in chips) 
FDIBA2009: posts small blind 50
s70n3fac3: posts big blind 100
*** HOLE CARDS ***
FDIBA2009: raises 200 to 300
s70n3fac3: calls 200
*** FLOP *** [8s 3c 9d]
s70n3fac3: checks 
FDIBA2009: checks 
*** TURN *** [8s 3c 9d] [Qs]
s70n3fac3: checks 
FDIBA2009: bets 567
s70n3fac3: folds 
Uncalled bet (567) returned to FDIBA2009
FDIBA2009 collected 567 from pot
FDIBA2009: doesn't show hand 
*** SUMMARY ***
Total pot 600 | Rake 33 
Board [8s 3c 9d Qs]
Seat 1: s70n3fac3 (big blind) folded on the Turn
Seat 2: FDIBA2009 (button) (small blind) collected (567)



PokerStars Home Game Hand #227252192259: {Club #4781089}  Hold'em No Limit (50/100) - 2021/06/02 0:40:15 EET [2021/06/01 17:40:15 ET]
Table 'VTPP NLHE 0106' 2-max (Play Money) Seat #1 is the button
Seat 1: s70n3fac3 (5826 in chips) 
Seat 2: FDIBA2009 (23333 in chips) 
s70n3fac3: posts small blind 50
FDIBA2009: posts big blind 100
*** HOLE CARDS ***
s70n3fac3: calls 50
FDIBA2009: checks 
*** FLOP *** [Qh 4h 9h]
FDIBA2009: checks 
s70n3fac3: bets 200
FDIBA2009: folds 
Uncalled bet (200) returned to s70n3fac3
s70n3fac3 collected 189 from pot
s70n3fac3: doesn't show hand 
*** SUMMARY ***
Total pot 200 | Rake 11 
Board [Qh 4h 9h]
Seat 1: s70n3fac3 (button) (small blind) collected (189)
Seat 2: FDIBA2009 (big blind) folded on the Flop



PokerStars Home Game Hand #227252196649: {Club #4781089}  Hold'em No Limit (50/100) - 2021/06/02 0:40:24 EET [2021/06/01 17:40:24 ET]
Table 'VTPP NLHE 0106' 2-max (Play Money) Seat #2 is the button
Seat 1: s70n3fac3 (5915 in chips) 
Seat 2: FDIBA2009 (23233 in chips) 
FDIBA2009: posts small blind 50
s70n3fac3: posts big blind 100
*** HOLE CARDS ***
FDIBA2009: raises 200 to 300
s70n3fac3: folds 
Uncalled bet (200) returned to FDIBA2009
FDIBA2009 collected 200 from pot
FDIBA2009: doesn't show hand 
*** SUMMARY ***
Total pot 200 | Rake 0 
Seat 1: s70n3fac3 (big blind) folded before Flop
Seat 2: FDIBA2009 (button) (small blind) collected (200)



PokerStars Home Game Hand #227252199700: {Club #4781089}  Hold'em No Limit (50/100) - 2021/06/02 0:40:31 EET [2021/06/01 17:40:31 ET]
Table 'VTPP NLHE 0106' 2-max (Play Money) Seat #1 is the button
Seat 1: s70n3fac3 (5815 in chips) 
Seat 2: FDIBA2009 (23333 in chips) 
s70n3fac3: posts small blind 50
FDIBA2009: posts big blind 100
*** HOLE CARDS ***
s70n3fac3: raises 150 to 250
FDIBA2009: raises 500 to 750
s70n3fac3: calls 500
*** FLOP *** [9h 2h 7h]
FDIBA2009: bets 1417
s70n3fac3: folds 
Uncalled bet (1417) returned to FDIBA2009
FDIBA2009 collected 1417 from pot
FDIBA2009: doesn't show hand 
*** SUMMARY ***
Total pot 1500 | Rake 83 
Board [9h 2h 7h]
Seat 1: s70n3fac3 (button) (small blind) folded on the Flop
Seat 2: FDIBA2009 (big blind) collected (1417)



PokerStars Home Game Hand #227252206542: {Club #4781089}  Hold'em No Limit (50/100) - 2021/06/02 0:40:46 EET [2021/06/01 17:40:46 ET]
Table 'VTPP NLHE 0106' 2-max (Play Money) Seat #2 is the button
Seat 1: s70n3fac3 (5065 in chips) 
Seat 2: FDIBA2009 (24000 in chips) 
FDIBA2009: posts small blind 50
s70n3fac3: posts big blind 100
*** HOLE CARDS ***
FDIBA2009: raises 200 to 300
s70n3fac3: calls 200
*** FLOP *** [Kc 8d 7d]
s70n3fac3: checks 
FDIBA2009: checks 
*** TURN *** [Kc 8d 7d] [3h]
s70n3fac3: checks 
FDIBA2009: bets 567
s70n3fac3: calls 567
*** RIVER *** [Kc 8d 7d 3h] [Kd]
s70n3fac3: checks 
FDIBA2009: bets 819
s70n3fac3: raises 3379 to 4198 and is all-in
FDIBA2009: calls 3379
*** SHOW DOWN ***
s70n3fac3: shows [Jd 4d] (a flush, King high)
FDIBA2009: shows [Qs Qc] (two pair, Kings and Queens)
s70n3fac3 collected 9573 from pot
*** SUMMARY ***
Total pot 10130 | Rake 557 
Board [Kc 8d 7d 3h Kd]
Seat 1: s70n3fac3 (big blind) showed [Jd 4d] and won (9573) with a flush, King high
Seat 2: FDIBA2009 (button) (small blind) showed [Qs Qc] and lost with two pair, Kings and Queens



PokerStars Home Game Hand #227252223570: {Club #4781089}  Hold'em No Limit (50/100) - 2021/06/02 0:41:22 EET [2021/06/01 17:41:22 ET]
Table 'VTPP NLHE 0106' 2-max (Play Money) Seat #1 is the button
Seat 1: s70n3fac3 (9573 in chips) 
Seat 2: FDIBA2009 (18935 in chips) 
s70n3fac3: posts small blind 50
FDIBA2009: posts big blind 100
*** HOLE CARDS ***
s70n3fac3: raises 150 to 250
FDIBA2009: folds 
Uncalled bet (150) returned to s70n3fac3
s70n3fac3 collected 200 from pot
s70n3fac3: doesn't show hand 
*** SUMMARY ***
Total pot 200 | Rake 0 
Seat 1: s70n3fac3 (button) (small blind) collected (200)
Seat 2: FDIBA2009 (big blind) folded before Flop



PokerStars Home Game Hand #227252229346: {Club #4781089}  Hold'em No Limit (50/100) - 2021/06/02 0:41:35 EET [2021/06/01 17:41:35 ET]
Table 'VTPP NLHE 0106' 2-max (Play Money) Seat #2 is the button
Seat 1: s70n3fac3 (9673 in chips) 
Seat 2: FDIBA2009 (18835 in chips) 
FDIBA2009: posts small blind 50
s70n3fac3: posts big blind 100
*** HOLE CARDS ***
FDIBA2009: raises 100 to 200
s70n3fac3: calls 100
*** FLOP *** [As Th 7h]
s70n3fac3: checks 
FDIBA2009: checks 
*** TURN *** [As Th 7h] [Kc]
s70n3fac3: checks 
FDIBA2009: checks 
*** RIVER *** [As Th 7h Kc] [Ah]
s70n3fac3: bets 300
FDIBA2009: calls 300
*** SHOW DOWN ***
s70n3fac3: shows [Kh 8d] (two pair, Aces and Kings)
FDIBA2009: mucks hand 
s70n3fac3 collected 945 from pot
*** SUMMARY ***
Total pot 1000 | Rake 55 
Board [As Th 7h Kc Ah]
Seat 1: s70n3fac3 (big blind) showed [Kh 8d] and won (945) with two pair, Aces and Kings
Seat 2: FDIBA2009 (button) (small blind) mucked [8s 7c]



PokerStars Home Game Hand #227252235843: {Club #4781089}  Hold'em No Limit (50/100) - 2021/06/02 0:41:49 EET [2021/06/01 17:41:49 ET]
Table 'VTPP NLHE 0106' 2-max (Play Money) Seat #1 is the button
Seat 1: s70n3fac3 (10118 in chips) 
Seat 2: FDIBA2009 (18335 in chips) 
s70n3fac3: posts small blind 50
FDIBA2009: posts big blind 100
*** HOLE CARDS ***
s70n3fac3: folds 
Uncalled bet (50) returned to FDIBA2009
FDIBA2009 collected 100 from pot
FDIBA2009: doesn't show hand 
*** SUMMARY ***
Total pot 100 | Rake 0 
Seat 1: s70n3fac3 (button) (small blind) folded before Flop
Seat 2: FDIBA2009 (big blind) collected (100)



PokerStars Home Game Hand #227252237701: {Club #4781089}  Hold'em No Limit (50/100) - 2021/06/02 0:41:53 EET [2021/06/01 17:41:53 ET]
Table 'VTPP NLHE 0106' 2-max (Play Money) Seat #2 is the button
Seat 1: s70n3fac3 (10068 in chips) 
Seat 2: FDIBA2009 (18385 in chips) 
FDIBA2009: posts small blind 50
s70n3fac3: posts big blind 100
*** HOLE CARDS ***
FDIBA2009: raises 100 to 200
s70n3fac3: folds 
Uncalled bet (100) returned to FDIBA2009
FDIBA2009 collected 200 from pot
FDIBA2009: doesn't show hand 
*** SUMMARY ***
Total pot 200 | Rake 0 
Seat 1: s70n3fac3 (big blind) folded before Flop
Seat 2: FDIBA2009 (button) (small blind) collected (200)



PokerStars Home Game Hand #227252240707: {Club #4781089}  Hold'em No Limit (50/100) - 2021/06/02 0:41:59 EET [2021/06/01 17:41:59 ET]
Table 'VTPP NLHE 0106' 2-max (Play Money) Seat #1 is the button
Seat 1: s70n3fac3 (9968 in chips) 
Seat 2: FDIBA2009 (18485 in chips) 
s70n3fac3: posts small blind 50
FDIBA2009: posts big blind 100
*** HOLE CARDS ***
s70n3fac3: raises 150 to 250
FDIBA2009: calls 150
*** FLOP *** [Ts Qd 9h]
FDIBA2009: checks 
s70n3fac3: bets 300
FDIBA2009: folds 
Uncalled bet (300) returned to s70n3fac3
s70n3fac3 collected 472 from pot
s70n3fac3: doesn't show hand 
*** SUMMARY ***
Total pot 500 | Rake 28 
Board [Ts Qd 9h]
Seat 1: s70n3fac3 (button) (small blind) collected (472)
Seat 2: FDIBA2009 (big blind) folded on the Flop



PokerStars Home Game Hand #227252246871: {Club #4781089}  Hold'em No Limit (50/100) - 2021/06/02 0:42:13 EET [2021/06/01 17:42:13 ET]
Table 'VTPP NLHE 0106' 2-max (Play Money) Seat #2 is the button
Seat 1: s70n3fac3 (10190 in chips) 
Seat 2: FDIBA2009 (18235 in chips) 
FDIBA2009: posts small blind 50
s70n3fac3: posts big blind 100
*** HOLE CARDS ***
FDIBA2009: raises 100 to 200
s70n3fac3: folds 
Uncalled bet (100) returned to FDIBA2009
FDIBA2009 collected 200 from pot
FDIBA2009: doesn't show hand 
*** SUMMARY ***
Total pot 200 | Rake 0 
Seat 1: s70n3fac3 (big blind) folded before Flop
Seat 2: FDIBA2009 (button) (small blind) collected (200)



PokerStars Home Game Hand #227252249609: {Club #4781089}  Hold'em No Limit (50/100) - 2021/06/02 0:42:19 EET [2021/06/01 17:42:19 ET]
Table 'VTPP NLHE 0106' 2-max (Play Money) Seat #1 is the button
Seat 1: s70n3fac3 (10090 in chips) 
Seat 2: FDIBA2009 (18335 in chips) 
s70n3fac3: posts small blind 50
FDIBA2009: posts big blind 100
*** HOLE CARDS ***
s70n3fac3: calls 50
FDIBA2009: checks 
*** FLOP *** [Ah Qs 6d]
FDIBA2009: checks 
s70n3fac3: checks 
*** TURN *** [Ah Qs 6d] [Kc]
FDIBA2009: bets 189
s70n3fac3: raises 311 to 500
FDIBA2009: calls 311
*** RIVER *** [Ah Qs 6d Kc] [Th]
FDIBA2009: checks 
s70n3fac3: checks 
*** SHOW DOWN ***
FDIBA2009: shows [3c Kd] (a pair of Kings)
s70n3fac3: shows [Qh 6c] (two pair, Queens and Sixes)
s70n3fac3 collected 1134 from pot
*** SUMMARY ***
Total pot 1200 | Rake 66 
Board [Ah Qs 6d Kc Th]
Seat 1: s70n3fac3 (button) (small blind) showed [Qh 6c] and won (1134) with two pair, Queens and Sixes
Seat 2: FDIBA2009 (big blind) showed [3c Kd] and lost with a pair of Kings



PokerStars Home Game Hand #227252264855: {Club #4781089}  Hold'em No Limit (50/100) - 2021/06/02 0:42:37 EET [2021/06/01 17:42:37 ET]
Table 'VTPP NLHE 0106' 2-max (Play Money) Seat #2 is the button
Seat 1: s70n3fac3 (10624 in chips) 
Seat 2: FDIBA2009 (17735 in chips) 
FDIBA2009: posts small blind 50
s70n3fac3: posts big blind 100
*** HOLE CARDS ***
FDIBA2009: raises 200 to 300
s70n3fac3: calls 200
*** FLOP *** [Qc Qs As]
s70n3fac3: checks 
FDIBA2009: bets 567
s70n3fac3: folds 
Uncalled bet (567) returned to FDIBA2009
FDIBA2009 collected 567 from pot
FDIBA2009: doesn't show hand 
*** SUMMARY ***
Total pot 600 | Rake 33 
Board [Qc Qs As]
Seat 1: s70n3fac3 (big blind) folded on the Flop
Seat 2: FDIBA2009 (button) (small blind) collected (567)



PokerStars Home Game Hand #227252270009: {Club #4781089}  Hold'em No Limit (50/100) - 2021/06/02 0:42:48 EET [2021/06/01 17:42:48 ET]
Table 'VTPP NLHE 0106' 2-max (Play Money) Seat #1 is the button
Seat 1: s70n3fac3 (10324 in chips) 
Seat 2: FDIBA2009 (18002 in chips) 
s70n3fac3: posts small blind 50
FDIBA2009: posts big blind 100
*** HOLE CARDS ***
s70n3fac3: folds 
Uncalled bet (50) returned to FDIBA2009
FDIBA2009 collected 100 from pot
FDIBA2009: doesn't show hand 
*** SUMMARY ***
Total pot 100 | Rake 0 
Seat 1: s70n3fac3 (button) (small blind) folded before Flop
Seat 2: FDIBA2009 (big blind) collected (100)



PokerStars Home Game Hand #227252271888: {Club #4781089}  Hold'em No Limit (50/100) - 2021/06/02 0:42:52 EET [2021/06/01 17:42:52 ET]
Table 'VTPP NLHE 0106' 2-max (Play Money) Seat #2 is the button
Seat 1: s70n3fac3 (10274 in chips) 
Seat 2: FDIBA2009 (18052 in chips) 
FDIBA2009: posts small blind 50
s70n3fac3: posts big blind 100
*** HOLE CARDS ***
FDIBA2009: raises 200 to 300
s70n3fac3: calls 200
*** FLOP *** [5h 5s Jh]
s70n3fac3: checks 
FDIBA2009: bets 567
s70n3fac3: raises 733 to 1300
FDIBA2009: calls 733
*** TURN *** [5h 5s Jh] [Ts]
s70n3fac3: bets 1512
FDIBA2009: calls 1512
*** RIVER *** [5h 5s Jh Ts] [Qd]
s70n3fac3: bets 2941
FDIBA2009: calls 2941
*** SHOW DOWN ***
s70n3fac3: shows [5d 7h] (three of a kind, Fives)
FDIBA2009: mucks hand 
s70n3fac3 collected 11440 from pot
*** SUMMARY ***
Total pot 12106 | Rake 666 
Board [5h 5s Jh Ts Qd]
Seat 1: s70n3fac3 (big blind) showed [5d 7h] and won (11440) with three of a kind, Fives
Seat 2: FDIBA2009 (button) (small blind) mucked [Qh Kd]



PokerStars Home Game Hand #227252283384: {Club #4781089}  Hold'em No Limit (50/100) - 2021/06/02 0:43:16 EET [2021/06/01 17:43:16 ET]
Table 'VTPP NLHE 0106' 2-max (Play Money) Seat #1 is the button
Seat 1: s70n3fac3 (15661 in chips) 
Seat 2: FDIBA2009 (11999 in chips) 
s70n3fac3: posts small blind 50
FDIBA2009: posts big blind 100
*** HOLE CARDS ***
s70n3fac3: raises 150 to 250
FDIBA2009: calls 150
*** FLOP *** [6h 6c 6s]
FDIBA2009: checks 
s70n3fac3: checks 
*** TURN *** [6h 6c 6s] [3s]
FDIBA2009: checks 
s70n3fac3: checks 
*** RIVER *** [6h 6c 6s 3s] [Kh]
FDIBA2009: bets 472
s70n3fac3: folds 
Uncalled bet (472) returned to FDIBA2009
FDIBA2009 collected 472 from pot
FDIBA2009: doesn't show hand 
*** SUMMARY ***
Total pot 500 | Rake 28 
Board [6h 6c 6s 3s Kh]
Seat 1: s70n3fac3 (button) (small blind) folded on the River
Seat 2: FDIBA2009 (big blind) collected (472)



PokerStars Home Game Hand #227252292247: {Club #4781089}  Hold'em No Limit (50/100) - 2021/06/02 0:43:35 EET [2021/06/01 17:43:35 ET]
Table 'VTPP NLHE 0106' 2-max (Play Money) Seat #2 is the button
Seat 1: s70n3fac3 (15411 in chips) 
Seat 2: FDIBA2009 (12221 in chips) 
FDIBA2009: posts small blind 50
s70n3fac3: posts big blind 100
*** HOLE CARDS ***
FDIBA2009: folds 
Uncalled bet (50) returned to s70n3fac3
s70n3fac3 collected 100 from pot
s70n3fac3: doesn't show hand 
*** SUMMARY ***
Total pot 100 | Rake 0 
Seat 1: s70n3fac3 (big blind) collected (100)
Seat 2: FDIBA2009 (button) (small blind) folded before Flop



PokerStars Home Game Hand #227252294538: {Club #4781089}  Hold'em No Limit (50/100) - 2021/06/02 0:43:40 EET [2021/06/01 17:43:40 ET]
Table 'VTPP NLHE 0106' 2-max (Play Money) Seat #1 is the button
Seat 1: s70n3fac3 (15461 in chips) 
Seat 2: FDIBA2009 (12171 in chips) 
s70n3fac3: posts small blind 50
FDIBA2009: posts big blind 100
*** HOLE CARDS ***
s70n3fac3: folds 
Uncalled bet (50) returned to FDIBA2009
FDIBA2009 collected 100 from pot
FDIBA2009: doesn't show hand 
*** SUMMARY ***
Total pot 100 | Rake 0 
Seat 1: s70n3fac3 (button) (small blind) folded before Flop
Seat 2: FDIBA2009 (big blind) collected (100)



PokerStars Home Game Hand #227252296204: {Club #4781089}  Hold'em No Limit (50/100) - 2021/06/02 0:43:44 EET [2021/06/01 17:43:44 ET]
Table 'VTPP NLHE 0106' 2-max (Play Money) Seat #2 is the button
Seat 1: s70n3fac3 (15411 in chips) 
Seat 2: FDIBA2009 (12221 in chips) 
FDIBA2009: posts small blind 50
s70n3fac3: posts big blind 100
*** HOLE CARDS ***
FDIBA2009: raises 100 to 200
s70n3fac3: calls 100
*** FLOP *** [9h 4s 3c]
s70n3fac3: checks 
FDIBA2009: bets 378
s70n3fac3: folds 
Uncalled bet (378) returned to FDIBA2009
FDIBA2009 collected 378 from pot
FDIBA2009: doesn't show hand 
*** SUMMARY ***
Total pot 400 | Rake 22 
Board [9h 4s 3c]
Seat 1: s70n3fac3 (big blind) folded on the Flop
Seat 2: FDIBA2009 (button) (small blind) collected (378)



PokerStars Home Game Hand #227252301352: {Club #4781089}  Hold'em No Limit (50/100) - 2021/06/02 0:43:55 EET [2021/06/01 17:43:55 ET]
Table 'VTPP NLHE 0106' 2-max (Play Money) Seat #1 is the button
Seat 1: s70n3fac3 (15211 in chips) 
Seat 2: FDIBA2009 (12399 in chips) 
s70n3fac3: posts small blind 50
FDIBA2009: posts big blind 100
*** HOLE CARDS ***
s70n3fac3: raises 150 to 250
FDIBA2009: raises 500 to 750
s70n3fac3: calls 500
*** FLOP *** [2d As 2s]
FDIBA2009: checks 
s70n3fac3: bets 500
FDIBA2009: calls 500
*** TURN *** [2d As 2s] [Jc]
FDIBA2009: checks 
s70n3fac3: bets 900
FDIBA2009: calls 900
*** RIVER *** [2d As 2s Jc] [Qs]
FDIBA2009: checks 
s70n3fac3: checks 
*** SHOW DOWN ***
FDIBA2009: shows [8c Ac] (two pair, Aces and Deuces)
s70n3fac3: shows [6d Ah] (two pair, Aces and Deuces)
FDIBA2009 collected 2032 from pot
s70n3fac3 collected 2031 from pot
*** SUMMARY ***
Total pot 4300 | Rake 237 
Board [2d As 2s Jc Qs]
Seat 1: s70n3fac3 (button) (small blind) showed [6d Ah] and won (2031) with two pair, Aces and Deuces
Seat 2: FDIBA2009 (big blind) showed [8c Ac] and won (2032) with two pair, Aces and Deuces



PokerStars Home Game Hand #227252314407: {Club #4781089}  Hold'em No Limit (50/100) - 2021/06/02 0:44:23 EET [2021/06/01 17:44:23 ET]
Table 'VTPP NLHE 0106' 2-max (Play Money) Seat #2 is the button
Seat 1: s70n3fac3 (15092 in chips) 
Seat 2: FDIBA2009 (12281 in chips) 
FDIBA2009: posts small blind 50
s70n3fac3: posts big blind 100
*** HOLE CARDS ***
FDIBA2009: raises 200 to 300
s70n3fac3: calls 200
*** FLOP *** [4s Ks Th]
s70n3fac3: checks 
FDIBA2009: checks 
*** TURN *** [4s Ks Th] [7d]
s70n3fac3: checks 
FDIBA2009: bets 567
s70n3fac3: calls 567
*** RIVER *** [4s Ks Th 7d] [8s]
s70n3fac3: checks 
FDIBA2009: checks 
*** SHOW DOWN ***
s70n3fac3: shows [5s Js] (a flush, King high)
FDIBA2009: mucks hand 
s70n3fac3 collected 1639 from pot
*** SUMMARY ***
Total pot 1734 | Rake 95 
Board [4s Ks Th 7d 8s]
Seat 1: s70n3fac3 (big blind) showed [5s Js] and won (1639) with a flush, King high
Seat 2: FDIBA2009 (button) (small blind) mucked [3h 5d]



PokerStars Home Game Hand #227252322458: {Club #4781089}  Hold'em No Limit (50/100) - 2021/06/02 0:44:41 EET [2021/06/01 17:44:41 ET]
Table 'VTPP NLHE 0106' 2-max (Play Money) Seat #1 is the button
Seat 1: s70n3fac3 (15864 in chips) 
Seat 2: FDIBA2009 (11414 in chips) 
s70n3fac3: posts small blind 50
FDIBA2009: posts big blind 100
*** HOLE CARDS ***
s70n3fac3: folds 
Uncalled bet (50) returned to FDIBA2009
FDIBA2009 collected 100 from pot
FDIBA2009: doesn't show hand 
*** SUMMARY ***
Total pot 100 | Rake 0 
Seat 1: s70n3fac3 (button) (small blind) folded before Flop
Seat 2: FDIBA2009 (big blind) collected (100)



PokerStars Home Game Hand #227252324167: {Club #4781089}  Hold'em No Limit (50/100) - 2021/06/02 0:44:44 EET [2021/06/01 17:44:44 ET]
Table 'VTPP NLHE 0106' 2-max (Play Money) Seat #2 is the button
Seat 1: s70n3fac3 (15814 in chips) 
Seat 2: FDIBA2009 (11464 in chips) 
FDIBA2009: posts small blind 50
s70n3fac3: posts big blind 100
*** HOLE CARDS ***
FDIBA2009: raises 200 to 300
s70n3fac3: folds 
Uncalled bet (200) returned to FDIBA2009
FDIBA2009 collected 200 from pot
FDIBA2009: doesn't show hand 
*** SUMMARY ***
Total pot 200 | Rake 0 
Seat 1: s70n3fac3 (big blind) folded before Flop
Seat 2: FDIBA2009 (button) (small blind) collected (200)



PokerStars Home Game Hand #227252327366: {Club #4781089}  Hold'em No Limit (50/100) - 2021/06/02 0:44:51 EET [2021/06/01 17:44:51 ET]
Table 'VTPP NLHE 0106' 2-max (Play Money) Seat #1 is the button
Seat 1: s70n3fac3 (15714 in chips) 
Seat 2: FDIBA2009 (11564 in chips) 
s70n3fac3: posts small blind 50
FDIBA2009: posts big blind 100
*** HOLE CARDS ***
s70n3fac3: raises 150 to 250
FDIBA2009: calls 150
*** FLOP *** [8s 4s Kd]
FDIBA2009: checks 
s70n3fac3: bets 300
FDIBA2009: calls 300
*** TURN *** [8s 4s Kd] [Th]
FDIBA2009: checks 
s70n3fac3: checks 
*** RIVER *** [8s 4s Kd Th] [6d]
FDIBA2009: bets 1039
s70n3fac3: calls 1039
*** SHOW DOWN ***
FDIBA2009: shows [5d 3d] (high card King)
s70n3fac3: shows [7h Ts] (a pair of Tens)
s70n3fac3 collected 3003 from pot
*** SUMMARY ***
Total pot 3178 | Rake 175 
Board [8s 4s Kd Th 6d]
Seat 1: s70n3fac3 (button) (small blind) showed [7h Ts] and won (3003) with a pair of Tens
Seat 2: FDIBA2009 (big blind) showed [5d 3d] and lost with high card King



PokerStars Home Game Hand #227252336438: {Club #4781089}  Hold'em No Limit (50/100) - 2021/06/02 0:45:11 EET [2021/06/01 17:45:11 ET]
Table 'VTPP NLHE 0106' 2-max (Play Money) Seat #2 is the button
Seat 1: s70n3fac3 (17128 in chips) 
Seat 2: FDIBA2009 (9975 in chips) 
FDIBA2009: posts small blind 50
s70n3fac3: posts big blind 100
*** HOLE CARDS ***
FDIBA2009: calls 50
s70n3fac3: checks 
*** FLOP *** [5c 9d Qd]
s70n3fac3: checks 
FDIBA2009: checks 
*** TURN *** [5c 9d Qd] [Ks]
s70n3fac3: checks 
FDIBA2009: bets 189
s70n3fac3: folds 
Uncalled bet (189) returned to FDIBA2009
FDIBA2009 collected 189 from pot
FDIBA2009: doesn't show hand 
*** SUMMARY ***
Total pot 200 | Rake 11 
Board [5c 9d Qd Ks]
Seat 1: s70n3fac3 (big blind) folded on the Turn
Seat 2: FDIBA2009 (button) (small blind) collected (189)



PokerStars Home Game Hand #227252342652: {Club #4781089}  Hold'em No Limit (50/100) - 2021/06/02 0:45:24 EET [2021/06/01 17:45:24 ET]
Table 'VTPP NLHE 0106' 2-max (Play Money) Seat #1 is the button
Seat 1: s70n3fac3 (17028 in chips) 
Seat 2: FDIBA2009 (10064 in chips) 
s70n3fac3: posts small blind 50
FDIBA2009: posts big blind 100
*** HOLE CARDS ***
s70n3fac3: calls 50
FDIBA2009: raises 200 to 300
s70n3fac3: calls 200
*** FLOP *** [7s Jh 4h]
FDIBA2009: bets 567
s70n3fac3: calls 567
*** TURN *** [7s Jh 4h] [9c]
FDIBA2009: checks 
s70n3fac3: bets 800
FDIBA2009: folds 
Uncalled bet (800) returned to s70n3fac3
s70n3fac3 collected 1639 from pot
s70n3fac3: doesn't show hand 
*** SUMMARY ***
Total pot 1734 | Rake 95 
Board [7s Jh 4h 9c]
Seat 1: s70n3fac3 (button) (small blind) collected (1639)
Seat 2: FDIBA2009 (big blind) folded on the Turn



PokerStars Home Game Hand #227252351581: {Club #4781089}  Hold'em No Limit (50/100) - 2021/06/02 0:45:44 EET [2021/06/01 17:45:44 ET]
Table 'VTPP NLHE 0106' 2-max (Play Money) Seat #2 is the button
Seat 1: s70n3fac3 (17800 in chips) 
Seat 2: FDIBA2009 (9197 in chips) 
FDIBA2009: posts small blind 50
s70n3fac3: posts big blind 100
*** HOLE CARDS ***
FDIBA2009: raises 200 to 300
s70n3fac3: calls 200
*** FLOP *** [2h Jh 6s]
s70n3fac3: checks 
FDIBA2009: bets 567
s70n3fac3: calls 567
*** TURN *** [2h Jh 6s] [Kc]
s70n3fac3: checks 
FDIBA2009: bets 1639
s70n3fac3: folds 
Uncalled bet (1639) returned to FDIBA2009
FDIBA2009 collected 1639 from pot
FDIBA2009: doesn't show hand 
*** SUMMARY ***
Total pot 1734 | Rake 95 
Board [2h Jh 6s Kc]
Seat 1: s70n3fac3 (big blind) folded on the Turn
Seat 2: FDIBA2009 (button) (small blind) collected (1639)



PokerStars Home Game Hand #227252360008: {Club #4781089}  Hold'em No Limit (50/100) - 2021/06/02 0:46:02 EET [2021/06/01 17:46:02 ET]
Table 'VTPP NLHE 0106' 2-max (Play Money) Seat #1 is the button
Seat 1: s70n3fac3 (16933 in chips) 
Seat 2: FDIBA2009 (9969 in chips) 
s70n3fac3: posts small blind 50
FDIBA2009: posts big blind 100
*** HOLE CARDS ***
s70n3fac3: raises 150 to 250
FDIBA2009: raises 500 to 750
s70n3fac3: calls 500
*** FLOP *** [Js 6c 4d]
FDIBA2009: bets 1417
s70n3fac3: folds 
Uncalled bet (1417) returned to FDIBA2009
FDIBA2009 collected 1417 from pot
FDIBA2009: doesn't show hand 
*** SUMMARY ***
Total pot 1500 | Rake 83 
Board [Js 6c 4d]
Seat 1: s70n3fac3 (button) (small blind) folded on the Flop
Seat 2: FDIBA2009 (big blind) collected (1417)



PokerStars Home Game Hand #227252368285: {Club #4781089}  Hold'em No Limit (50/100) - 2021/06/02 0:46:20 EET [2021/06/01 17:46:20 ET]
Table 'VTPP NLHE 0106' 2-max (Play Money) Seat #2 is the button
Seat 1: s70n3fac3 (16183 in chips) 
Seat 2: FDIBA2009 (10636 in chips) 
FDIBA2009: posts small blind 50
s70n3fac3: posts big blind 100
*** HOLE CARDS ***
FDIBA2009: raises 200 to 300
s70n3fac3: folds 
Uncalled bet (200) returned to FDIBA2009
FDIBA2009 collected 200 from pot
FDIBA2009: doesn't show hand 
*** SUMMARY ***
Total pot 200 | Rake 0 
Seat 1: s70n3fac3 (big blind) folded before Flop
Seat 2: FDIBA2009 (button) (small blind) collected (200)



PokerStars Home Game Hand #227252371158: {Club #4781089}  Hold'em No Limit (50/100) - 2021/06/02 0:46:26 EET [2021/06/01 17:46:26 ET]
Table 'VTPP NLHE 0106' 2-max (Play Money) Seat #1 is the button
Seat 1: s70n3fac3 (16083 in chips) 
Seat 2: FDIBA2009 (10736 in chips) 
s70n3fac3: posts small blind 50
FDIBA2009: posts big blind 100
*** HOLE CARDS ***
s70n3fac3: folds 
Uncalled bet (50) returned to FDIBA2009
FDIBA2009 collected 100 from pot
FDIBA2009: doesn't show hand 
*** SUMMARY ***
Total pot 100 | Rake 0 
Seat 1: s70n3fac3 (button) (small blind) folded before Flop
Seat 2: FDIBA2009 (big blind) collected (100)



PokerStars Home Game Hand #227252372820: {Club #4781089}  Hold'em No Limit (50/100) - 2021/06/02 0:46:30 EET [2021/06/01 17:46:30 ET]
Table 'VTPP NLHE 0106' 2-max (Play Money) Seat #2 is the button
Seat 1: s70n3fac3 (16033 in chips) 
Seat 2: FDIBA2009 (10786 in chips) 
FDIBA2009: posts small blind 50
s70n3fac3: posts big blind 100
*** HOLE CARDS ***
FDIBA2009: raises 200 to 300
s70n3fac3: raises 600 to 900
FDIBA2009: calls 600
*** FLOP *** [2c 7d 5c]
s70n3fac3: checks 
FDIBA2009: checks 
*** TURN *** [2c 7d 5c] [4h]
s70n3fac3: checks 
FDIBA2009: checks 
*** RIVER *** [2c 7d 5c 4h] [Kc]
s70n3fac3: checks 
FDIBA2009: bets 1701
s70n3fac3: calls 1701
*** SHOW DOWN ***
FDIBA2009: shows [Jc As] (high card Ace)
s70n3fac3: shows [Kd Jd] (a pair of Kings)
s70n3fac3 collected 4916 from pot
*** SUMMARY ***
Total pot 5202 | Rake 286 
Board [2c 7d 5c 4h Kc]
Seat 1: s70n3fac3 (big blind) showed [Kd Jd] and won (4916) with a pair of Kings
Seat 2: FDIBA2009 (button) (small blind) showed [Jc As] and lost with high card Ace



PokerStars Home Game Hand #227252383390: {Club #4781089}  Hold'em No Limit (50/100) - 2021/06/02 0:46:52 EET [2021/06/01 17:46:52 ET]
Table 'VTPP NLHE 0106' 2-max (Play Money) Seat #1 is the button
Seat 1: s70n3fac3 (18348 in chips) 
Seat 2: FDIBA2009 (8185 in chips) 
s70n3fac3: posts small blind 50
FDIBA2009: posts big blind 100
*** HOLE CARDS ***
s70n3fac3: folds 
Uncalled bet (50) returned to FDIBA2009
FDIBA2009 collected 100 from pot
FDIBA2009: doesn't show hand 
*** SUMMARY ***
Total pot 100 | Rake 0 
Seat 1: s70n3fac3 (button) (small blind) folded before Flop
Seat 2: FDIBA2009 (big blind) collected (100)



PokerStars Home Game Hand #227252385031: {Club #4781089}  Hold'em No Limit (50/100) - 2021/06/02 0:46:56 EET [2021/06/01 17:46:56 ET]
Table 'VTPP NLHE 0106' 2-max (Play Money) Seat #2 is the button
Seat 1: s70n3fac3 (18298 in chips) 
Seat 2: FDIBA2009 (8235 in chips) 
FDIBA2009: posts small blind 50
s70n3fac3: posts big blind 100
*** HOLE CARDS ***
FDIBA2009: raises 200 to 300
s70n3fac3: calls 200
*** FLOP *** [Jc 5s 2c]
s70n3fac3: checks 
FDIBA2009: checks 
*** TURN *** [Jc 5s 2c] [8h]
s70n3fac3: checks 
FDIBA2009: checks 
*** RIVER *** [Jc 5s 2c 8h] [6c]
s70n3fac3: checks 
FDIBA2009: checks 
*** SHOW DOWN ***
s70n3fac3: shows [6d Kh] (a pair of Sixes)
FDIBA2009: mucks hand 
s70n3fac3 collected 567 from pot
*** SUMMARY ***
Total pot 600 | Rake 33 
Board [Jc 5s 2c 8h 6c]
Seat 1: s70n3fac3 (big blind) showed [6d Kh] and won (567) with a pair of Sixes
Seat 2: FDIBA2009 (button) (small blind) mucked [Ah Qh]



PokerStars Home Game Hand #227252392333: {Club #4781089}  Hold'em No Limit (50/100) - 2021/06/02 0:47:12 EET [2021/06/01 17:47:12 ET]
Table 'VTPP NLHE 0106' 2-max (Play Money) Seat #1 is the button
Seat 1: s70n3fac3 (18565 in chips) 
Seat 2: FDIBA2009 (7935 in chips) 
s70n3fac3: posts small blind 50
FDIBA2009: posts big blind 100
*** HOLE CARDS ***
s70n3fac3: raises 150 to 250
FDIBA2009: calls 150
*** FLOP *** [5s 6h Ah]
FDIBA2009: bets 472
s70n3fac3: calls 472
*** TURN *** [5s 6h Ah] [8d]
FDIBA2009: bets 1365
s70n3fac3: calls 1365
*** RIVER *** [5s 6h Ah 8d] [8h]
FDIBA2009: checks 
s70n3fac3: checks 
*** SHOW DOWN ***
FDIBA2009: shows [7d 5c] (two pair, Eights and Fives)
s70n3fac3: shows [7c Ad] (two pair, Aces and Eights)
s70n3fac3 collected 3944 from pot
*** SUMMARY ***
Total pot 4174 | Rake 230 
Board [5s 6h Ah 8d 8h]
Seat 1: s70n3fac3 (button) (small blind) showed [7c Ad] and won (3944) with two pair, Aces and Eights
Seat 2: FDIBA2009 (big blind) showed [7d 5c] and lost with two pair, Eights and Fives



PokerStars Home Game Hand #227252402329: {Club #4781089}  Hold'em No Limit (50/100) - 2021/06/02 0:47:34 EET [2021/06/01 17:47:34 ET]
Table 'VTPP NLHE 0106' 2-max (Play Money) Seat #2 is the button
Seat 1: s70n3fac3 (20422 in chips) 
Seat 2: FDIBA2009 (5848 in chips) 
FDIBA2009: posts small blind 50
s70n3fac3: posts big blind 100
*** HOLE CARDS ***
FDIBA2009: raises 200 to 300
s70n3fac3: calls 200
*** FLOP *** [8d Ah 6s]
s70n3fac3: checks 
FDIBA2009: checks 
*** TURN *** [8d Ah 6s] [2h]
s70n3fac3: checks 
FDIBA2009: checks 
*** RIVER *** [8d Ah 6s 2h] [3h]
s70n3fac3: bets 400
FDIBA2009: folds 
Uncalled bet (400) returned to s70n3fac3
s70n3fac3 collected 567 from pot
s70n3fac3: doesn't show hand 
*** SUMMARY ***
Total pot 600 | Rake 33 
Board [8d Ah 6s 2h 3h]
Seat 1: s70n3fac3 (big blind) collected (567)
Seat 2: FDIBA2009 (button) (small blind) folded on the River



PokerStars Home Game Hand #227252409122: {Club #4781089}  Hold'em No Limit (50/100) - 2021/06/02 0:47:49 EET [2021/06/01 17:47:49 ET]
Table 'VTPP NLHE 0106' 2-max (Play Money) Seat #1 is the button
Seat 1: s70n3fac3 (20689 in chips) 
Seat 2: FDIBA2009 (5548 in chips) 
s70n3fac3: posts small blind 50
FDIBA2009: posts big blind 100
*** HOLE CARDS ***
s70n3fac3: raises 150 to 250
FDIBA2009: raises 500 to 750
s70n3fac3: calls 500
*** FLOP *** [Qc Tc Kh]
FDIBA2009: checks 
s70n3fac3: checks 
*** TURN *** [Qc Tc Kh] [Qd]
FDIBA2009: checks 
s70n3fac3: bets 700
FDIBA2009: folds 
Uncalled bet (700) returned to s70n3fac3
s70n3fac3 collected 1417 from pot
s70n3fac3: doesn't show hand 
*** SUMMARY ***
Total pot 1500 | Rake 83 
Board [Qc Tc Kh Qd]
Seat 1: s70n3fac3 (button) (small blind) collected (1417)
Seat 2: FDIBA2009 (big blind) folded on the Turn



PokerStars Home Game Hand #227252418178: {Club #4781089}  Hold'em No Limit (50/100) - 2021/06/02 0:48:08 EET [2021/06/01 17:48:08 ET]
Table 'VTPP NLHE 0106' 2-max (Play Money) Seat #2 is the button
Seat 1: s70n3fac3 (21356 in chips) 
Seat 2: FDIBA2009 (4798 in chips) 
FDIBA2009: posts small blind 50
s70n3fac3: posts big blind 100
*** HOLE CARDS ***
FDIBA2009: raises 100 to 200
s70n3fac3: calls 100
*** FLOP *** [4s Kh 2d]
s70n3fac3: checks 
FDIBA2009: checks 
*** TURN *** [4s Kh 2d] [7h]
s70n3fac3: checks 
FDIBA2009: bets 378
s70n3fac3: calls 378
*** RIVER *** [4s Kh 2d 7h] [As]
s70n3fac3: checks 
FDIBA2009: bets 1092
s70n3fac3: folds 
Uncalled bet (1092) returned to FDIBA2009
FDIBA2009 collected 1092 from pot
FDIBA2009: doesn't show hand 
*** SUMMARY ***
Total pot 1156 | Rake 64 
Board [4s Kh 2d 7h As]
Seat 1: s70n3fac3 (big blind) folded on the River
Seat 2: FDIBA2009 (button) (small blind) collected (1092)



PokerStars Home Game Hand #227252427278: {Club #4781089}  Hold'em No Limit (50/100) - 2021/06/02 0:48:28 EET [2021/06/01 17:48:28 ET]
Table 'VTPP NLHE 0106' 2-max (Play Money) Seat #1 is the button
Seat 1: s70n3fac3 (20778 in chips) 
Seat 2: FDIBA2009 (5312 in chips) 
s70n3fac3: posts small blind 50
FDIBA2009: posts big blind 100
*** HOLE CARDS ***
s70n3fac3: calls 50
FDIBA2009: raises 200 to 300
s70n3fac3: calls 200
*** FLOP *** [6c 3h 7c]
FDIBA2009: checks 
s70n3fac3: checks 
*** TURN *** [6c 3h 7c] [9s]
FDIBA2009: checks 
s70n3fac3: bets 300
FDIBA2009: folds 
Uncalled bet (300) returned to s70n3fac3
s70n3fac3 collected 567 from pot
s70n3fac3: doesn't show hand 
*** SUMMARY ***
Total pot 600 | Rake 33 
Board [6c 3h 7c 9s]
Seat 1: s70n3fac3 (button) (small blind) collected (567)
Seat 2: FDIBA2009 (big blind) folded on the Turn



PokerStars Home Game Hand #227252434066: {Club #4781089}  Hold'em No Limit (50/100) - 2021/06/02 0:48:43 EET [2021/06/01 17:48:43 ET]
Table 'VTPP NLHE 0106' 2-max (Play Money) Seat #2 is the button
Seat 1: s70n3fac3 (21045 in chips) 
Seat 2: FDIBA2009 (5012 in chips) 
FDIBA2009: posts small blind 50
s70n3fac3: posts big blind 100
*** HOLE CARDS ***
FDIBA2009: raises 200 to 300
s70n3fac3: calls 200
*** FLOP *** [3d 9c Qs]
s70n3fac3: checks 
FDIBA2009: bets 567
s70n3fac3: folds 
Uncalled bet (567) returned to FDIBA2009
FDIBA2009 collected 567 from pot
FDIBA2009: doesn't show hand 
*** SUMMARY ***
Total pot 600 | Rake 33 
Board [3d 9c Qs]
Seat 1: s70n3fac3 (big blind) folded on the Flop
Seat 2: FDIBA2009 (button) (small blind) collected (567)



PokerStars Home Game Hand #227252439143: {Club #4781089}  Hold'em No Limit (50/100) - 2021/06/02 0:48:54 EET [2021/06/01 17:48:54 ET]
Table 'VTPP NLHE 0106' 2-max (Play Money) Seat #1 is the button
Seat 1: s70n3fac3 (20745 in chips) 
Seat 2: FDIBA2009 (5279 in chips) 
s70n3fac3: posts small blind 50
FDIBA2009: posts big blind 100
*** HOLE CARDS ***
s70n3fac3: raises 150 to 250
FDIBA2009: calls 150
*** FLOP *** [6h Kc Kd]
FDIBA2009: checks 
s70n3fac3: checks 
*** TURN *** [6h Kc Kd] [As]
FDIBA2009: checks 
s70n3fac3: checks 
*** RIVER *** [6h Kc Kd As] [Td]
FDIBA2009: checks 
s70n3fac3: bets 100
FDIBA2009: calls 100
*** SHOW DOWN ***
s70n3fac3: shows [Ks 4s] (three of a kind, Kings)
FDIBA2009: mucks hand 
s70n3fac3 collected 661 from pot
*** SUMMARY ***
Total pot 700 | Rake 39 
Board [6h Kc Kd As Td]
Seat 1: s70n3fac3 (button) (small blind) showed [Ks 4s] and won (661) with three of a kind, Kings
Seat 2: FDIBA2009 (big blind) mucked [7s Jd]



PokerStars Home Game Hand #227252449143: {Club #4781089}  Hold'em No Limit (50/100) - 2021/06/02 0:49:16 EET [2021/06/01 17:49:16 ET]
Table 'VTPP NLHE 0106' 2-max (Play Money) Seat #2 is the button
Seat 1: s70n3fac3 (21056 in chips) 
Seat 2: FDIBA2009 (4929 in chips) 
FDIBA2009: posts small blind 50
s70n3fac3: posts big blind 100
*** HOLE CARDS ***
FDIBA2009: raises 200 to 300
s70n3fac3: calls 200
*** FLOP *** [Td 6h Ac]
s70n3fac3: checks 
FDIBA2009: bets 567
s70n3fac3: folds 
Uncalled bet (567) returned to FDIBA2009
FDIBA2009 collected 567 from pot
FDIBA2009: doesn't show hand 
*** SUMMARY ***
Total pot 600 | Rake 33 
Board [Td 6h Ac]
Seat 1: s70n3fac3 (big blind) folded on the Flop
Seat 2: FDIBA2009 (button) (small blind) collected (567)



PokerStars Home Game Hand #227252454823: {Club #4781089}  Hold'em No Limit (50/100) - 2021/06/02 0:49:29 EET [2021/06/01 17:49:29 ET]
Table 'VTPP NLHE 0106' 2-max (Play Money) Seat #1 is the button
Seat 1: s70n3fac3 (20756 in chips) 
Seat 2: FDIBA2009 (5196 in chips) 
s70n3fac3: posts small blind 50
FDIBA2009: posts big blind 100
*** HOLE CARDS ***
s70n3fac3: raises 150 to 250
FDIBA2009: calls 150
*** FLOP *** [7s 4c Ad]
FDIBA2009: checks 
s70n3fac3: bets 200
FDIBA2009: folds 
Uncalled bet (200) returned to s70n3fac3
s70n3fac3 collected 472 from pot
s70n3fac3: doesn't show hand 
*** SUMMARY ***
Total pot 500 | Rake 28 
Board [7s 4c Ad]
Seat 1: s70n3fac3 (button) (small blind) collected (472)
Seat 2: FDIBA2009 (big blind) folded on the Flop



PokerStars Home Game Hand #227252459571: {Club #4781089}  Hold'em No Limit (50/100) - 2021/06/02 0:49:39 EET [2021/06/01 17:49:39 ET]
Table 'VTPP NLHE 0106' 2-max (Play Money) Seat #2 is the button
Seat 1: s70n3fac3 (20978 in chips) 
Seat 2: FDIBA2009 (4946 in chips) 
FDIBA2009: posts small blind 50
s70n3fac3: posts big blind 100
*** HOLE CARDS ***
FDIBA2009: raises 200 to 300
s70n3fac3: calls 200
*** FLOP *** [Th 4d Jh]
s70n3fac3: checks 
FDIBA2009: bets 567
s70n3fac3: raises 1701 to 2268
FDIBA2009: folds 
Uncalled bet (1701) returned to s70n3fac3
s70n3fac3 collected 1639 from pot
s70n3fac3: doesn't show hand 
*** SUMMARY ***
Total pot 1734 | Rake 95 
Board [Th 4d Jh]
Seat 1: s70n3fac3 (big blind) collected (1639)
Seat 2: FDIBA2009 (button) (small blind) folded on the Flop



PokerStars Home Game Hand #227252466679: {Club #4781089}  Hold'em No Limit (50/100) - 2021/06/02 0:49:55 EET [2021/06/01 17:49:55 ET]
Table 'VTPP NLHE 0106' 2-max (Play Money) Seat #1 is the button
Seat 1: s70n3fac3 (21750 in chips) 
Seat 2: FDIBA2009 (4079 in chips) 
s70n3fac3: posts small blind 50
FDIBA2009: posts big blind 100
*** HOLE CARDS ***
s70n3fac3: calls 50
FDIBA2009: checks 
*** FLOP *** [7c 4h Kh]
FDIBA2009: checks 
s70n3fac3: checks 
*** TURN *** [7c 4h Kh] [3h]
FDIBA2009: bets 189
s70n3fac3: folds 
Uncalled bet (189) returned to FDIBA2009
FDIBA2009 collected 189 from pot
FDIBA2009: doesn't show hand 
*** SUMMARY ***
Total pot 200 | Rake 11 
Board [7c 4h Kh 3h]
Seat 1: s70n3fac3 (button) (small blind) folded on the Turn
Seat 2: FDIBA2009 (big blind) collected (189)



PokerStars Home Game Hand #227252472669: {Club #4781089}  Hold'em No Limit (50/100) - 2021/06/02 0:50:08 EET [2021/06/01 17:50:08 ET]
Table 'VTPP NLHE 0106' 2-max (Play Money) Seat #2 is the button
Seat 1: s70n3fac3 (21650 in chips) 
Seat 2: FDIBA2009 (4168 in chips) 
FDIBA2009: posts small blind 50
s70n3fac3: posts big blind 100
*** HOLE CARDS ***
FDIBA2009: raises 200 to 300
s70n3fac3: calls 200
*** FLOP *** [8c 6s Th]
s70n3fac3: checks 
FDIBA2009: checks 
*** TURN *** [8c 6s Th] [Jh]
s70n3fac3: checks 
FDIBA2009: checks 
*** RIVER *** [8c 6s Th Jh] [9c]
s70n3fac3: checks 
FDIBA2009: bets 3868 and is all-in
s70n3fac3: folds 
Uncalled bet (3868) returned to FDIBA2009
FDIBA2009 collected 567 from pot
FDIBA2009: doesn't show hand 
*** SUMMARY ***
Total pot 600 | Rake 33 
Board [8c 6s Th Jh 9c]
Seat 1: s70n3fac3 (big blind) folded on the River
Seat 2: FDIBA2009 (button) (small blind) collected (567)



PokerStars Home Game Hand #227252480894: {Club #4781089}  Hold'em No Limit (50/100) - 2021/06/02 0:50:26 EET [2021/06/01 17:50:26 ET]
Table 'VTPP NLHE 0106' 2-max (Play Money) Seat #1 is the button
Seat 1: s70n3fac3 (21350 in chips) 
Seat 2: FDIBA2009 (4435 in chips) 
s70n3fac3: posts small blind 50
FDIBA2009: posts big blind 100
*** HOLE CARDS ***
s70n3fac3: raises 150 to 250
FDIBA2009: calls 150
*** FLOP *** [Qd 9s 4d]
FDIBA2009: checks 
s70n3fac3: bets 200
FDIBA2009: folds 
Uncalled bet (200) returned to s70n3fac3
s70n3fac3 collected 472 from pot
s70n3fac3: doesn't show hand 
*** SUMMARY ***
Total pot 500 | Rake 28 
Board [Qd 9s 4d]
Seat 1: s70n3fac3 (button) (small blind) collected (472)
Seat 2: FDIBA2009 (big blind) folded on the Flop



PokerStars Home Game Hand #227252486444: {Club #4781089}  Hold'em No Limit (50/100) - 2021/06/02 0:50:39 EET [2021/06/01 17:50:39 ET]
Table 'VTPP NLHE 0106' 2-max (Play Money) Seat #2 is the button
Seat 1: s70n3fac3 (21572 in chips) 
Seat 2: FDIBA2009 (4185 in chips) 
FDIBA2009: posts small blind 50
s70n3fac3: posts big blind 100
*** HOLE CARDS ***
FDIBA2009: raises 200 to 300
s70n3fac3: calls 200
*** FLOP *** [2s 9d 8d]
s70n3fac3: checks 
FDIBA2009: bets 567
s70n3fac3: folds 
Uncalled bet (567) returned to FDIBA2009
FDIBA2009 collected 567 from pot
FDIBA2009: doesn't show hand 
*** SUMMARY ***
Total pot 600 | Rake 33 
Board [2s 9d 8d]
Seat 1: s70n3fac3 (big blind) folded on the Flop
Seat 2: FDIBA2009 (button) (small blind) collected (567)



PokerStars Home Game Hand #227252491545: {Club #4781089}  Hold'em No Limit (50/100) - 2021/06/02 0:50:50 EET [2021/06/01 17:50:50 ET]
Table 'VTPP NLHE 0106' 2-max (Play Money) Seat #1 is the button
Seat 1: s70n3fac3 (21272 in chips) 
Seat 2: FDIBA2009 (4452 in chips) 
s70n3fac3: posts small blind 50
FDIBA2009: posts big blind 100
*** HOLE CARDS ***
s70n3fac3: calls 50
FDIBA2009: raises 100 to 200
s70n3fac3: calls 100
*** FLOP *** [Qd Qc 2h]
FDIBA2009: checks 
s70n3fac3: checks 
*** TURN *** [Qd Qc 2h] [6c]
FDIBA2009: bets 378
s70n3fac3: folds 
Uncalled bet (378) returned to FDIBA2009
FDIBA2009 collected 378 from pot
FDIBA2009: doesn't show hand 
*** SUMMARY ***
Total pot 400 | Rake 22 
Board [Qd Qc 2h 6c]
Seat 1: s70n3fac3 (button) (small blind) folded on the Turn
Seat 2: FDIBA2009 (big blind) collected (378)



PokerStars Home Game Hand #227252497736: {Club #4781089}  Hold'em No Limit (50/100) - 2021/06/02 0:51:04 EET [2021/06/01 17:51:04 ET]
Table 'VTPP NLHE 0106' 2-max (Play Money) Seat #2 is the button
Seat 1: s70n3fac3 (21072 in chips) 
Seat 2: FDIBA2009 (4630 in chips) 
FDIBA2009: posts small blind 50
s70n3fac3: posts big blind 100
*** HOLE CARDS ***
FDIBA2009: raises 200 to 300
s70n3fac3: calls 200
*** FLOP *** [Th 9h 4s]
s70n3fac3: checks 
FDIBA2009: bets 567
s70n3fac3: folds 
Uncalled bet (567) returned to FDIBA2009
FDIBA2009 collected 567 from pot
FDIBA2009: doesn't show hand 
*** SUMMARY ***
Total pot 600 | Rake 33 
Board [Th 9h 4s]
Seat 1: s70n3fac3 (big blind) folded on the Flop
Seat 2: FDIBA2009 (button) (small blind) collected (567)



PokerStars Home Game Hand #227252502855: {Club #4781089}  Hold'em No Limit (50/100) - 2021/06/02 0:51:15 EET [2021/06/01 17:51:15 ET]
Table 'VTPP NLHE 0106' 2-max (Play Money) Seat #1 is the button
Seat 1: s70n3fac3 (20772 in chips) 
Seat 2: FDIBA2009 (4897 in chips) 
s70n3fac3: posts small blind 50
FDIBA2009: posts big blind 100
*** HOLE CARDS ***
s70n3fac3: folds 
Uncalled bet (50) returned to FDIBA2009
FDIBA2009 collected 100 from pot
FDIBA2009: doesn't show hand 
*** SUMMARY ***
Total pot 100 | Rake 0 
Seat 1: s70n3fac3 (button) (small blind) folded before Flop
Seat 2: FDIBA2009 (big blind) collected (100)



PokerStars Home Game Hand #227252504613: {Club #4781089}  Hold'em No Limit (50/100) - 2021/06/02 0:51:19 EET [2021/06/01 17:51:19 ET]
Table 'VTPP NLHE 0106' 2-max (Play Money) Seat #2 is the button
Seat 1: s70n3fac3 (20722 in chips) 
Seat 2: FDIBA2009 (4947 in chips) 
FDIBA2009: posts small blind 50
s70n3fac3: posts big blind 100
*** HOLE CARDS ***
FDIBA2009: folds 
Uncalled bet (50) returned to s70n3fac3
s70n3fac3 collected 100 from pot
s70n3fac3: doesn't show hand 
*** SUMMARY ***
Total pot 100 | Rake 0 
Seat 1: s70n3fac3 (big blind) collected (100)
Seat 2: FDIBA2009 (button) (small blind) folded before Flop



PokerStars Home Game Hand #227252507002: {Club #4781089}  Hold'em No Limit (50/100) - 2021/06/02 0:51:24 EET [2021/06/01 17:51:24 ET]
Table 'VTPP NLHE 0106' 2-max (Play Money) Seat #1 is the button
Seat 1: s70n3fac3 (20772 in chips) 
Seat 2: FDIBA2009 (4897 in chips) 
s70n3fac3: posts small blind 50
FDIBA2009: posts big blind 100
*** HOLE CARDS ***
s70n3fac3: raises 150 to 250
FDIBA2009: raises 500 to 750
s70n3fac3: folds 
Uncalled bet (500) returned to FDIBA2009
FDIBA2009 collected 500 from pot
FDIBA2009: doesn't show hand 
*** SUMMARY ***
Total pot 500 | Rake 0 
Seat 1: s70n3fac3 (button) (small blind) folded before Flop
Seat 2: FDIBA2009 (big blind) collected (500)



PokerStars Home Game Hand #227252511278: {Club #4781089}  Hold'em No Limit (50/100) - 2021/06/02 0:51:34 EET [2021/06/01 17:51:34 ET]
Table 'VTPP NLHE 0106' 2-max (Play Money) Seat #2 is the button
Seat 1: s70n3fac3 (20522 in chips) 
Seat 2: FDIBA2009 (5147 in chips) 
FDIBA2009: posts small blind 50
s70n3fac3: posts big blind 100
*** HOLE CARDS ***
FDIBA2009: raises 200 to 300
s70n3fac3: calls 200
*** FLOP *** [4h 3h 5s]
s70n3fac3: checks 
FDIBA2009: bets 567
s70n3fac3: folds 
Uncalled bet (567) returned to FDIBA2009
FDIBA2009 collected 567 from pot
FDIBA2009: doesn't show hand 
*** SUMMARY ***
Total pot 600 | Rake 33 
Board [4h 3h 5s]
Seat 1: s70n3fac3 (big blind) folded on the Flop
Seat 2: FDIBA2009 (button) (small blind) collected (567)



PokerStars Home Game Hand #227252516583: {Club #4781089}  Hold'em No Limit (50/100) - 2021/06/02 0:51:46 EET [2021/06/01 17:51:46 ET]
Table 'VTPP NLHE 0106' 2-max (Play Money) Seat #1 is the button
Seat 1: s70n3fac3 (20222 in chips) 
Seat 2: FDIBA2009 (5414 in chips) 
s70n3fac3: posts small blind 50
FDIBA2009: posts big blind 100
*** HOLE CARDS ***
s70n3fac3: calls 50
FDIBA2009: checks 
*** FLOP *** [Jh 7c Th]
FDIBA2009: checks 
s70n3fac3: checks 
*** TURN *** [Jh 7c Th] [Kd]
FDIBA2009: checks 
s70n3fac3: checks 
*** RIVER *** [Jh 7c Th Kd] [2s]
FDIBA2009: checks 
s70n3fac3: bets 200
FDIBA2009: folds 
Uncalled bet (200) returned to s70n3fac3
s70n3fac3 collected 189 from pot
s70n3fac3: doesn't show hand 
*** SUMMARY ***
Total pot 200 | Rake 11 
Board [Jh 7c Th Kd 2s]
Seat 1: s70n3fac3 (button) (small blind) collected (189)
Seat 2: FDIBA2009 (big blind) folded on the River



PokerStars Home Game Hand #227252523401: {Club #4781089}  Hold'em No Limit (50/100) - 2021/06/02 0:52:01 EET [2021/06/01 17:52:01 ET]
Table 'VTPP NLHE 0106' 2-max (Play Money) Seat #2 is the button
Seat 1: s70n3fac3 (20311 in chips) 
Seat 2: FDIBA2009 (5314 in chips) 
FDIBA2009: posts small blind 50
s70n3fac3: posts big blind 100
*** HOLE CARDS ***
FDIBA2009: raises 200 to 300
s70n3fac3: calls 200
*** FLOP *** [2d Ts Kh]
s70n3fac3: checks 
FDIBA2009: checks 
*** TURN *** [2d Ts Kh] [3s]
s70n3fac3: checks 
FDIBA2009: checks 
*** RIVER *** [2d Ts Kh 3s] [2h]
s70n3fac3: checks 
FDIBA2009: bets 567
s70n3fac3: folds 
Uncalled bet (567) returned to FDIBA2009
FDIBA2009 collected 567 from pot
FDIBA2009: doesn't show hand 
*** SUMMARY ***
Total pot 600 | Rake 33 
Board [2d Ts Kh 3s 2h]
Seat 1: s70n3fac3 (big blind) folded on the River
Seat 2: FDIBA2009 (button) (small blind) collected (567)



PokerStars Home Game Hand #227252530883: {Club #4781089}  Hold'em No Limit (50/100) - 2021/06/02 0:52:17 EET [2021/06/01 17:52:17 ET]
Table 'VTPP NLHE 0106' 2-max (Play Money) Seat #1 is the button
Seat 1: s70n3fac3 (20011 in chips) 
Seat 2: FDIBA2009 (5581 in chips) 
s70n3fac3: posts small blind 50
FDIBA2009: posts big blind 100
*** HOLE CARDS ***
s70n3fac3: calls 50
FDIBA2009: raises 200 to 300
s70n3fac3: calls 200
*** FLOP *** [5h 4d Qh]
FDIBA2009: checks 
s70n3fac3: bets 300
FDIBA2009: folds 
Uncalled bet (300) returned to s70n3fac3
s70n3fac3 collected 567 from pot
s70n3fac3: doesn't show hand 
*** SUMMARY ***
Total pot 600 | Rake 33 
Board [5h 4d Qh]
Seat 1: s70n3fac3 (button) (small blind) collected (567)
Seat 2: FDIBA2009 (big blind) folded on the Flop



PokerStars Home Game Hand #227252536226: {Club #4781089}  Hold'em No Limit (50/100) - 2021/06/02 0:52:29 EET [2021/06/01 17:52:29 ET]
Table 'VTPP NLHE 0106' 2-max (Play Money) Seat #2 is the button
Seat 1: s70n3fac3 (20278 in chips) 
Seat 2: FDIBA2009 (5281 in chips) 
FDIBA2009: posts small blind 50
s70n3fac3: posts big blind 100
*** HOLE CARDS ***
FDIBA2009: raises 100 to 200
s70n3fac3: calls 100
*** FLOP *** [6d 2s 2h]
s70n3fac3: checks 
FDIBA2009: checks 
*** TURN *** [6d 2s 2h] [8s]
s70n3fac3: checks 
FDIBA2009: checks 
*** RIVER *** [6d 2s 2h 8s] [3h]
s70n3fac3: checks 
FDIBA2009: bets 400
s70n3fac3: folds 
Uncalled bet (400) returned to FDIBA2009
FDIBA2009 collected 378 from pot
FDIBA2009: doesn't show hand 
*** SUMMARY ***
Total pot 400 | Rake 22 
Board [6d 2s 2h 8s 3h]
Seat 1: s70n3fac3 (big blind) folded on the River
Seat 2: FDIBA2009 (button) (small blind) collected (378)



PokerStars Home Game Hand #227252543124: {Club #4781089}  Hold'em No Limit (50/100) - 2021/06/02 0:52:45 EET [2021/06/01 17:52:45 ET]
Table 'VTPP NLHE 0106' 2-max (Play Money) Seat #1 is the button
Seat 1: s70n3fac3 (20078 in chips) 
Seat 2: FDIBA2009 (5459 in chips) 
s70n3fac3: posts small blind 50
FDIBA2009: posts big blind 100
*** HOLE CARDS ***
s70n3fac3: calls 50
FDIBA2009: checks 
*** FLOP *** [9h Qh Ah]
FDIBA2009: checks 
s70n3fac3: bets 100
FDIBA2009: raises 400 to 500
s70n3fac3: folds 
Uncalled bet (400) returned to FDIBA2009
FDIBA2009 collected 378 from pot
FDIBA2009: doesn't show hand 
*** SUMMARY ***
Total pot 400 | Rake 22 
Board [9h Qh Ah]
Seat 1: s70n3fac3 (button) (small blind) folded on the Flop
Seat 2: FDIBA2009 (big blind) collected (378)



PokerStars Home Game Hand #227252549651: {Club #4781089}  Hold'em No Limit (50/100) - 2021/06/02 0:52:59 EET [2021/06/01 17:52:59 ET]
Table 'VTPP NLHE 0106' 2-max (Play Money) Seat #2 is the button
Seat 1: s70n3fac3 (19878 in chips) 
Seat 2: FDIBA2009 (5637 in chips) 
FDIBA2009: posts small blind 50
s70n3fac3: posts big blind 100
*** HOLE CARDS ***
FDIBA2009: raises 150 to 250
s70n3fac3: calls 150
*** FLOP *** [Jd 7h Qh]
s70n3fac3: checks 
FDIBA2009: checks 
*** TURN *** [Jd 7h Qh] [2h]
s70n3fac3: bets 300
FDIBA2009: calls 300
*** RIVER *** [Jd 7h Qh 2h] [6c]
s70n3fac3: bets 800
FDIBA2009: folds 
Uncalled bet (800) returned to s70n3fac3
s70n3fac3 collected 1039 from pot
s70n3fac3: doesn't show hand 
*** SUMMARY ***
Total pot 1100 | Rake 61 
Board [Jd 7h Qh 2h 6c]
Seat 1: s70n3fac3 (big blind) collected (1039)
Seat 2: FDIBA2009 (button) (small blind) folded on the River



PokerStars Home Game Hand #227252557071: {Club #4781089}  Hold'em No Limit (50/100) - 2021/06/02 0:53:16 EET [2021/06/01 17:53:16 ET]
Table 'VTPP NLHE 0106' 2-max (Play Money) Seat #1 is the button
Seat 1: s70n3fac3 (20367 in chips) 
Seat 2: FDIBA2009 (5087 in chips) 
s70n3fac3: posts small blind 50
FDIBA2009: posts big blind 100
*** HOLE CARDS ***
s70n3fac3: calls 50
FDIBA2009: raises 200 to 300
s70n3fac3: calls 200
*** FLOP *** [7s Qc 8c]
FDIBA2009: checks 
s70n3fac3: checks 
*** TURN *** [7s Qc 8c] [Tc]
FDIBA2009: checks 
s70n3fac3: bets 400
FDIBA2009: folds 
Uncalled bet (400) returned to s70n3fac3
s70n3fac3 collected 567 from pot
s70n3fac3: doesn't show hand 
*** SUMMARY ***
Total pot 600 | Rake 33 
Board [7s Qc 8c Tc]
Seat 1: s70n3fac3 (button) (small blind) collected (567)
Seat 2: FDIBA2009 (big blind) folded on the Turn



PokerStars Home Game Hand #227252563815: {Club #4781089}  Hold'em No Limit (50/100) - 2021/06/02 0:53:32 EET [2021/06/01 17:53:32 ET]
Table 'VTPP NLHE 0106' 2-max (Play Money) Seat #2 is the button
Seat 1: s70n3fac3 (20634 in chips) 
Seat 2: FDIBA2009 (4787 in chips) 
FDIBA2009: posts small blind 50
s70n3fac3: posts big blind 100
*** HOLE CARDS ***
FDIBA2009: folds 
Uncalled bet (50) returned to s70n3fac3
s70n3fac3 collected 100 from pot
s70n3fac3: doesn't show hand 
*** SUMMARY ***
Total pot 100 | Rake 0 
Seat 1: s70n3fac3 (big blind) collected (100)
Seat 2: FDIBA2009 (button) (small blind) folded before Flop



PokerStars Home Game Hand #227252565801: {Club #4781089}  Hold'em No Limit (50/100) - 2021/06/02 0:53:36 EET [2021/06/01 17:53:36 ET]
Table 'VTPP NLHE 0106' 2-max (Play Money) Seat #1 is the button
Seat 1: s70n3fac3 (20684 in chips) 
Seat 2: FDIBA2009 (4737 in chips) 
s70n3fac3: posts small blind 50
FDIBA2009: posts big blind 100
*** HOLE CARDS ***
s70n3fac3: folds 
Uncalled bet (50) returned to FDIBA2009
FDIBA2009 collected 100 from pot
FDIBA2009: doesn't show hand 
*** SUMMARY ***
Total pot 100 | Rake 0 
Seat 1: s70n3fac3 (button) (small blind) folded before Flop
Seat 2: FDIBA2009 (big blind) collected (100)



PokerStars Home Game Hand #227252567442: {Club #4781089}  Hold'em No Limit (50/100) - 2021/06/02 0:53:40 EET [2021/06/01 17:53:40 ET]
Table 'VTPP NLHE 0106' 2-max (Play Money) Seat #2 is the button
Seat 1: s70n3fac3 (20634 in chips) 
Seat 2: FDIBA2009 (4787 in chips) 
FDIBA2009: posts small blind 50
s70n3fac3: posts big blind 100
*** HOLE CARDS ***
FDIBA2009: raises 200 to 300
s70n3fac3: calls 200
*** FLOP *** [6c 2s Kc]
s70n3fac3: checks 
FDIBA2009: checks 
*** TURN *** [6c 2s Kc] [3s]
s70n3fac3: checks 
FDIBA2009: bets 567
s70n3fac3: folds 
Uncalled bet (567) returned to FDIBA2009
FDIBA2009 collected 567 from pot
FDIBA2009: doesn't show hand 
*** SUMMARY ***
Total pot 600 | Rake 33 
Board [6c 2s Kc 3s]
Seat 1: s70n3fac3 (big blind) folded on the Turn
Seat 2: FDIBA2009 (button) (small blind) collected (567)



PokerStars Home Game Hand #227252573760: {Club #4781089}  Hold'em No Limit (50/100) - 2021/06/02 0:53:54 EET [2021/06/01 17:53:54 ET]
Table 'VTPP NLHE 0106' 2-max (Play Money) Seat #1 is the button
Seat 1: s70n3fac3 (20334 in chips) 
Seat 2: FDIBA2009 (5054 in chips) 
s70n3fac3: posts small blind 50
FDIBA2009: posts big blind 100
*** HOLE CARDS ***
s70n3fac3: folds 
Uncalled bet (50) returned to FDIBA2009
FDIBA2009 collected 100 from pot
FDIBA2009: doesn't show hand 
*** SUMMARY ***
Total pot 100 | Rake 0 
Seat 1: s70n3fac3 (button) (small blind) folded before Flop
Seat 2: FDIBA2009 (big blind) collected (100)



PokerStars Home Game Hand #227252575356: {Club #4781089}  Hold'em No Limit (50/100) - 2021/06/02 0:53:58 EET [2021/06/01 17:53:58 ET]
Table 'VTPP NLHE 0106' 2-max (Play Money) Seat #2 is the button
Seat 1: s70n3fac3 (20284 in chips) 
Seat 2: FDIBA2009 (5104 in chips) 
FDIBA2009: posts small blind 50
s70n3fac3: posts big blind 100
*** HOLE CARDS ***
FDIBA2009: raises 200 to 300
s70n3fac3: calls 200
*** FLOP *** [Ks Ad 7c]
s70n3fac3: checks 
FDIBA2009: checks 
*** TURN *** [Ks Ad 7c] [7h]
s70n3fac3: checks 
FDIBA2009: checks 
*** RIVER *** [Ks Ad 7c 7h] [9d]
s70n3fac3: bets 400
FDIBA2009: folds 
Uncalled bet (400) returned to s70n3fac3
s70n3fac3 collected 567 from pot
s70n3fac3: doesn't show hand 
*** SUMMARY ***
Total pot 600 | Rake 33 
Board [Ks Ad 7c 7h 9d]
Seat 1: s70n3fac3 (big blind) collected (567)
Seat 2: FDIBA2009 (button) (small blind) folded on the River



PokerStars Home Game Hand #227252582206: {Club #4781089}  Hold'em No Limit (50/100) - 2021/06/02 0:54:13 EET [2021/06/01 17:54:13 ET]
Table 'VTPP NLHE 0106' 2-max (Play Money) Seat #1 is the button
Seat 1: s70n3fac3 (20551 in chips) 
Seat 2: FDIBA2009 (4804 in chips) 
s70n3fac3: posts small blind 50
FDIBA2009: posts big blind 100
*** HOLE CARDS ***
s70n3fac3: calls 50
FDIBA2009: raises 200 to 300
s70n3fac3: calls 200
*** FLOP *** [Jd Th 4h]
FDIBA2009: bets 567
s70n3fac3: calls 567
*** TURN *** [Jd Th 4h] [Qd]
FDIBA2009: bets 1639
s70n3fac3: calls 1639
*** RIVER *** [Jd Th 4h Qd] [9h]
FDIBA2009: bets 2298 and is all-in
s70n3fac3: calls 2298
*** SHOW DOWN ***
FDIBA2009: shows [5h 2h] (a flush, Ten high)
s70n3fac3: shows [8c 9d] (a straight, Eight to Queen)
FDIBA2009 collected 9080 from pot
*** SUMMARY ***
Total pot 9608 | Rake 528 
Board [Jd Th 4h Qd 9h]
Seat 1: s70n3fac3 (button) (small blind) showed [8c 9d] and lost with a straight, Eight to Queen
Seat 2: FDIBA2009 (big blind) showed [5h 2h] and won (9080) with a flush, Ten high



PokerStars Home Game Hand #227252593564: {Club #4781089}  Hold'em No Limit (50/100) - 2021/06/02 0:54:39 EET [2021/06/01 17:54:39 ET]
Table 'VTPP NLHE 0106' 2-max (Play Money) Seat #2 is the button
Seat 1: s70n3fac3 (15747 in chips) 
Seat 2: FDIBA2009 (9080 in chips) 
FDIBA2009: posts small blind 50
s70n3fac3: posts big blind 100
*** HOLE CARDS ***
FDIBA2009: raises 100 to 200
s70n3fac3: calls 100
*** FLOP *** [9d Jc 7s]
s70n3fac3: checks 
FDIBA2009: checks 
*** TURN *** [9d Jc 7s] [4c]
s70n3fac3: checks 
FDIBA2009: bets 378
s70n3fac3: calls 378
*** RIVER *** [9d Jc 7s 4c] [Ks]
s70n3fac3: checks 
FDIBA2009: checks 
*** SHOW DOWN ***
s70n3fac3: shows [Kh 7d] (two pair, Kings and Sevens)
FDIBA2009: mucks hand 
s70n3fac3 collected 1092 from pot
*** SUMMARY ***
Total pot 1156 | Rake 64 
Board [9d Jc 7s 4c Ks]
Seat 1: s70n3fac3 (big blind) showed [Kh 7d] and won (1092) with two pair, Kings and Sevens
Seat 2: FDIBA2009 (button) (small blind) mucked [5c 2c]



PokerStars Home Game Hand #227252602956: {Club #4781089}  Hold'em No Limit (50/100) - 2021/06/02 0:55:00 EET [2021/06/01 17:55:00 ET]
Table 'VTPP NLHE 0106' 2-max (Play Money) Seat #1 is the button
Seat 1: s70n3fac3 (16261 in chips) 
Seat 2: FDIBA2009 (8502 in chips) 
s70n3fac3: posts small blind 50
FDIBA2009: posts big blind 100
*** HOLE CARDS ***
s70n3fac3: raises 150 to 250
FDIBA2009: calls 150
*** FLOP *** [5d 5s 6c]
FDIBA2009: checks 
s70n3fac3: checks 
*** TURN *** [5d 5s 6c] [6h]
FDIBA2009: bets 472
s70n3fac3: calls 472
*** RIVER *** [5d 5s 6c 6h] [Jc]
FDIBA2009: bets 1365
s70n3fac3: folds 
Uncalled bet (1365) returned to FDIBA2009
FDIBA2009 collected 1365 from pot
FDIBA2009: doesn't show hand 
*** SUMMARY ***
Total pot 1444 | Rake 79 
Board [5d 5s 6c 6h Jc]
Seat 1: s70n3fac3 (button) (small blind) folded on the River
Seat 2: FDIBA2009 (big blind) collected (1365)



PokerStars Home Game Hand #227252610929: {Club #4781089}  Hold'em No Limit (50/100) - 2021/06/02 0:55:22 EET [2021/06/01 17:55:22 ET]
Table 'VTPP NLHE 0106' 2-max (Play Money) Seat #2 is the button
Seat 1: s70n3fac3 (15539 in chips) 
Seat 2: FDIBA2009 (9145 in chips) 
FDIBA2009: posts small blind 50
s70n3fac3: posts big blind 100
*** HOLE CARDS ***
FDIBA2009: raises 100 to 200
s70n3fac3: folds 
Uncalled bet (100) returned to FDIBA2009
FDIBA2009 collected 200 from pot
FDIBA2009: doesn't show hand 
*** SUMMARY ***
Total pot 200 | Rake 0 
Seat 1: s70n3fac3 (big blind) folded before Flop
Seat 2: FDIBA2009 (button) (small blind) collected (200)



PokerStars Home Game Hand #227252612986: {Club #4781089}  Hold'em No Limit (50/100) - 2021/06/02 0:55:28 EET [2021/06/01 17:55:28 ET]
Table 'VTPP NLHE 0106' 2-max (Play Money) Seat #1 is the button
Seat 1: s70n3fac3 (15439 in chips) 
Seat 2: FDIBA2009 (9245 in chips) 
s70n3fac3: posts small blind 50
FDIBA2009: posts big blind 100
*** HOLE CARDS ***
s70n3fac3: raises 150 to 250
FDIBA2009: raises 500 to 750
s70n3fac3: calls 500
*** FLOP *** [Td Ad 4s]
FDIBA2009: bets 1417
s70n3fac3: folds 
Uncalled bet (1417) returned to FDIBA2009
FDIBA2009 collected 1417 from pot
FDIBA2009: doesn't show hand 
*** SUMMARY ***
Total pot 1500 | Rake 83 
Board [Td Ad 4s]
Seat 1: s70n3fac3 (button) (small blind) folded on the Flop
Seat 2: FDIBA2009 (big blind) collected (1417)



PokerStars Home Game Hand #227252616972: {Club #4781089}  Hold'em No Limit (50/100) - 2021/06/02 0:55:40 EET [2021/06/01 17:55:40 ET]
Table 'VTPP NLHE 0106' 2-max (Play Money) Seat #2 is the button
Seat 1: s70n3fac3 (14689 in chips) 
Seat 2: FDIBA2009 (9912 in chips) 
FDIBA2009: posts small blind 50
s70n3fac3: posts big blind 100
*** HOLE CARDS ***
FDIBA2009: raises 200 to 300
s70n3fac3: calls 200
*** FLOP *** [5c 6h Kh]
s70n3fac3: checks 
FDIBA2009: bets 567
s70n3fac3: calls 567
*** TURN *** [5c 6h Kh] [4d]
s70n3fac3: checks 
FDIBA2009: checks 
*** RIVER *** [5c 6h Kh 4d] [8s]
s70n3fac3: checks 
FDIBA2009: checks 
*** SHOW DOWN ***
s70n3fac3: shows [6d As] (a pair of Sixes)
FDIBA2009: mucks hand 
s70n3fac3 collected 1639 from pot
*** SUMMARY ***
Total pot 1734 | Rake 95 
Board [5c 6h Kh 4d 8s]
Seat 1: s70n3fac3 (big blind) showed [6d As] and won (1639) with a pair of Sixes
Seat 2: FDIBA2009 (button) (small blind) mucked [Tc Qh]



PokerStars Home Game Hand #227252623156: {Club #4781089}  Hold'em No Limit (50/100) - 2021/06/02 0:55:58 EET [2021/06/01 17:55:58 ET]
Table 'VTPP NLHE 0106' 2-max (Play Money) Seat #1 is the button
Seat 1: s70n3fac3 (15461 in chips) 
Seat 2: FDIBA2009 (9045 in chips) 
s70n3fac3: posts small blind 50
FDIBA2009: posts big blind 100
*** HOLE CARDS ***
s70n3fac3: raises 150 to 250
FDIBA2009: raises 8795 to 9045 and is all-in
s70n3fac3: folds 
Uncalled bet (8795) returned to FDIBA2009
FDIBA2009 collected 500 from pot
FDIBA2009: doesn't show hand 
*** SUMMARY ***
Total pot 500 | Rake 0 
Seat 1: s70n3fac3 (button) (small blind) folded before Flop
Seat 2: FDIBA2009 (big blind) collected (500)



PokerStars Home Game Hand #227252625941: {Club #4781089}  Hold'em No Limit (50/100) - 2021/06/02 0:56:06 EET [2021/06/01 17:56:06 ET]
Table 'VTPP NLHE 0106' 2-max (Play Money) Seat #2 is the button
Seat 1: s70n3fac3 (15211 in chips) 
Seat 2: FDIBA2009 (9295 in chips) 
FDIBA2009: posts small blind 50
s70n3fac3: posts big blind 100
*** HOLE CARDS ***
FDIBA2009: raises 200 to 300
s70n3fac3: folds 
Uncalled bet (200) returned to FDIBA2009
FDIBA2009 collected 200 from pot
FDIBA2009: doesn't show hand 
*** SUMMARY ***
Total pot 200 | Rake 0 
Seat 1: s70n3fac3 (big blind) folded before Flop
Seat 2: FDIBA2009 (button) (small blind) collected (200)



PokerStars Home Game Hand #227252628352: {Club #4781089}  Hold'em No Limit (50/100) - 2021/06/02 0:56:13 EET [2021/06/01 17:56:13 ET]
Table 'VTPP NLHE 0106' 2-max (Play Money) Seat #1 is the button
Seat 1: s70n3fac3 (15111 in chips) 
Seat 2: FDIBA2009 (9395 in chips) 
s70n3fac3: posts small blind 50
FDIBA2009: posts big blind 100
*** HOLE CARDS ***
s70n3fac3: raises 150 to 250
FDIBA2009: calls 150
*** FLOP *** [6c Qc 2d]
FDIBA2009: checks 
s70n3fac3: bets 300
FDIBA2009: folds 
Uncalled bet (300) returned to s70n3fac3
s70n3fac3 collected 472 from pot
s70n3fac3: doesn't show hand 
*** SUMMARY ***
Total pot 500 | Rake 28 
Board [6c Qc 2d]
Seat 1: s70n3fac3 (button) (small blind) collected (472)
Seat 2: FDIBA2009 (big blind) folded on the Flop



PokerStars Home Game Hand #227252631742: {Club #4781089}  Hold'em No Limit (50/100) - 2021/06/02 0:56:23 EET [2021/06/01 17:56:23 ET]
Table 'VTPP NLHE 0106' 2-max (Play Money) Seat #2 is the button
Seat 1: s70n3fac3 (15333 in chips) 
Seat 2: FDIBA2009 (9145 in chips) 
FDIBA2009: posts small blind 50
s70n3fac3: posts big blind 100
*** HOLE CARDS ***
FDIBA2009: folds 
Uncalled bet (50) returned to s70n3fac3
s70n3fac3 collected 100 from pot
s70n3fac3: doesn't show hand 
*** SUMMARY ***
Total pot 100 | Rake 0 
Seat 1: s70n3fac3 (big blind) collected (100)
Seat 2: FDIBA2009 (button) (small blind) folded before Flop



PokerStars Home Game Hand #227252633613: {Club #4781089}  Hold'em No Limit (50/100) - 2021/06/02 0:56:28 EET [2021/06/01 17:56:28 ET]
Table 'VTPP NLHE 0106' 2-max (Play Money) Seat #1 is the button
Seat 1: s70n3fac3 (15383 in chips) 
Seat 2: FDIBA2009 (9095 in chips) 
s70n3fac3: posts small blind 50
FDIBA2009: posts big blind 100
*** HOLE CARDS ***
s70n3fac3: calls 50
FDIBA2009: checks 
*** FLOP *** [Ah Qc 8d]
FDIBA2009: checks 
s70n3fac3: bets 200
FDIBA2009: calls 200
*** TURN *** [Ah Qc 8d] [Jh]
FDIBA2009: checks 
s70n3fac3: checks 
*** RIVER *** [Ah Qc 8d Jh] [3h]
FDIBA2009: checks 
s70n3fac3: checks 
*** SHOW DOWN ***
FDIBA2009: shows [4c Qd] (a pair of Queens)
s70n3fac3: mucks hand 
FDIBA2009 collected 567 from pot
*** SUMMARY ***
Total pot 600 | Rake 33 
Board [Ah Qc 8d Jh 3h]
Seat 1: s70n3fac3 (button) (small blind) mucked [5d 6c]
Seat 2: FDIBA2009 (big blind) showed [4c Qd] and won (567) with a pair of Queens



PokerStars Home Game Hand #227252639444: {Club #4781089}  Hold'em No Limit (50/100) - 2021/06/02 0:56:45 EET [2021/06/01 17:56:45 ET]
Table 'VTPP NLHE 0106' 2-max (Play Money) Seat #2 is the button
Seat 1: s70n3fac3 (15083 in chips) 
Seat 2: FDIBA2009 (9362 in chips) 
FDIBA2009: posts small blind 50
s70n3fac3: posts big blind 100
*** HOLE CARDS ***
FDIBA2009: raises 200 to 300
s70n3fac3: folds 
Uncalled bet (200) returned to FDIBA2009
FDIBA2009 collected 200 from pot
FDIBA2009: doesn't show hand 
*** SUMMARY ***
Total pot 200 | Rake 0 
Seat 1: s70n3fac3 (big blind) folded before Flop
Seat 2: FDIBA2009 (button) (small blind) collected (200)



PokerStars Home Game Hand #227252641648: {Club #4781089}  Hold'em No Limit (50/100) - 2021/06/02 0:56:51 EET [2021/06/01 17:56:51 ET]
Table 'VTPP NLHE 0106' 2-max (Play Money) Seat #1 is the button
Seat 1: s70n3fac3 (14983 in chips) 
Seat 2: FDIBA2009 (9462 in chips) 
s70n3fac3: posts small blind 50
FDIBA2009: posts big blind 100
*** HOLE CARDS ***
s70n3fac3: raises 150 to 250
FDIBA2009: calls 150
*** FLOP *** [7d 8s 5c]
FDIBA2009: checks 
s70n3fac3: checks 
*** TURN *** [7d 8s 5c] [Ad]
FDIBA2009: checks 
s70n3fac3: checks 
*** RIVER *** [7d 8s 5c Ad] [8h]
FDIBA2009: checks 
s70n3fac3: bets 300
FDIBA2009: calls 300
*** SHOW DOWN ***
s70n3fac3: shows [Ah Th] (two pair, Aces and Eights)
FDIBA2009: mucks hand 
s70n3fac3 collected 1039 from pot
*** SUMMARY ***
Total pot 1100 | Rake 61 
Board [7d 8s 5c Ad 8h]
Seat 1: s70n3fac3 (button) (small blind) showed [Ah Th] and won (1039) with two pair, Aces and Eights
Seat 2: FDIBA2009 (big blind) mucked [7s 4c]



PokerStars Home Game Hand #227252647183: {Club #4781089}  Hold'em No Limit (50/100) - 2021/06/02 0:57:07 EET [2021/06/01 17:57:07 ET]
Table 'VTPP NLHE 0106' 2-max (Play Money) Seat #2 is the button
Seat 1: s70n3fac3 (15472 in chips) 
Seat 2: FDIBA2009 (8912 in chips) 
FDIBA2009: posts small blind 50
s70n3fac3: posts big blind 100
*** HOLE CARDS ***
FDIBA2009: raises 200 to 300
s70n3fac3: calls 200
*** FLOP *** [Kd 9d 7d]
s70n3fac3: checks 
FDIBA2009: checks 
*** TURN *** [Kd 9d 7d] [Tc]
s70n3fac3: checks 
FDIBA2009: checks 
*** RIVER *** [Kd 9d 7d Tc] [6d]
s70n3fac3: bets 300
FDIBA2009: calls 300
*** SHOW DOWN ***
s70n3fac3: shows [8h 8d] (a flush, King high)
FDIBA2009: mucks hand 
s70n3fac3 collected 1134 from pot
*** SUMMARY ***
Total pot 1200 | Rake 66 
Board [Kd 9d 7d Tc 6d]
Seat 1: s70n3fac3 (big blind) showed [8h 8d] and won (1134) with a flush, King high
Seat 2: FDIBA2009 (button) (small blind) mucked [Ah 5d]



PokerStars Home Game Hand #227252652701: {Club #4781089}  Hold'em No Limit (50/100) - 2021/06/02 0:57:23 EET [2021/06/01 17:57:23 ET]
Table 'VTPP NLHE 0106' 2-max (Play Money) Seat #1 is the button
Seat 1: s70n3fac3 (16006 in chips) 
Seat 2: FDIBA2009 (8312 in chips) 
s70n3fac3: posts small blind 50
FDIBA2009: posts big blind 100
*** HOLE CARDS ***
s70n3fac3: calls 50
FDIBA2009: checks 
*** FLOP *** [Th Td 6c]
FDIBA2009: checks 
s70n3fac3: checks 
*** TURN *** [Th Td 6c] [Qh]
FDIBA2009: checks 
s70n3fac3: checks 
*** RIVER *** [Th Td 6c Qh] [2d]
FDIBA2009: bets 189
s70n3fac3: raises 611 to 800
FDIBA2009: folds 
Uncalled bet (611) returned to s70n3fac3
s70n3fac3 collected 546 from pot
s70n3fac3: doesn't show hand 
*** SUMMARY ***
Total pot 578 | Rake 32 
Board [Th Td 6c Qh 2d]
Seat 1: s70n3fac3 (button) (small blind) collected (546)
Seat 2: FDIBA2009 (big blind) folded on the River



PokerStars Home Game Hand #227252661223: {Club #4781089}  Hold'em No Limit (50/100) - 2021/06/02 0:57:48 EET [2021/06/01 17:57:48 ET]
Table 'VTPP NLHE 0106' 2-max (Play Money) Seat #2 is the button
Seat 1: s70n3fac3 (16263 in chips) 
Seat 2: FDIBA2009 (8023 in chips) 
FDIBA2009: posts small blind 50
s70n3fac3: posts big blind 100
*** HOLE CARDS ***
FDIBA2009: raises 200 to 300
s70n3fac3: folds 
Uncalled bet (200) returned to FDIBA2009
FDIBA2009 collected 200 from pot
FDIBA2009: doesn't show hand 
*** SUMMARY ***
Total pot 200 | Rake 0 
Seat 1: s70n3fac3 (big blind) folded before Flop
Seat 2: FDIBA2009 (button) (small blind) collected (200)



PokerStars Home Game Hand #227252663429: {Club #4781089}  Hold'em No Limit (50/100) - 2021/06/02 0:57:54 EET [2021/06/01 17:57:54 ET]
Table 'VTPP NLHE 0106' 2-max (Play Money) Seat #1 is the button
Seat 1: s70n3fac3 (16163 in chips) 
Seat 2: FDIBA2009 (8123 in chips) 
s70n3fac3: posts small blind 50
FDIBA2009: posts big blind 100
*** HOLE CARDS ***
s70n3fac3: raises 150 to 250
FDIBA2009: raises 500 to 750
s70n3fac3: calls 500
*** FLOP *** [4c 2s 5c]
FDIBA2009: checks 
s70n3fac3: bets 700
FDIBA2009: calls 700
*** TURN *** [4c 2s 5c] [6h]
FDIBA2009: checks 
s70n3fac3: bets 1300
FDIBA2009: folds 
Uncalled bet (1300) returned to s70n3fac3
s70n3fac3 collected 2740 from pot
s70n3fac3: doesn't show hand 
*** SUMMARY ***
Total pot 2900 | Rake 160 
Board [4c 2s 5c 6h]
Seat 1: s70n3fac3 (button) (small blind) collected (2740)
Seat 2: FDIBA2009 (big blind) folded on the Turn



PokerStars Home Game Hand #227252670606: {Club #4781089}  Hold'em No Limit (50/100) - 2021/06/02 0:58:14 EET [2021/06/01 17:58:14 ET]
Table 'VTPP NLHE 0106' 2-max (Play Money) Seat #2 is the button
Seat 1: s70n3fac3 (17453 in chips) 
Seat 2: FDIBA2009 (6673 in chips) 
FDIBA2009: posts small blind 50
s70n3fac3: posts big blind 100
*** HOLE CARDS ***
FDIBA2009: raises 200 to 300
s70n3fac3: calls 200
*** FLOP *** [As 5c Jc]
s70n3fac3: checks 
FDIBA2009: bets 567
s70n3fac3: folds 
Uncalled bet (567) returned to FDIBA2009
FDIBA2009 collected 567 from pot
FDIBA2009: doesn't show hand 
*** SUMMARY ***
Total pot 600 | Rake 33 
Board [As 5c Jc]
Seat 1: s70n3fac3 (big blind) folded on the Flop
Seat 2: FDIBA2009 (button) (small blind) collected (567)



PokerStars Home Game Hand #227252674465: {Club #4781089}  Hold'em No Limit (50/100) - 2021/06/02 0:58:26 EET [2021/06/01 17:58:26 ET]
Table 'VTPP NLHE 0106' 2-max (Play Money) Seat #1 is the button
Seat 1: s70n3fac3 (17153 in chips) 
Seat 2: FDIBA2009 (6940 in chips) 
s70n3fac3: posts small blind 50
FDIBA2009: posts big blind 100
*** HOLE CARDS ***
s70n3fac3: calls 50
FDIBA2009: raises 200 to 300
s70n3fac3: calls 200
*** FLOP *** [Ah Th 6c]
FDIBA2009: bets 567
s70n3fac3: folds 
Uncalled bet (567) returned to FDIBA2009
FDIBA2009 collected 567 from pot
FDIBA2009: doesn't show hand 
*** SUMMARY ***
Total pot 600 | Rake 33 
Board [Ah Th 6c]
Seat 1: s70n3fac3 (button) (small blind) folded on the Flop
Seat 2: FDIBA2009 (big blind) collected (567)



PokerStars Home Game Hand #227252678237: {Club #4781089}  Hold'em No Limit (50/100) - 2021/06/02 0:58:36 EET [2021/06/01 17:58:36 ET]
Table 'VTPP NLHE 0106' 2-max (Play Money) Seat #2 is the button
Seat 1: s70n3fac3 (16853 in chips) 
Seat 2: FDIBA2009 (7207 in chips) 
FDIBA2009: posts small blind 50
s70n3fac3: posts big blind 100
*** HOLE CARDS ***
FDIBA2009: raises 200 to 300
s70n3fac3: calls 200
*** FLOP *** [8s 7s 4s]
s70n3fac3: checks 
FDIBA2009: bets 567
s70n3fac3: calls 567
*** TURN *** [8s 7s 4s] [Jh]
s70n3fac3: checks 
FDIBA2009: bets 1639
s70n3fac3: calls 1639
*** RIVER *** [8s 7s 4s Jh] [2s]
s70n3fac3: checks 
FDIBA2009: checks 
*** SHOW DOWN ***
s70n3fac3: shows [Kh 8c] (a pair of Eights)
FDIBA2009: shows [9s Ac] (a flush, Nine high)
FDIBA2009 collected 4736 from pot
*** SUMMARY ***
Total pot 5012 | Rake 276 
Board [8s 7s 4s Jh 2s]
Seat 1: s70n3fac3 (big blind) showed [Kh 8c] and lost with a pair of Eights
Seat 2: FDIBA2009 (button) (small blind) showed [9s Ac] and won (4736) with a flush, Nine high



PokerStars Home Game Hand #227252686204: {Club #4781089}  Hold'em No Limit (50/100) - 2021/06/02 0:58:59 EET [2021/06/01 17:58:59 ET]
Table 'VTPP NLHE 0106' 2-max (Play Money) Seat #1 is the button
Seat 1: s70n3fac3 (14347 in chips) 
Seat 2: FDIBA2009 (9437 in chips) 
s70n3fac3: posts small blind 50
FDIBA2009: posts big blind 100
*** HOLE CARDS ***
s70n3fac3: folds 
Uncalled bet (50) returned to FDIBA2009
FDIBA2009 collected 100 from pot
FDIBA2009: doesn't show hand 
*** SUMMARY ***
Total pot 100 | Rake 0 
Seat 1: s70n3fac3 (button) (small blind) folded before Flop
Seat 2: FDIBA2009 (big blind) collected (100)



PokerStars Home Game Hand #227252687553: {Club #4781089}  Hold'em No Limit (50/100) - 2021/06/02 0:59:03 EET [2021/06/01 17:59:03 ET]
Table 'VTPP NLHE 0106' 2-max (Play Money) Seat #2 is the button
Seat 1: s70n3fac3 (14297 in chips) 
Seat 2: FDIBA2009 (9487 in chips) 
FDIBA2009: posts small blind 50
s70n3fac3: posts big blind 100
*** HOLE CARDS ***
FDIBA2009: raises 200 to 300
s70n3fac3: calls 200
*** FLOP *** [7c 8d 2s]
s70n3fac3: checks 
FDIBA2009: bets 567
s70n3fac3: calls 567
*** TURN *** [7c 8d 2s] [3h]
s70n3fac3: checks 
FDIBA2009: bets 1639
s70n3fac3: folds 
Uncalled bet (1639) returned to FDIBA2009
FDIBA2009 collected 1639 from pot
FDIBA2009: doesn't show hand 
*** SUMMARY ***
Total pot 1734 | Rake 95 
Board [7c 8d 2s 3h]
Seat 1: s70n3fac3 (big blind) folded on the Turn
Seat 2: FDIBA2009 (button) (small blind) collected (1639)



PokerStars Home Game Hand #227252693595: {Club #4781089}  Hold'em No Limit (50/100) - 2021/06/02 0:59:19 EET [2021/06/01 17:59:19 ET]
Table 'VTPP NLHE 0106' 2-max (Play Money) Seat #1 is the button
Seat 1: s70n3fac3 (13430 in chips) 
Seat 2: FDIBA2009 (10259 in chips) 
s70n3fac3: posts small blind 50
FDIBA2009: posts big blind 100
*** HOLE CARDS ***
s70n3fac3: raises 150 to 250
FDIBA2009: calls 150
*** FLOP *** [4d Ks Ac]
FDIBA2009: checks 
s70n3fac3: bets 300
FDIBA2009: folds 
Uncalled bet (300) returned to s70n3fac3
s70n3fac3 collected 472 from pot
s70n3fac3: doesn't show hand 
*** SUMMARY ***
Total pot 500 | Rake 28 
Board [4d Ks Ac]
Seat 1: s70n3fac3 (button) (small blind) collected (472)
Seat 2: FDIBA2009 (big blind) folded on the Flop



PokerStars Home Game Hand #227252697124: {Club #4781089}  Hold'em No Limit (50/100) - 2021/06/02 0:59:29 EET [2021/06/01 17:59:29 ET]
Table 'VTPP NLHE 0106' 2-max (Play Money) Seat #2 is the button
Seat 1: s70n3fac3 (13652 in chips) 
Seat 2: FDIBA2009 (10009 in chips) 
FDIBA2009: posts small blind 50
s70n3fac3: posts big blind 100
*** HOLE CARDS ***
FDIBA2009: raises 100 to 200
s70n3fac3: calls 100
*** FLOP *** [Ad Ah 8d]
s70n3fac3: checks 
FDIBA2009: bets 378
s70n3fac3: folds 
Uncalled bet (378) returned to FDIBA2009
FDIBA2009 collected 378 from pot
FDIBA2009: doesn't show hand 
*** SUMMARY ***
Total pot 400 | Rake 22 
Board [Ad Ah 8d]
Seat 1: s70n3fac3 (big blind) folded on the Flop
Seat 2: FDIBA2009 (button) (small blind) collected (378)



PokerStars Home Game Hand #227252700495: {Club #4781089}  Hold'em No Limit (50/100) - 2021/06/02 0:59:39 EET [2021/06/01 17:59:39 ET]
Table 'VTPP NLHE 0106' 2-max (Play Money) Seat #1 is the button
Seat 1: s70n3fac3 (13452 in chips) 
Seat 2: FDIBA2009 (10187 in chips) 
s70n3fac3: posts small blind 50
FDIBA2009: posts big blind 100
*** HOLE CARDS ***
s70n3fac3: raises 150 to 250
FDIBA2009: calls 150
*** FLOP *** [6s Td 6h]
FDIBA2009: checks 
s70n3fac3: checks 
*** TURN *** [6s Td 6h] [Qd]
FDIBA2009: checks 
s70n3fac3: bets 300
FDIBA2009: folds 
Uncalled bet (300) returned to s70n3fac3
s70n3fac3 collected 472 from pot
s70n3fac3: doesn't show hand 
*** SUMMARY ***
Total pot 500 | Rake 28 
Board [6s Td 6h Qd]
Seat 1: s70n3fac3 (button) (small blind) collected (472)
Seat 2: FDIBA2009 (big blind) folded on the Turn



PokerStars Home Game Hand #227252704823: {Club #4781089}  Hold'em No Limit (50/100) - 2021/06/02 0:59:51 EET [2021/06/01 17:59:51 ET]
Table 'VTPP NLHE 0106' 2-max (Play Money) Seat #2 is the button
Seat 1: s70n3fac3 (13674 in chips) 
Seat 2: FDIBA2009 (9937 in chips) 
FDIBA2009: posts small blind 50
s70n3fac3: posts big blind 100
*** HOLE CARDS ***
FDIBA2009: folds 
Uncalled bet (50) returned to s70n3fac3
s70n3fac3 collected 100 from pot
s70n3fac3: doesn't show hand 
*** SUMMARY ***
Total pot 100 | Rake 0 
Seat 1: s70n3fac3 (big blind) collected (100)
Seat 2: FDIBA2009 (button) (small blind) folded before Flop



PokerStars Home Game Hand #227252706711: {Club #4781089}  Hold'em No Limit (50/100) - 2021/06/02 0:59:57 EET [2021/06/01 17:59:57 ET]
Table 'VTPP NLHE 0106' 2-max (Play Money) Seat #1 is the button
Seat 1: s70n3fac3 (13724 in chips) 
Seat 2: FDIBA2009 (9887 in chips) 
s70n3fac3: posts small blind 50
FDIBA2009: posts big blind 100
*** HOLE CARDS ***
s70n3fac3: folds 
Uncalled bet (50) returned to FDIBA2009
FDIBA2009 collected 100 from pot
FDIBA2009: doesn't show hand 
*** SUMMARY ***
Total pot 100 | Rake 0 
Seat 1: s70n3fac3 (button) (small blind) folded before Flop
Seat 2: FDIBA2009 (big blind) collected (100)



PokerStars Home Game Hand #227252707966: {Club #4781089}  Hold'em No Limit (50/100) - 2021/06/02 1:00:01 EET [2021/06/01 18:00:01 ET]
Table 'VTPP NLHE 0106' 2-max (Play Money) Seat #2 is the button
Seat 1: s70n3fac3 (13674 in chips) 
Seat 2: FDIBA2009 (9937 in chips) 
FDIBA2009: posts small blind 50
s70n3fac3: posts big blind 100
*** HOLE CARDS ***
FDIBA2009: raises 200 to 300
s70n3fac3: calls 200
*** FLOP *** [8c 4d 6h]
s70n3fac3: checks 
FDIBA2009: bets 567
s70n3fac3: folds 
Uncalled bet (567) returned to FDIBA2009
FDIBA2009 collected 567 from pot
FDIBA2009: doesn't show hand 
*** SUMMARY ***
Total pot 600 | Rake 33 
Board [8c 4d 6h]
Seat 1: s70n3fac3 (big blind) folded on the Flop
Seat 2: FDIBA2009 (button) (small blind) collected (567)



PokerStars Home Game Hand #227252711818: {Club #4781089}  Hold'em No Limit (50/100) - 2021/06/02 1:00:11 EET [2021/06/01 18:00:11 ET]
Table 'VTPP NLHE 0106' 2-max (Play Money) Seat #1 is the button
Seat 1: s70n3fac3 (13374 in chips) 
Seat 2: FDIBA2009 (10204 in chips) 
s70n3fac3: posts small blind 50
FDIBA2009: posts big blind 100
*** HOLE CARDS ***
s70n3fac3: calls 50
FDIBA2009: checks 
*** FLOP *** [3h 9d 7s]
FDIBA2009: checks 
s70n3fac3: checks 
*** TURN *** [3h 9d 7s] [Kc]
FDIBA2009: checks 
s70n3fac3: checks 
*** RIVER *** [3h 9d 7s Kc] [2h]
FDIBA2009: bets 189
s70n3fac3: raises 711 to 900
FDIBA2009: folds 
Uncalled bet (711) returned to s70n3fac3
s70n3fac3 collected 546 from pot
s70n3fac3: doesn't show hand 
*** SUMMARY ***
Total pot 578 | Rake 32 
Board [3h 9d 7s Kc 2h]
Seat 1: s70n3fac3 (button) (small blind) collected (546)
Seat 2: FDIBA2009 (big blind) folded on the River



PokerStars Home Game Hand #227252718243: {Club #4781089}  Hold'em No Limit (50/100) - 2021/06/02 1:00:29 EET [2021/06/01 18:00:29 ET]
Table 'VTPP NLHE 0106' 2-max (Play Money) Seat #2 is the button
Seat 1: s70n3fac3 (13631 in chips) 
Seat 2: FDIBA2009 (9915 in chips) 
FDIBA2009: posts small blind 50
s70n3fac3: posts big blind 100
*** HOLE CARDS ***
FDIBA2009: raises 200 to 300
s70n3fac3: raises 700 to 1000
FDIBA2009: folds 
Uncalled bet (700) returned to s70n3fac3
s70n3fac3 collected 600 from pot
s70n3fac3: doesn't show hand 
*** SUMMARY ***
Total pot 600 | Rake 0 
Seat 1: s70n3fac3 (big blind) collected (600)
Seat 2: FDIBA2009 (button) (small blind) folded before Flop



PokerStars Home Game Hand #227252730341: {Club #4781089}  Hold'em No Limit (50/100) - 2021/06/02 1:00:38 EET [2021/06/01 18:00:38 ET]
Table 'VTPP NLHE 0106' 2-max (Play Money) Seat #1 is the button
Seat 1: s70n3fac3 (13931 in chips) 
Seat 2: FDIBA2009 (9615 in chips) 
s70n3fac3: posts small blind 50
FDIBA2009: posts big blind 100
*** HOLE CARDS ***
s70n3fac3: folds 
Uncalled bet (50) returned to FDIBA2009
FDIBA2009 collected 100 from pot
FDIBA2009: doesn't show hand 
*** SUMMARY ***
Total pot 100 | Rake 0 
Seat 1: s70n3fac3 (button) (small blind) folded before Flop
Seat 2: FDIBA2009 (big blind) collected (100)



PokerStars Home Game Hand #227252731732: {Club #4781089}  Hold'em No Limit (50/100) - 2021/06/02 1:00:42 EET [2021/06/01 18:00:42 ET]
Table 'VTPP NLHE 0106' 2-max (Play Money) Seat #2 is the button
Seat 1: s70n3fac3 (13881 in chips) 
Seat 2: FDIBA2009 (9665 in chips) 
FDIBA2009: posts small blind 50
s70n3fac3: posts big blind 100
*** HOLE CARDS ***
FDIBA2009: raises 200 to 300
s70n3fac3: calls 200
*** FLOP *** [3c 8s 2d]
s70n3fac3: checks 
FDIBA2009: bets 567
s70n3fac3: calls 567
*** TURN *** [3c 8s 2d] [6d]
s70n3fac3: checks 
FDIBA2009: checks 
*** RIVER *** [3c 8s 2d 6d] [9d]
s70n3fac3: checks 
FDIBA2009: checks 
*** SHOW DOWN ***
s70n3fac3: shows [6h 5d] (a pair of Sixes)
FDIBA2009: mucks hand 
s70n3fac3 collected 1639 from pot
*** SUMMARY ***
Total pot 1734 | Rake 95 
Board [3c 8s 2d 6d 9d]
Seat 1: s70n3fac3 (big blind) showed [6h 5d] and won (1639) with a pair of Sixes
Seat 2: FDIBA2009 (button) (small blind) mucked [7s As]



PokerStars Home Game Hand #227252737742: {Club #4781089}  Hold'em No Limit (50/100) - 2021/06/02 1:00:57 EET [2021/06/01 18:00:57 ET]
Table 'VTPP NLHE 0106' 2-max (Play Money) Seat #1 is the button
Seat 1: s70n3fac3 (14653 in chips) 
Seat 2: FDIBA2009 (8798 in chips) 
s70n3fac3: posts small blind 50
FDIBA2009: posts big blind 100
*** HOLE CARDS ***
s70n3fac3: raises 150 to 250
FDIBA2009: raises 500 to 750
s70n3fac3: folds 
Uncalled bet (500) returned to FDIBA2009
FDIBA2009 collected 500 from pot
FDIBA2009: doesn't show hand 
*** SUMMARY ***
Total pot 500 | Rake 0 
Seat 1: s70n3fac3 (button) (small blind) folded before Flop
Seat 2: FDIBA2009 (big blind) collected (500)



PokerStars Home Game Hand #227252743415: {Club #4781089}  Hold'em No Limit (50/100) - 2021/06/02 1:01:11 EET [2021/06/01 18:01:11 ET]
Table 'VTPP NLHE 0106' 2-max (Play Money) Seat #2 is the button
Seat 1: s70n3fac3 (14403 in chips) 
Seat 2: FDIBA2009 (9048 in chips) 
FDIBA2009: posts small blind 50
s70n3fac3: posts big blind 100
*** HOLE CARDS ***
FDIBA2009: raises 100 to 200
s70n3fac3: calls 100
*** FLOP *** [8s 3c 2h]
s70n3fac3: checks 
FDIBA2009: checks 
*** TURN *** [8s 3c 2h] [Kh]
s70n3fac3: bets 200
FDIBA2009: calls 200
*** RIVER *** [8s 3c 2h Kh] [7c]
s70n3fac3: bets 500
FDIBA2009: folds 
Uncalled bet (500) returned to s70n3fac3
s70n3fac3 collected 756 from pot
s70n3fac3: doesn't show hand 
*** SUMMARY ***
Total pot 800 | Rake 44 
Board [8s 3c 2h Kh 7c]
Seat 1: s70n3fac3 (big blind) collected (756)
Seat 2: FDIBA2009 (button) (small blind) folded on the River



PokerStars Home Game Hand #227252749678: {Club #4781089}  Hold'em No Limit (50/100) - 2021/06/02 1:01:26 EET [2021/06/01 18:01:26 ET]
Table 'VTPP NLHE 0106' 2-max (Play Money) Seat #1 is the button
Seat 1: s70n3fac3 (14759 in chips) 
Seat 2: FDIBA2009 (8648 in chips) 
s70n3fac3: posts small blind 50
FDIBA2009: posts big blind 100
*** HOLE CARDS ***
s70n3fac3: folds 
Uncalled bet (50) returned to FDIBA2009
FDIBA2009 collected 100 from pot
FDIBA2009: doesn't show hand 
*** SUMMARY ***
Total pot 100 | Rake 0 
Seat 1: s70n3fac3 (button) (small blind) folded before Flop
Seat 2: FDIBA2009 (big blind) collected (100)



PokerStars Home Game Hand #227252751207: {Club #4781089}  Hold'em No Limit (50/100) - 2021/06/02 1:01:30 EET [2021/06/01 18:01:30 ET]
Table 'VTPP NLHE 0106' 2-max (Play Money) Seat #2 is the button
Seat 1: s70n3fac3 (14709 in chips) 
Seat 2: FDIBA2009 (8698 in chips) 
FDIBA2009: posts small blind 50
s70n3fac3: posts big blind 100
*** HOLE CARDS ***
FDIBA2009: raises 200 to 300
s70n3fac3: folds 
Uncalled bet (200) returned to FDIBA2009
FDIBA2009 collected 200 from pot
FDIBA2009: doesn't show hand 
*** SUMMARY ***
Total pot 200 | Rake 0 
Seat 1: s70n3fac3 (big blind) folded before Flop
Seat 2: FDIBA2009 (button) (small blind) collected (200)



PokerStars Home Game Hand #227252753830: {Club #4781089}  Hold'em No Limit (50/100) - 2021/06/02 1:01:37 EET [2021/06/01 18:01:37 ET]
Table 'VTPP NLHE 0106' 2-max (Play Money) Seat #1 is the button
Seat 1: s70n3fac3 (14609 in chips) 
Seat 2: FDIBA2009 (8798 in chips) 
s70n3fac3: posts small blind 50
FDIBA2009: posts big blind 100
*** HOLE CARDS ***
s70n3fac3: raises 150 to 250
FDIBA2009: raises 500 to 750
s70n3fac3: calls 500
*** FLOP *** [Kc 9h 7c]
FDIBA2009: bets 1417
s70n3fac3: folds 
Uncalled bet (1417) returned to FDIBA2009
FDIBA2009 collected 1417 from pot
FDIBA2009: doesn't show hand 
*** SUMMARY ***
Total pot 1500 | Rake 83 
Board [Kc 9h 7c]
Seat 1: s70n3fac3 (button) (small blind) folded on the Flop
Seat 2: FDIBA2009 (big blind) collected (1417)



PokerStars Home Game Hand #227252760102: {Club #4781089}  Hold'em No Limit (50/100) - 2021/06/02 1:01:51 EET [2021/06/01 18:01:51 ET]
Table 'VTPP NLHE 0106' 2-max (Play Money) Seat #2 is the button
Seat 1: s70n3fac3 (13859 in chips) 
Seat 2: FDIBA2009 (9465 in chips) 
FDIBA2009: posts small blind 50
s70n3fac3: posts big blind 100
*** HOLE CARDS ***
FDIBA2009: raises 100 to 200
s70n3fac3: folds 
Uncalled bet (100) returned to FDIBA2009
FDIBA2009 collected 200 from pot
FDIBA2009: doesn't show hand 
*** SUMMARY ***
Total pot 200 | Rake 0 
Seat 1: s70n3fac3 (big blind) folded before Flop
Seat 2: FDIBA2009 (button) (small blind) collected (200)



PokerStars Home Game Hand #227252762647: {Club #4781089}  Hold'em No Limit (50/100) - 2021/06/02 1:01:57 EET [2021/06/01 18:01:57 ET]
Table 'VTPP NLHE 0106' 2-max (Play Money) Seat #1 is the button
Seat 1: s70n3fac3 (13759 in chips) 
Seat 2: FDIBA2009 (9565 in chips) 
s70n3fac3: posts small blind 50
FDIBA2009: posts big blind 100
*** HOLE CARDS ***
s70n3fac3: raises 150 to 250
FDIBA2009: calls 150
*** FLOP *** [5s 8c 5c]
FDIBA2009: bets 472
s70n3fac3: folds 
Uncalled bet (472) returned to FDIBA2009
FDIBA2009 collected 472 from pot
FDIBA2009: doesn't show hand 
*** SUMMARY ***
Total pot 500 | Rake 28 
Board [5s 8c 5c]
Seat 1: s70n3fac3 (button) (small blind) folded on the Flop
Seat 2: FDIBA2009 (big blind) collected (472)



PokerStars Home Game Hand #227252766806: {Club #4781089}  Hold'em No Limit (50/100) - 2021/06/02 1:02:07 EET [2021/06/01 18:02:07 ET]
Table 'VTPP NLHE 0106' 2-max (Play Money) Seat #2 is the button
Seat 1: s70n3fac3 (13509 in chips) 
Seat 2: FDIBA2009 (9787 in chips) 
FDIBA2009: posts small blind 50
s70n3fac3: posts big blind 100
*** HOLE CARDS ***
FDIBA2009: raises 200 to 300
s70n3fac3: folds 
Uncalled bet (200) returned to FDIBA2009
FDIBA2009 collected 200 from pot
FDIBA2009: doesn't show hand 
*** SUMMARY ***
Total pot 200 | Rake 0 
Seat 1: s70n3fac3 (big blind) folded before Flop
Seat 2: FDIBA2009 (button) (small blind) collected (200)



PokerStars Home Game Hand #227252769419: {Club #4781089}  Hold'em No Limit (50/100) - 2021/06/02 1:02:13 EET [2021/06/01 18:02:13 ET]
Table 'VTPP NLHE 0106' 2-max (Play Money) Seat #1 is the button
Seat 1: s70n3fac3 (13409 in chips) 
Seat 2: FDIBA2009 (9887 in chips) 
s70n3fac3: posts small blind 50
FDIBA2009: posts big blind 100
*** HOLE CARDS ***
s70n3fac3: folds 
Uncalled bet (50) returned to FDIBA2009
FDIBA2009 collected 100 from pot
FDIBA2009: doesn't show hand 
*** SUMMARY ***
Total pot 100 | Rake 0 
Seat 1: s70n3fac3 (button) (small blind) folded before Flop
Seat 2: FDIBA2009 (big blind) collected (100)



PokerStars Home Game Hand #227252771178: {Club #4781089}  Hold'em No Limit (50/100) - 2021/06/02 1:02:17 EET [2021/06/01 18:02:17 ET]
Table 'VTPP NLHE 0106' 2-max (Play Money) Seat #2 is the button
Seat 1: s70n3fac3 (13359 in chips) 
Seat 2: FDIBA2009 (9937 in chips) 
FDIBA2009: posts small blind 50
s70n3fac3: posts big blind 100
*** HOLE CARDS ***
FDIBA2009: raises 200 to 300
s70n3fac3: folds 
Uncalled bet (200) returned to FDIBA2009
FDIBA2009 collected 200 from pot
FDIBA2009: doesn't show hand 
*** SUMMARY ***
Total pot 200 | Rake 0 
Seat 1: s70n3fac3 (big blind) folded before Flop
Seat 2: FDIBA2009 (button) (small blind) collected (200)



PokerStars Home Game Hand #227252773598: {Club #4781089}  Hold'em No Limit (50/100) - 2021/06/02 1:02:23 EET [2021/06/01 18:02:23 ET]
Table 'VTPP NLHE 0106' 2-max (Play Money) Seat #1 is the button
Seat 1: s70n3fac3 (13259 in chips) 
Seat 2: FDIBA2009 (10037 in chips) 
s70n3fac3: posts small blind 50
FDIBA2009: posts big blind 100
*** HOLE CARDS ***
s70n3fac3: folds 
Uncalled bet (50) returned to FDIBA2009
FDIBA2009 collected 100 from pot
FDIBA2009: doesn't show hand 
*** SUMMARY ***
Total pot 100 | Rake 0 
Seat 1: s70n3fac3 (button) (small blind) folded before Flop
Seat 2: FDIBA2009 (big blind) collected (100)



PokerStars Home Game Hand #227252775270: {Club #4781089}  Hold'em No Limit (50/100) - 2021/06/02 1:02:27 EET [2021/06/01 18:02:27 ET]
Table 'VTPP NLHE 0106' 2-max (Play Money) Seat #2 is the button
Seat 1: s70n3fac3 (13209 in chips) 
Seat 2: FDIBA2009 (10087 in chips) 
FDIBA2009: posts small blind 50
s70n3fac3: posts big blind 100
*** HOLE CARDS ***
FDIBA2009: raises 200 to 300
s70n3fac3: folds 
Uncalled bet (200) returned to FDIBA2009
FDIBA2009 collected 200 from pot
FDIBA2009: doesn't show hand 
*** SUMMARY ***
Total pot 200 | Rake 0 
Seat 1: s70n3fac3 (big blind) folded before Flop
Seat 2: FDIBA2009 (button) (small blind) collected (200)



PokerStars Home Game Hand #227252778124: {Club #4781089}  Hold'em No Limit (50/100) - 2021/06/02 1:02:33 EET [2021/06/01 18:02:33 ET]
Table 'VTPP NLHE 0106' 2-max (Play Money) Seat #1 is the button
Seat 1: s70n3fac3 (13109 in chips) 
Seat 2: FDIBA2009 (10187 in chips) 
s70n3fac3: posts small blind 50
FDIBA2009: posts big blind 100
*** HOLE CARDS ***
s70n3fac3: raises 150 to 250
FDIBA2009: calls 150
*** FLOP *** [Jh 4s 8d]
FDIBA2009: checks 
s70n3fac3: bets 300
FDIBA2009: calls 300
*** TURN *** [Jh 4s 8d] [3h]
FDIBA2009: checks 
s70n3fac3: bets 600
FDIBA2009: calls 600
*** RIVER *** [Jh 4s 8d 3h] [5h]
FDIBA2009: checks 
s70n3fac3: checks 
*** SHOW DOWN ***
FDIBA2009: shows [7d 9c] (high card Jack)
s70n3fac3: shows [3c 8c] (two pair, Eights and Threes)
s70n3fac3 collected 2173 from pot
*** SUMMARY ***
Total pot 2300 | Rake 127 
Board [Jh 4s 8d 3h 5h]
Seat 1: s70n3fac3 (button) (small blind) showed [3c 8c] and won (2173) with two pair, Eights and Threes
Seat 2: FDIBA2009 (big blind) showed [7d 9c] and lost with high card Jack



PokerStars Home Game Hand #227252789657: {Club #4781089}  Hold'em No Limit (50/100) - 2021/06/02 1:03:00 EET [2021/06/01 18:03:00 ET]
Table 'VTPP NLHE 0106' 2-max (Play Money) Seat #2 is the button
Seat 1: s70n3fac3 (14132 in chips) 
Seat 2: FDIBA2009 (9037 in chips) 
FDIBA2009: posts small blind 50
s70n3fac3: posts big blind 100
*** HOLE CARDS ***
FDIBA2009: raises 200 to 300
s70n3fac3: calls 200
*** FLOP *** [Kh Th 2c]
s70n3fac3: checks 
FDIBA2009: bets 567
s70n3fac3: calls 567
*** TURN *** [Kh Th 2c] [3d]
s70n3fac3: checks 
FDIBA2009: bets 1639
s70n3fac3: raises 2458 to 4097
FDIBA2009: folds 
Uncalled bet (2458) returned to s70n3fac3
s70n3fac3 collected 4736 from pot
s70n3fac3: doesn't show hand 
*** SUMMARY ***
Total pot 5012 | Rake 276 
Board [Kh Th 2c 3d]
Seat 1: s70n3fac3 (big blind) collected (4736)
Seat 2: FDIBA2009 (button) (small blind) folded on the Turn



PokerStars Home Game Hand #227252798422: {Club #4781089}  Hold'em No Limit (50/100) - 2021/06/02 1:03:20 EET [2021/06/01 18:03:20 ET]
Table 'VTPP NLHE 0106' 2-max (Play Money) Seat #1 is the button
Seat 1: s70n3fac3 (16362 in chips) 
Seat 2: FDIBA2009 (6531 in chips) 
s70n3fac3: posts small blind 50
FDIBA2009: posts big blind 100
*** HOLE CARDS ***
s70n3fac3: raises 150 to 250
FDIBA2009: calls 150
*** FLOP *** [Js Qd Ks]
FDIBA2009: checks 
s70n3fac3: bets 200
FDIBA2009: calls 200
*** TURN *** [Js Qd Ks] [4s]
FDIBA2009: checks 
s70n3fac3: bets 400
FDIBA2009: raises 400 to 800
s70n3fac3: calls 400
*** RIVER *** [Js Qd Ks 4s] [2s]
FDIBA2009: bets 2362
s70n3fac3: folds 
Uncalled bet (2362) returned to FDIBA2009
FDIBA2009 collected 2362 from pot
FDIBA2009: doesn't show hand 
*** SUMMARY ***
Total pot 2500 | Rake 138 
Board [Js Qd Ks 4s 2s]
Seat 1: s70n3fac3 (button) (small blind) folded on the River
Seat 2: FDIBA2009 (big blind) collected (2362)



PokerStars Home Game Hand #227252809632: {Club #4781089}  Hold'em No Limit (50/100) - 2021/06/02 1:03:46 EET [2021/06/01 18:03:46 ET]
Table 'VTPP NLHE 0106' 2-max (Play Money) Seat #2 is the button
Seat 1: s70n3fac3 (15112 in chips) 
Seat 2: FDIBA2009 (7643 in chips) 
FDIBA2009: posts small blind 50
s70n3fac3: posts big blind 100
*** HOLE CARDS ***
FDIBA2009: raises 200 to 300
s70n3fac3: folds 
Uncalled bet (200) returned to FDIBA2009
FDIBA2009 collected 200 from pot
FDIBA2009: doesn't show hand 
*** SUMMARY ***
Total pot 200 | Rake 0 
Seat 1: s70n3fac3 (big blind) folded before Flop
Seat 2: FDIBA2009 (button) (small blind) collected (200)



PokerStars Home Game Hand #227252812308: {Club #4781089}  Hold'em No Limit (50/100) - 2021/06/02 1:03:52 EET [2021/06/01 18:03:52 ET]
Table 'VTPP NLHE 0106' 2-max (Play Money) Seat #1 is the button
Seat 1: s70n3fac3 (15012 in chips) 
Seat 2: FDIBA2009 (7743 in chips) 
s70n3fac3: posts small blind 50
FDIBA2009: posts big blind 100
*** HOLE CARDS ***
s70n3fac3: calls 50
FDIBA2009: raises 200 to 300
s70n3fac3: calls 200
*** FLOP *** [Kh Kd 8s]
FDIBA2009: bets 567
s70n3fac3: folds 
Uncalled bet (567) returned to FDIBA2009
FDIBA2009 collected 567 from pot
FDIBA2009: doesn't show hand 
*** SUMMARY ***
Total pot 600 | Rake 33 
Board [Kh Kd 8s]
Seat 1: s70n3fac3 (button) (small blind) folded on the Flop
Seat 2: FDIBA2009 (big blind) collected (567)



PokerStars Home Game Hand #227252817154: {Club #4781089}  Hold'em No Limit (50/100) - 2021/06/02 1:04:04 EET [2021/06/01 18:04:04 ET]
Table 'VTPP NLHE 0106' 2-max (Play Money) Seat #2 is the button
Seat 1: s70n3fac3 (14712 in chips) 
Seat 2: FDIBA2009 (8010 in chips) 
FDIBA2009: posts small blind 50
s70n3fac3: posts big blind 100
*** HOLE CARDS ***
FDIBA2009: raises 200 to 300
s70n3fac3: calls 200
*** FLOP *** [3d 2c Ad]
s70n3fac3: checks 
FDIBA2009: bets 567
s70n3fac3: folds 
Uncalled bet (567) returned to FDIBA2009
FDIBA2009 collected 567 from pot
FDIBA2009: doesn't show hand 
*** SUMMARY ***
Total pot 600 | Rake 33 
Board [3d 2c Ad]
Seat 1: s70n3fac3 (big blind) folded on the Flop
Seat 2: FDIBA2009 (button) (small blind) collected (567)



PokerStars Home Game Hand #227252821609: {Club #4781089}  Hold'em No Limit (50/100) - 2021/06/02 1:04:14 EET [2021/06/01 18:04:14 ET]
Table 'VTPP NLHE 0106' 2-max (Play Money) Seat #1 is the button
Seat 1: s70n3fac3 (14412 in chips) 
Seat 2: FDIBA2009 (8277 in chips) 
s70n3fac3: posts small blind 50
FDIBA2009: posts big blind 100
*** HOLE CARDS ***
s70n3fac3: folds 
Uncalled bet (50) returned to FDIBA2009
FDIBA2009 collected 100 from pot
FDIBA2009: doesn't show hand 
*** SUMMARY ***
Total pot 100 | Rake 0 
Seat 1: s70n3fac3 (button) (small blind) folded before Flop
Seat 2: FDIBA2009 (big blind) collected (100)



PokerStars Home Game Hand #227252823247: {Club #4781089}  Hold'em No Limit (50/100) - 2021/06/02 1:04:18 EET [2021/06/01 18:04:18 ET]
Table 'VTPP NLHE 0106' 2-max (Play Money) Seat #2 is the button
Seat 1: s70n3fac3 (14362 in chips) 
Seat 2: FDIBA2009 (8327 in chips) 
FDIBA2009: posts small blind 50
s70n3fac3: posts big blind 100
*** HOLE CARDS ***
FDIBA2009: raises 200 to 300
s70n3fac3: calls 200
*** FLOP *** [Tc Qd 7h]
s70n3fac3: checks 
FDIBA2009: bets 567
s70n3fac3: folds 
Uncalled bet (567) returned to FDIBA2009
FDIBA2009 collected 567 from pot
FDIBA2009: doesn't show hand 
*** SUMMARY ***
Total pot 600 | Rake 33 
Board [Tc Qd 7h]
Seat 1: s70n3fac3 (big blind) folded on the Flop
Seat 2: FDIBA2009 (button) (small blind) collected (567)



PokerStars Home Game Hand #227252827747: {Club #4781089}  Hold'em No Limit (50/100) - 2021/06/02 1:04:28 EET [2021/06/01 18:04:28 ET]
Table 'VTPP NLHE 0106' 2-max (Play Money) Seat #1 is the button
Seat 1: s70n3fac3 (14062 in chips) 
Seat 2: FDIBA2009 (8594 in chips) 
s70n3fac3: posts small blind 50
FDIBA2009: posts big blind 100
*** HOLE CARDS ***
s70n3fac3: raises 150 to 250
FDIBA2009: folds 
Uncalled bet (150) returned to s70n3fac3
s70n3fac3 collected 200 from pot
s70n3fac3: doesn't show hand 
*** SUMMARY ***
Total pot 200 | Rake 0 
Seat 1: s70n3fac3 (button) (small blind) collected (200)
Seat 2: FDIBA2009 (big blind) folded before Flop



PokerStars Home Game Hand #227252830289: {Club #4781089}  Hold'em No Limit (50/100) - 2021/06/02 1:04:34 EET [2021/06/01 18:04:34 ET]
Table 'VTPP NLHE 0106' 2-max (Play Money) Seat #2 is the button
Seat 1: s70n3fac3 (14162 in chips) 
Seat 2: FDIBA2009 (8494 in chips) 
FDIBA2009: posts small blind 50
s70n3fac3: posts big blind 100
*** HOLE CARDS ***
FDIBA2009: raises 100 to 200
s70n3fac3: calls 100
*** FLOP *** [Ts 7c 8s]
s70n3fac3: checks 
FDIBA2009: checks 
*** TURN *** [Ts 7c 8s] [Th]
s70n3fac3: checks 
FDIBA2009: checks 
*** RIVER *** [Ts 7c 8s Th] [7d]
s70n3fac3: checks 
FDIBA2009: checks 
*** SHOW DOWN ***
s70n3fac3: shows [Qd 6h] (two pair, Tens and Sevens)
FDIBA2009: shows [Kd 3s] (two pair, Tens and Sevens - King kicker)
FDIBA2009 collected 378 from pot
*** SUMMARY ***
Total pot 400 | Rake 22 
Board [Ts 7c 8s Th 7d]
Seat 1: s70n3fac3 (big blind) showed [Qd 6h] and lost with two pair, Tens and Sevens
Seat 2: FDIBA2009 (button) (small blind) showed [Kd 3s] and won (378) with two pair, Tens and Sevens



PokerStars Home Game Hand #227252836286: {Club #4781089}  Hold'em No Limit (50/100) - 2021/06/02 1:04:48 EET [2021/06/01 18:04:48 ET]
Table 'VTPP NLHE 0106' 2-max (Play Money) Seat #1 is the button
Seat 1: s70n3fac3 (13962 in chips) 
Seat 2: FDIBA2009 (8672 in chips) 
s70n3fac3: posts small blind 50
FDIBA2009: posts big blind 100
*** HOLE CARDS ***
s70n3fac3: raises 150 to 250
FDIBA2009: raises 150 to 400
s70n3fac3: calls 150
*** FLOP *** [5c 2c 2h]
FDIBA2009: bets 756
s70n3fac3: folds 
Uncalled bet (756) returned to FDIBA2009
FDIBA2009 collected 756 from pot
FDIBA2009: doesn't show hand 
*** SUMMARY ***
Total pot 800 | Rake 44 
Board [5c 2c 2h]
Seat 1: s70n3fac3 (button) (small blind) folded on the Flop
Seat 2: FDIBA2009 (big blind) collected (756)



PokerStars Home Game Hand #227252842940: {Club #4781089}  Hold'em No Limit (50/100) - 2021/06/02 1:05:02 EET [2021/06/01 18:05:02 ET]
Table 'VTPP NLHE 0106' 2-max (Play Money) Seat #2 is the button
Seat 1: s70n3fac3 (13562 in chips) 
Seat 2: FDIBA2009 (9028 in chips) 
FDIBA2009: posts small blind 50
s70n3fac3: posts big blind 100
*** HOLE CARDS ***
FDIBA2009: raises 200 to 300
s70n3fac3: calls 200
*** FLOP *** [8c Qd 6d]
s70n3fac3: checks 
FDIBA2009: checks 
*** TURN *** [8c Qd 6d] [5h]
s70n3fac3: checks 
FDIBA2009: checks 
*** RIVER *** [8c Qd 6d 5h] [9h]
s70n3fac3: checks 
FDIBA2009: checks 
*** SHOW DOWN ***
s70n3fac3: shows [9c Ts] (a pair of Nines)
FDIBA2009: mucks hand 
s70n3fac3 collected 567 from pot
*** SUMMARY ***
Total pot 600 | Rake 33 
Board [8c Qd 6d 5h 9h]
Seat 1: s70n3fac3 (big blind) showed [9c Ts] and won (567) with a pair of Nines
Seat 2: FDIBA2009 (button) (small blind) mucked [6s 4s]



PokerStars Home Game Hand #227252852284: {Club #4781089}  Hold'em No Limit (50/100) - 2021/06/02 1:05:24 EET [2021/06/01 18:05:24 ET]
Table 'VTPP NLHE 0106' 2-max (Play Money) Seat #1 is the button
Seat 1: s70n3fac3 (13829 in chips) 
Seat 2: FDIBA2009 (8728 in chips) 
s70n3fac3: posts small blind 50
FDIBA2009: posts big blind 100
*** HOLE CARDS ***
s70n3fac3: calls 50
FDIBA2009: checks 
*** FLOP *** [3c 4s Jd]
FDIBA2009: checks 
s70n3fac3: checks 
*** TURN *** [3c 4s Jd] [Jh]
FDIBA2009: bets 189
s70n3fac3: calls 189
*** RIVER *** [3c 4s Jd Jh] [Jc]
FDIBA2009: checks 
s70n3fac3: checks 
*** SHOW DOWN ***
FDIBA2009: shows [6s 2d] (three of a kind, Jacks)
s70n3fac3: shows [7s 6d] (three of a kind, Jacks - Seven kicker)
s70n3fac3 collected 546 from pot
*** SUMMARY ***
Total pot 578 | Rake 32 
Board [3c 4s Jd Jh Jc]
Seat 1: s70n3fac3 (button) (small blind) showed [7s 6d] and won (546) with three of a kind, Jacks
Seat 2: FDIBA2009 (big blind) showed [6s 2d] and lost with three of a kind, Jacks



PokerStars Home Game Hand #227252861002: {Club #4781089}  Hold'em No Limit (50/100) - 2021/06/02 1:05:45 EET [2021/06/01 18:05:45 ET]
Table 'VTPP NLHE 0106' 2-max (Play Money) Seat #2 is the button
Seat 1: s70n3fac3 (14086 in chips) 
Seat 2: FDIBA2009 (8439 in chips) 
FDIBA2009: posts small blind 50
s70n3fac3: posts big blind 100
*** HOLE CARDS ***
FDIBA2009: raises 200 to 300
s70n3fac3: calls 200
*** FLOP *** [Ts 4c Qs]
s70n3fac3: checks 
FDIBA2009: bets 567
s70n3fac3: folds 
Uncalled bet (567) returned to FDIBA2009
FDIBA2009 collected 567 from pot
FDIBA2009: doesn't show hand 
*** SUMMARY ***
Total pot 600 | Rake 33 
Board [Ts 4c Qs]
Seat 1: s70n3fac3 (big blind) folded on the Flop
Seat 2: FDIBA2009 (button) (small blind) collected (567)



PokerStars Home Game Hand #227252865582: {Club #4781089}  Hold'em No Limit (50/100) - 2021/06/02 1:05:56 EET [2021/06/01 18:05:56 ET]
Table 'VTPP NLHE 0106' 2-max (Play Money) Seat #1 is the button
Seat 1: s70n3fac3 (13786 in chips) 
Seat 2: FDIBA2009 (8706 in chips) 
s70n3fac3: posts small blind 50
FDIBA2009: posts big blind 100
*** HOLE CARDS ***
s70n3fac3: raises 150 to 250
FDIBA2009: raises 500 to 750
s70n3fac3: calls 500
*** FLOP *** [4s 6s Jc]
FDIBA2009: bets 1417
s70n3fac3: folds 
Uncalled bet (1417) returned to FDIBA2009
FDIBA2009 collected 1417 from pot
FDIBA2009: doesn't show hand 
*** SUMMARY ***
Total pot 1500 | Rake 83 
Board [4s 6s Jc]
Seat 1: s70n3fac3 (button) (small blind) folded on the Flop
Seat 2: FDIBA2009 (big blind) collected (1417)



PokerStars Home Game Hand #227252870458: {Club #4781089}  Hold'em No Limit (50/100) - 2021/06/02 1:06:07 EET [2021/06/01 18:06:07 ET]
Table 'VTPP NLHE 0106' 2-max (Play Money) Seat #2 is the button
Seat 1: s70n3fac3 (13036 in chips) 
Seat 2: FDIBA2009 (9373 in chips) 
FDIBA2009: posts small blind 50
s70n3fac3: posts big blind 100
*** HOLE CARDS ***
FDIBA2009: raises 100 to 200
s70n3fac3: calls 100
*** FLOP *** [Td 4c Tc]
s70n3fac3: checks 
FDIBA2009: checks 
*** TURN *** [Td 4c Tc] [8c]
s70n3fac3: bets 200
FDIBA2009: calls 200
*** RIVER *** [Td 4c Tc 8c] [Qh]
s70n3fac3: checks 
FDIBA2009: bets 756
s70n3fac3: raises 1544 to 2300
FDIBA2009: folds 
Uncalled bet (1544) returned to s70n3fac3
s70n3fac3 collected 2185 from pot
s70n3fac3: doesn't show hand 
*** SUMMARY ***
Total pot 2312 | Rake 127 
Board [Td 4c Tc 8c Qh]
Seat 1: s70n3fac3 (big blind) collected (2185)
Seat 2: FDIBA2009 (button) (small blind) folded on the River



PokerStars Home Game Hand #227252880644: {Club #4781089}  Hold'em No Limit (50/100) - 2021/06/02 1:06:28 EET [2021/06/01 18:06:28 ET]
Table 'VTPP NLHE 0106' 2-max (Play Money) Seat #1 is the button
Seat 1: s70n3fac3 (14065 in chips) 
Seat 2: FDIBA2009 (8217 in chips) 
s70n3fac3: posts small blind 50
FDIBA2009: posts big blind 100
*** HOLE CARDS ***
s70n3fac3: folds 
Uncalled bet (50) returned to FDIBA2009
FDIBA2009 collected 100 from pot
FDIBA2009: doesn't show hand 
*** SUMMARY ***
Total pot 100 | Rake 0 
Seat 1: s70n3fac3 (button) (small blind) folded before Flop
Seat 2: FDIBA2009 (big blind) collected (100)



PokerStars Home Game Hand #227252891047: {Club #4781089}  Hold'em No Limit (50/100) - 2021/06/02 1:06:32 EET [2021/06/01 18:06:32 ET]
Table 'VTPP NLHE 0106' 2-max (Play Money) Seat #2 is the button
Seat 1: s70n3fac3 (14015 in chips) 
Seat 2: FDIBA2009 (8267 in chips) 
FDIBA2009: posts small blind 50
s70n3fac3: posts big blind 100
*** HOLE CARDS ***
FDIBA2009: raises 200 to 300
s70n3fac3: calls 200
*** FLOP *** [2c Kh 3c]
s70n3fac3: checks 
FDIBA2009: bets 567
s70n3fac3: calls 567
*** TURN *** [2c Kh 3c] [5s]
s70n3fac3: checks 
FDIBA2009: checks 
*** RIVER *** [2c Kh 3c 5s] [7d]
s70n3fac3: checks 
FDIBA2009: checks 
*** SHOW DOWN ***
s70n3fac3: shows [4d Kc] (a pair of Kings)
FDIBA2009: mucks hand 
s70n3fac3 collected 1639 from pot
*** SUMMARY ***
Total pot 1734 | Rake 95 
Board [2c Kh 3c 5s 7d]
Seat 1: s70n3fac3 (big blind) showed [4d Kc] and won (1639) with a pair of Kings
Seat 2: FDIBA2009 (button) (small blind) mucked [Qc 3h]



PokerStars Home Game Hand #227252898283: {Club #4781089}  Hold'em No Limit (50/100) - 2021/06/02 1:06:49 EET [2021/06/01 18:06:49 ET]
Table 'VTPP NLHE 0106' 2-max (Play Money) Seat #1 is the button
Seat 1: s70n3fac3 (14787 in chips) 
Seat 2: FDIBA2009 (7400 in chips) 
s70n3fac3: posts small blind 50
FDIBA2009: posts big blind 100
*** HOLE CARDS ***
s70n3fac3: folds 
Uncalled bet (50) returned to FDIBA2009
FDIBA2009 collected 100 from pot
FDIBA2009: doesn't show hand 
*** SUMMARY ***
Total pot 100 | Rake 0 
Seat 1: s70n3fac3 (button) (small blind) folded before Flop
Seat 2: FDIBA2009 (big blind) collected (100)



PokerStars Home Game Hand #227252899888: {Club #4781089}  Hold'em No Limit (50/100) - 2021/06/02 1:06:53 EET [2021/06/01 18:06:53 ET]
Table 'VTPP NLHE 0106' 2-max (Play Money) Seat #2 is the button
Seat 1: s70n3fac3 (14737 in chips) 
Seat 2: FDIBA2009 (7450 in chips) 
FDIBA2009: posts small blind 50
s70n3fac3: posts big blind 100
*** HOLE CARDS ***
FDIBA2009: raises 200 to 300
s70n3fac3: calls 200
*** FLOP *** [8h Td Ts]
s70n3fac3: checks 
FDIBA2009: bets 567
s70n3fac3: calls 567
*** TURN *** [8h Td Ts] [Js]
s70n3fac3: checks 
FDIBA2009: bets 1639
s70n3fac3: calls 1639
*** RIVER *** [8h Td Ts Js] [7d]
s70n3fac3: checks 
FDIBA2009: bets 4736
s70n3fac3: raises 4736 to 9472
FDIBA2009: calls 208 and is all-in
Uncalled bet (4528) returned to s70n3fac3
*** SHOW DOWN ***
s70n3fac3: shows [Jh 9d] (a straight, Seven to Jack)
FDIBA2009: shows [Qh 9s] (a straight, Eight to Queen)
FDIBA2009 collected 14080 from pot
*** SUMMARY ***
Total pot 14900 | Rake 820 
Board [8h Td Ts Js 7d]
Seat 1: s70n3fac3 (big blind) showed [Jh 9d] and lost with a straight, Seven to Jack
Seat 2: FDIBA2009 (button) (small blind) showed [Qh 9s] and won (14080) with a straight, Eight to Queen



PokerStars Home Game Hand #227252911202: {Club #4781089}  Hold'em No Limit (50/100) - 2021/06/02 1:07:19 EET [2021/06/01 18:07:19 ET]
Table 'VTPP NLHE 0106' 2-max (Play Money) Seat #1 is the button
Seat 1: s70n3fac3 (7287 in chips) 
Seat 2: FDIBA2009 (14080 in chips) 
s70n3fac3: posts small blind 50
FDIBA2009: posts big blind 100
*** HOLE CARDS ***
s70n3fac3: folds 
Uncalled bet (50) returned to FDIBA2009
FDIBA2009 collected 100 from pot
FDIBA2009: doesn't show hand 
*** SUMMARY ***
Total pot 100 | Rake 0 
Seat 1: s70n3fac3 (button) (small blind) folded before Flop
Seat 2: FDIBA2009 (big blind) collected (100)



PokerStars Home Game Hand #227252916900: {Club #4781089}  Hold'em No Limit (50/100) - 2021/06/02 1:07:32 EET [2021/06/01 18:07:32 ET]
Table 'VTPP NLHE 0106' 2-max (Play Money) Seat #2 is the button
Seat 1: s70n3fac3 (7237 in chips) 
Seat 2: FDIBA2009 (14130 in chips) 
FDIBA2009: posts small blind 50
s70n3fac3: posts big blind 100
*** HOLE CARDS ***
FDIBA2009: calls 50
s70n3fac3: checks 
*** FLOP *** [2c Js Ad]
s70n3fac3: checks 
FDIBA2009: checks 
*** TURN *** [2c Js Ad] [7d]
s70n3fac3: checks 
FDIBA2009: checks 
*** RIVER *** [2c Js Ad 7d] [6s]
s70n3fac3: bets 200
FDIBA2009: folds 
Uncalled bet (200) returned to s70n3fac3
s70n3fac3 collected 189 from pot
s70n3fac3: doesn't show hand 
*** SUMMARY ***
Total pot 200 | Rake 11 
Board [2c Js Ad 7d 6s]
Seat 1: s70n3fac3 (big blind) collected (189)
Seat 2: FDIBA2009 (button) (small blind) folded on the River



PokerStars Home Game Hand #227252924373: {Club #4781089}  Hold'em No Limit (50/100) - 2021/06/02 1:07:50 EET [2021/06/01 18:07:50 ET]
Table 'VTPP NLHE 0106' 2-max (Play Money) Seat #1 is the button
Seat 1: s70n3fac3 (7326 in chips) 
Seat 2: FDIBA2009 (14030 in chips) 
s70n3fac3: posts small blind 50
FDIBA2009: posts big blind 100
*** HOLE CARDS ***
s70n3fac3: raises 150 to 250
FDIBA2009: folds 
Uncalled bet (150) returned to s70n3fac3
s70n3fac3 collected 200 from pot
s70n3fac3: doesn't show hand 
*** SUMMARY ***
Total pot 200 | Rake 0 
Seat 1: s70n3fac3 (button) (small blind) collected (200)
Seat 2: FDIBA2009 (big blind) folded before Flop



PokerStars Home Game Hand #227252926411: {Club #4781089}  Hold'em No Limit (50/100) - 2021/06/02 1:07:55 EET [2021/06/01 18:07:55 ET]
Table 'VTPP NLHE 0106' 2-max (Play Money) Seat #2 is the button
Seat 1: s70n3fac3 (7426 in chips) 
Seat 2: FDIBA2009 (13930 in chips) 
FDIBA2009: posts small blind 50
s70n3fac3: posts big blind 100
*** HOLE CARDS ***
FDIBA2009: folds 
Uncalled bet (50) returned to s70n3fac3
s70n3fac3 collected 100 from pot
s70n3fac3: doesn't show hand 
*** SUMMARY ***
Total pot 100 | Rake 0 
Seat 1: s70n3fac3 (big blind) collected (100)
Seat 2: FDIBA2009 (button) (small blind) folded before Flop



PokerStars Home Game Hand #227252928577: {Club #4781089}  Hold'em No Limit (50/100) - 2021/06/02 1:07:59 EET [2021/06/01 18:07:59 ET]
Table 'VTPP NLHE 0106' 2-max (Play Money) Seat #1 is the button
Seat 1: s70n3fac3 (7476 in chips) 
Seat 2: FDIBA2009 (13880 in chips) 
s70n3fac3: posts small blind 50
FDIBA2009: posts big blind 100
*** HOLE CARDS ***
s70n3fac3: raises 150 to 250
FDIBA2009: calls 150
*** FLOP *** [7c 5c 5s]
FDIBA2009: checks 
s70n3fac3: checks 
*** TURN *** [7c 5c 5s] [5d]
FDIBA2009: bets 472
s70n3fac3: folds 
Uncalled bet (472) returned to FDIBA2009
FDIBA2009 collected 472 from pot
FDIBA2009: doesn't show hand 
*** SUMMARY ***
Total pot 500 | Rake 28 
Board [7c 5c 5s 5d]
Seat 1: s70n3fac3 (button) (small blind) folded on the Turn
Seat 2: FDIBA2009 (big blind) collected (472)



PokerStars Home Game Hand #227252934302: {Club #4781089}  Hold'em No Limit (50/100) - 2021/06/02 1:08:13 EET [2021/06/01 18:08:13 ET]
Table 'VTPP NLHE 0106' 2-max (Play Money) Seat #2 is the button
Seat 1: s70n3fac3 (7226 in chips) 
Seat 2: FDIBA2009 (14102 in chips) 
FDIBA2009: posts small blind 50
s70n3fac3: posts big blind 100
*** HOLE CARDS ***
FDIBA2009: raises 200 to 300
s70n3fac3: calls 200
*** FLOP *** [3s Jd 3c]
s70n3fac3: checks 
FDIBA2009: bets 567
s70n3fac3: folds 
Uncalled bet (567) returned to FDIBA2009
FDIBA2009 collected 567 from pot
FDIBA2009: doesn't show hand 
*** SUMMARY ***
Total pot 600 | Rake 33 
Board [3s Jd 3c]
Seat 1: s70n3fac3 (big blind) folded on the Flop
Seat 2: FDIBA2009 (button) (small blind) collected (567)



PokerStars Home Game Hand #227252939191: {Club #4781089}  Hold'em No Limit (50/100) - 2021/06/02 1:08:24 EET [2021/06/01 18:08:24 ET]
Table 'VTPP NLHE 0106' 2-max (Play Money) Seat #1 is the button
Seat 1: s70n3fac3 (6926 in chips) 
Seat 2: FDIBA2009 (14369 in chips) 
s70n3fac3: posts small blind 50
FDIBA2009: posts big blind 100
*** HOLE CARDS ***
s70n3fac3: raises 150 to 250
FDIBA2009: raises 500 to 750
s70n3fac3: calls 500
*** FLOP *** [Ac 7s 7c]
FDIBA2009: bets 1417
s70n3fac3: calls 1417
*** TURN *** [Ac 7s 7c] [8c]
FDIBA2009: checks 
s70n3fac3: bets 800
FDIBA2009: calls 800
*** RIVER *** [Ac 7s 7c 8c] [6d]
FDIBA2009: checks 
s70n3fac3: bets 1400
FDIBA2009: calls 1400
*** SHOW DOWN ***
s70n3fac3: shows [7h 9d] (three of a kind, Sevens)
FDIBA2009: mucks hand 
s70n3fac3 collected 8254 from pot
*** SUMMARY ***
Total pot 8734 | Rake 480 
Board [Ac 7s 7c 8c 6d]
Seat 1: s70n3fac3 (button) (small blind) showed [7h 9d] and won (8254) with three of a kind, Sevens
Seat 2: FDIBA2009 (big blind) mucked [5h Ah]



PokerStars Home Game Hand #227252953102: {Club #4781089}  Hold'em No Limit (50/100) - 2021/06/02 1:08:56 EET [2021/06/01 18:08:56 ET]
Table 'VTPP NLHE 0106' 2-max (Play Money) Seat #2 is the button
Seat 1: s70n3fac3 (10813 in chips) 
Seat 2: FDIBA2009 (10002 in chips) 
FDIBA2009: posts small blind 50
s70n3fac3: posts big blind 100
*** HOLE CARDS ***
FDIBA2009: raises 200 to 300
s70n3fac3: folds 
Uncalled bet (200) returned to FDIBA2009
FDIBA2009 collected 200 from pot
FDIBA2009: doesn't show hand 
*** SUMMARY ***
Total pot 200 | Rake 0 
Seat 1: s70n3fac3 (big blind) folded before Flop
Seat 2: FDIBA2009 (button) (small blind) collected (200)



PokerStars Home Game Hand #227252956416: {Club #4781089}  Hold'em No Limit (50/100) - 2021/06/02 1:09:04 EET [2021/06/01 18:09:04 ET]
Table 'VTPP NLHE 0106' 2-max (Play Money) Seat #1 is the button
Seat 1: s70n3fac3 (10713 in chips) 
Seat 2: FDIBA2009 (10102 in chips) 
s70n3fac3: posts small blind 50
FDIBA2009: posts big blind 100
*** HOLE CARDS ***
s70n3fac3: folds 
Uncalled bet (50) returned to FDIBA2009
FDIBA2009 collected 100 from pot
FDIBA2009: doesn't show hand 
*** SUMMARY ***
Total pot 100 | Rake 0 
Seat 1: s70n3fac3 (button) (small blind) folded before Flop
Seat 2: FDIBA2009 (big blind) collected (100)



PokerStars Home Game Hand #227252958155: {Club #4781089}  Hold'em No Limit (50/100) - 2021/06/02 1:09:08 EET [2021/06/01 18:09:08 ET]
Table 'VTPP NLHE 0106' 2-max (Play Money) Seat #2 is the button
Seat 1: s70n3fac3 (10663 in chips) 
Seat 2: FDIBA2009 (10152 in chips) 
FDIBA2009: posts small blind 50
s70n3fac3: posts big blind 100
*** HOLE CARDS ***
FDIBA2009: raises 200 to 300
s70n3fac3: raises 600 to 900
FDIBA2009: calls 600
*** FLOP *** [9c 5d Tc]
s70n3fac3: bets 1701
FDIBA2009: calls 1701
*** TURN *** [9c 5d Tc] [Ks]
s70n3fac3: checks 
FDIBA2009: bets 7551 and is all-in
s70n3fac3: folds 
Uncalled bet (7551) returned to FDIBA2009
FDIBA2009 collected 4916 from pot
FDIBA2009: doesn't show hand 
*** SUMMARY ***
Total pot 5202 | Rake 286 
Board [9c 5d Tc Ks]
Seat 1: s70n3fac3 (big blind) folded on the Turn
Seat 2: FDIBA2009 (button) (small blind) collected (4916)



PokerStars Home Game Hand #227252977850: {Club #4781089}  Hold'em No Limit (50/100) - 2021/06/02 1:09:55 EET [2021/06/01 18:09:55 ET]
Table 'VTPP NLHE 0106' 2-max (Play Money) Seat #1 is the button
Seat 1: s70n3fac3 (8062 in chips) 
Seat 2: FDIBA2009 (12467 in chips) 
s70n3fac3: posts small blind 50
FDIBA2009: posts big blind 100
*** HOLE CARDS ***
s70n3fac3: calls 50
FDIBA2009: raises 200 to 300
s70n3fac3: calls 200
*** FLOP *** [6d 3s 4d]
FDIBA2009: bets 567
s70n3fac3: calls 567
*** TURN *** [6d 3s 4d] [Kc]
FDIBA2009: checks 
s70n3fac3: checks 
*** RIVER *** [6d 3s 4d Kc] [Th]
FDIBA2009: checks 
s70n3fac3: checks 
*** SHOW DOWN ***
FDIBA2009: shows [2s 2d] (a pair of Deuces)
s70n3fac3: mucks hand 
FDIBA2009 collected 1639 from pot
*** SUMMARY ***
Total pot 1734 | Rake 95 
Board [6d 3s 4d Kc Th]
Seat 1: s70n3fac3 (button) (small blind) mucked [7s 8s]
Seat 2: FDIBA2009 (big blind) showed [2s 2d] and won (1639) with a pair of Deuces



PokerStars Home Game Hand #227252986366: {Club #4781089}  Hold'em No Limit (50/100) - 2021/06/02 1:10:15 EET [2021/06/01 18:10:15 ET]
Table 'VTPP NLHE 0106' 2-max (Play Money) Seat #2 is the button
Seat 1: s70n3fac3 (7195 in chips) 
Seat 2: FDIBA2009 (13239 in chips) 
FDIBA2009: posts small blind 50
s70n3fac3: posts big blind 100
*** HOLE CARDS ***
FDIBA2009: raises 200 to 300
s70n3fac3: folds 
Uncalled bet (200) returned to FDIBA2009
FDIBA2009 collected 200 from pot
FDIBA2009: doesn't show hand 
*** SUMMARY ***
Total pot 200 | Rake 0 
Seat 1: s70n3fac3 (big blind) folded before Flop
Seat 2: FDIBA2009 (button) (small blind) collected (200)



PokerStars Home Game Hand #227252989309: {Club #4781089}  Hold'em No Limit (50/100) - 2021/06/02 1:10:22 EET [2021/06/01 18:10:22 ET]
Table 'VTPP NLHE 0106' 2-max (Play Money) Seat #1 is the button
Seat 1: s70n3fac3 (7095 in chips) 
Seat 2: FDIBA2009 (13339 in chips) 
s70n3fac3: posts small blind 50
FDIBA2009: posts big blind 100
*** HOLE CARDS ***
s70n3fac3: calls 50
FDIBA2009: checks 
*** FLOP *** [Jd 9s 7s]
FDIBA2009: checks 
s70n3fac3: checks 
*** TURN *** [Jd 9s 7s] [Td]
FDIBA2009: checks 
s70n3fac3: checks 
*** RIVER *** [Jd 9s 7s Td] [6h]
FDIBA2009: checks 
s70n3fac3: checks 
*** SHOW DOWN ***
FDIBA2009: shows [Ks 5c] (high card King)
s70n3fac3: mucks hand 
FDIBA2009 collected 189 from pot
*** SUMMARY ***
Total pot 200 | Rake 11 
Board [Jd 9s 7s Td 6h]
Seat 1: s70n3fac3 (button) (small blind) mucked [3s 2s]
Seat 2: FDIBA2009 (big blind) showed [Ks 5c] and won (189) with high card King



PokerStars Home Game Hand #227252996193: {Club #4781089}  Hold'em No Limit (50/100) - 2021/06/02 1:10:38 EET [2021/06/01 18:10:38 ET]
Table 'VTPP NLHE 0106' 2-max (Play Money) Seat #2 is the button
Seat 1: s70n3fac3 (6995 in chips) 
Seat 2: FDIBA2009 (13428 in chips) 
FDIBA2009: posts small blind 50
s70n3fac3: posts big blind 100
*** HOLE CARDS ***
FDIBA2009: raises 200 to 300
s70n3fac3: calls 200
*** FLOP *** [Ah Kc Ts]
s70n3fac3: checks 
FDIBA2009: checks 
*** TURN *** [Ah Kc Ts] [3d]
s70n3fac3: checks 
FDIBA2009: checks 
*** RIVER *** [Ah Kc Ts 3d] [9h]
s70n3fac3: bets 400
FDIBA2009: folds 
Uncalled bet (400) returned to s70n3fac3
s70n3fac3 collected 567 from pot
s70n3fac3: doesn't show hand 
*** SUMMARY ***
Total pot 600 | Rake 33 
Board [Ah Kc Ts 3d 9h]
Seat 1: s70n3fac3 (big blind) collected (567)
Seat 2: FDIBA2009 (button) (small blind) folded on the River



PokerStars Home Game Hand #227253002189: {Club #4781089}  Hold'em No Limit (50/100) - 2021/06/02 1:10:52 EET [2021/06/01 18:10:52 ET]
Table 'VTPP NLHE 0106' 2-max (Play Money) Seat #1 is the button
Seat 1: s70n3fac3 (7262 in chips) 
Seat 2: FDIBA2009 (13128 in chips) 
s70n3fac3: posts small blind 50
FDIBA2009: posts big blind 100
*** HOLE CARDS ***
s70n3fac3: raises 150 to 250
FDIBA2009: calls 150
*** FLOP *** [Jh Kd 2s]
FDIBA2009: checks 
s70n3fac3: checks 
*** TURN *** [Jh Kd 2s] [2d]
FDIBA2009: checks 
s70n3fac3: bets 200
FDIBA2009: folds 
Uncalled bet (200) returned to s70n3fac3
s70n3fac3 collected 472 from pot
s70n3fac3: doesn't show hand 
*** SUMMARY ***
Total pot 500 | Rake 28 
Board [Jh Kd 2s 2d]
Seat 1: s70n3fac3 (button) (small blind) collected (472)
Seat 2: FDIBA2009 (big blind) folded on the Turn



PokerStars Home Game Hand #227253007959: {Club #4781089}  Hold'em No Limit (50/100) - 2021/06/02 1:11:06 EET [2021/06/01 18:11:06 ET]
Table 'VTPP NLHE 0106' 2-max (Play Money) Seat #2 is the button
Seat 1: s70n3fac3 (7484 in chips) 
Seat 2: FDIBA2009 (12878 in chips) 
FDIBA2009: posts small blind 50
s70n3fac3: posts big blind 100
*** HOLE CARDS ***
FDIBA2009: raises 200 to 300
s70n3fac3: folds 
Uncalled bet (200) returned to FDIBA2009
FDIBA2009 collected 200 from pot
FDIBA2009: doesn't show hand 
*** SUMMARY ***
Total pot 200 | Rake 0 
Seat 1: s70n3fac3 (big blind) folded before Flop
Seat 2: FDIBA2009 (button) (small blind) collected (200)



PokerStars Home Game Hand #227253010600: {Club #4781089}  Hold'em No Limit (50/100) - 2021/06/02 1:11:12 EET [2021/06/01 18:11:12 ET]
Table 'VTPP NLHE 0106' 2-max (Play Money) Seat #1 is the button
Seat 1: s70n3fac3 (7384 in chips) 
Seat 2: FDIBA2009 (12978 in chips) 
s70n3fac3: posts small blind 50
FDIBA2009: posts big blind 100
*** HOLE CARDS ***
s70n3fac3: raises 150 to 250
FDIBA2009: raises 500 to 750
s70n3fac3: calls 500
*** FLOP *** [2d 3h 4c]
FDIBA2009: checks 
s70n3fac3: checks 
*** TURN *** [2d 3h 4c] [Kc]
FDIBA2009: checks 
s70n3fac3: checks 
*** RIVER *** [2d 3h 4c Kc] [Qc]
FDIBA2009: bets 1417
s70n3fac3: calls 1417
*** SHOW DOWN ***
FDIBA2009: shows [7h 9c] (high card King)
s70n3fac3: shows [Qs 8d] (a pair of Queens)
s70n3fac3 collected 4096 from pot
*** SUMMARY ***
Total pot 4334 | Rake 238 
Board [2d 3h 4c Kc Qc]
Seat 1: s70n3fac3 (button) (small blind) showed [Qs 8d] and won (4096) with a pair of Queens
Seat 2: FDIBA2009 (big blind) showed [7h 9c] and lost with high card King



PokerStars Home Game Hand #227253018400: {Club #4781089}  Hold'em No Limit (50/100) - 2021/06/02 1:11:31 EET [2021/06/01 18:11:31 ET]
Table 'VTPP NLHE 0106' 2-max (Play Money) Seat #2 is the button
Seat 1: s70n3fac3 (9313 in chips) 
Seat 2: FDIBA2009 (10811 in chips) 
FDIBA2009: posts small blind 50
s70n3fac3: posts big blind 100
*** HOLE CARDS ***
FDIBA2009: raises 200 to 300
s70n3fac3: folds 
Uncalled bet (200) returned to FDIBA2009
FDIBA2009 collected 200 from pot
FDIBA2009: doesn't show hand 
*** SUMMARY ***
Total pot 200 | Rake 0 
Seat 1: s70n3fac3 (big blind) folded before Flop
Seat 2: FDIBA2009 (button) (small blind) collected (200)



PokerStars Home Game Hand #227253021350: {Club #4781089}  Hold'em No Limit (50/100) - 2021/06/02 1:11:38 EET [2021/06/01 18:11:38 ET]
Table 'VTPP NLHE 0106' 2-max (Play Money) Seat #1 is the button
Seat 1: s70n3fac3 (9213 in chips) 
Seat 2: FDIBA2009 (10911 in chips) 
s70n3fac3: posts small blind 50
FDIBA2009: posts big blind 100
*** HOLE CARDS ***
s70n3fac3: raises 150 to 250
FDIBA2009: raises 500 to 750
s70n3fac3: calls 500
*** FLOP *** [7h 5h Ks]
FDIBA2009: bets 1417
s70n3fac3: folds 
Uncalled bet (1417) returned to FDIBA2009
FDIBA2009 collected 1417 from pot
FDIBA2009: doesn't show hand 
*** SUMMARY ***
Total pot 1500 | Rake 83 
Board [7h 5h Ks]
Seat 1: s70n3fac3 (button) (small blind) folded on the Flop
Seat 2: FDIBA2009 (big blind) collected (1417)



PokerStars Home Game Hand #227253026377: {Club #4781089}  Hold'em No Limit (50/100) - 2021/06/02 1:11:50 EET [2021/06/01 18:11:50 ET]
Table 'VTPP NLHE 0106' 2-max (Play Money) Seat #2 is the button
Seat 1: s70n3fac3 (8463 in chips) 
Seat 2: FDIBA2009 (11578 in chips) 
FDIBA2009: posts small blind 50
s70n3fac3: posts big blind 100
*** HOLE CARDS ***
FDIBA2009: raises 200 to 300
s70n3fac3: folds 
Uncalled bet (200) returned to FDIBA2009
FDIBA2009 collected 200 from pot
FDIBA2009: doesn't show hand 
*** SUMMARY ***
Total pot 200 | Rake 0 
Seat 1: s70n3fac3 (big blind) folded before Flop
Seat 2: FDIBA2009 (button) (small blind) collected (200)



PokerStars Home Game Hand #227253029308: {Club #4781089}  Hold'em No Limit (50/100) - 2021/06/02 1:11:56 EET [2021/06/01 18:11:56 ET]
Table 'VTPP NLHE 0106' 2-max (Play Money) Seat #1 is the button
Seat 1: s70n3fac3 (8363 in chips) 
Seat 2: FDIBA2009 (11678 in chips) 
s70n3fac3: posts small blind 50
FDIBA2009: posts big blind 100
*** HOLE CARDS ***
s70n3fac3: calls 50
FDIBA2009: raises 200 to 300
s70n3fac3: calls 200
*** FLOP *** [5s 4d 8c]
FDIBA2009: bets 567
s70n3fac3: calls 567
*** TURN *** [5s 4d 8c] [3h]
FDIBA2009: bets 1639
s70n3fac3: calls 1639
*** RIVER *** [5s 4d 8c 3h] [6s]
FDIBA2009: bets 4736
s70n3fac3: folds 
Uncalled bet (4736) returned to FDIBA2009
FDIBA2009 collected 4736 from pot
FDIBA2009: doesn't show hand 
*** SUMMARY ***
Total pot 5012 | Rake 276 
Board [5s 4d 8c 3h 6s]
Seat 1: s70n3fac3 (button) (small blind) folded on the River
Seat 2: FDIBA2009 (big blind) collected (4736)



PokerStars Home Game Hand #227253040713: {Club #4781089}  Hold'em No Limit (50/100) - 2021/06/02 1:12:24 EET [2021/06/01 18:12:24 ET]
Table 'VTPP NLHE 0106' 2-max (Play Money) Seat #2 is the button
Seat 1: s70n3fac3 (5857 in chips) 
Seat 2: FDIBA2009 (13908 in chips) 
FDIBA2009: posts small blind 50
s70n3fac3: posts big blind 100
*** HOLE CARDS ***
FDIBA2009: raises 200 to 300
s70n3fac3: folds 
Uncalled bet (200) returned to FDIBA2009
FDIBA2009 collected 200 from pot
FDIBA2009: doesn't show hand 
*** SUMMARY ***
Total pot 200 | Rake 0 
Seat 1: s70n3fac3 (big blind) folded before Flop
Seat 2: FDIBA2009 (button) (small blind) collected (200)



PokerStars Home Game Hand #227253043557: {Club #4781089}  Hold'em No Limit (50/100) - 2021/06/02 1:12:31 EET [2021/06/01 18:12:31 ET]
Table 'VTPP NLHE 0106' 2-max (Play Money) Seat #1 is the button
Seat 1: s70n3fac3 (5757 in chips) 
Seat 2: FDIBA2009 (14008 in chips) 
s70n3fac3: posts small blind 50
FDIBA2009: posts big blind 100
*** HOLE CARDS ***
s70n3fac3: calls 50
FDIBA2009: raises 200 to 300
s70n3fac3: calls 200
*** FLOP *** [Ts 6s Jh]
FDIBA2009: bets 567
s70n3fac3: calls 567
*** TURN *** [Ts 6s Jh] [3s]
FDIBA2009: bets 1639
s70n3fac3: folds 
Uncalled bet (1639) returned to FDIBA2009
FDIBA2009 collected 1639 from pot
FDIBA2009: doesn't show hand 
*** SUMMARY ***
Total pot 1734 | Rake 95 
Board [Ts 6s Jh 3s]
Seat 1: s70n3fac3 (button) (small blind) folded on the Turn
Seat 2: FDIBA2009 (big blind) collected (1639)



PokerStars Home Game Hand #227253050094: {Club #4781089}  Hold'em No Limit (50/100) - 2021/06/02 1:12:46 EET [2021/06/01 18:12:46 ET]
Table 'VTPP NLHE 0106' 2-max (Play Money) Seat #2 is the button
Seat 1: s70n3fac3 (4890 in chips) 
Seat 2: FDIBA2009 (14780 in chips) 
FDIBA2009: posts small blind 50
s70n3fac3: posts big blind 100
*** HOLE CARDS ***
FDIBA2009: calls 50
s70n3fac3: checks 
*** FLOP *** [4h 2d 5s]
s70n3fac3: checks 
FDIBA2009: checks 
*** TURN *** [4h 2d 5s] [Js]
s70n3fac3: checks 
FDIBA2009: bets 100
s70n3fac3: folds 
Uncalled bet (100) returned to FDIBA2009
FDIBA2009 collected 189 from pot
FDIBA2009: doesn't show hand 
*** SUMMARY ***
Total pot 200 | Rake 11 
Board [4h 2d 5s Js]
Seat 1: s70n3fac3 (big blind) folded on the Turn
Seat 2: FDIBA2009 (button) (small blind) collected (189)



PokerStars Home Game Hand #227253055175: {Club #4781089}  Hold'em No Limit (50/100) - 2021/06/02 1:12:58 EET [2021/06/01 18:12:58 ET]
Table 'VTPP NLHE 0106' 2-max (Play Money) Seat #1 is the button
Seat 1: s70n3fac3 (4790 in chips) 
Seat 2: FDIBA2009 (14869 in chips) 
s70n3fac3: posts small blind 50
FDIBA2009: posts big blind 100
*** HOLE CARDS ***
s70n3fac3: folds 
Uncalled bet (50) returned to FDIBA2009
FDIBA2009 collected 100 from pot
FDIBA2009: doesn't show hand 
*** SUMMARY ***
Total pot 100 | Rake 0 
Seat 1: s70n3fac3 (button) (small blind) folded before Flop
Seat 2: FDIBA2009 (big blind) collected (100)



PokerStars Home Game Hand #227253056621: {Club #4781089}  Hold'em No Limit (50/100) - 2021/06/02 1:13:02 EET [2021/06/01 18:13:02 ET]
Table 'VTPP NLHE 0106' 2-max (Play Money) Seat #2 is the button
Seat 1: s70n3fac3 (4740 in chips) 
Seat 2: FDIBA2009 (14919 in chips) 
FDIBA2009: posts small blind 50
s70n3fac3: posts big blind 100
*** HOLE CARDS ***
FDIBA2009: raises 200 to 300
s70n3fac3: calls 200
*** FLOP *** [7s As 4h]
s70n3fac3: checks 
FDIBA2009: bets 567
s70n3fac3: calls 567
*** TURN *** [7s As 4h] [Ah]
s70n3fac3: checks 
FDIBA2009: checks 
*** RIVER *** [7s As 4h Ah] [3h]
s70n3fac3: checks 
FDIBA2009: bets 14052 and is all-in
s70n3fac3: calls 3873 and is all-in
Uncalled bet (10179) returned to FDIBA2009
*** SHOW DOWN ***
FDIBA2009: shows [Ac 3d] (a full house, Aces full of Threes)
s70n3fac3: shows [4c 5s] (two pair, Aces and Fours)
FDIBA2009 collected 8959 from pot
*** SUMMARY ***
Total pot 9480 | Rake 521 
Board [7s As 4h Ah 3h]
Seat 1: s70n3fac3 (big blind) showed [4c 5s] and lost with two pair, Aces and Fours
Seat 2: FDIBA2009 (button) (small blind) showed [Ac 3d] and won (8959) with a full house, Aces full of Threes



