PokerStars Home Game Hand #225969897343: {Club #4781089}  Hold'em No Limit (50/100) - 2021/04/18 22:18:30 EET [2021/04/18 15:18:30 ET]
Table 'Session 3' 2-max (Play Money) Seat #1 is the button
Seat 1: s70n3fac3 (10000 in chips) 
Seat 2: FDIBA2009 (10000 in chips) 
s70n3fac3: posts small blind 50
FDIBA2009: posts big blind 100
*** HOLE CARDS ***
s70n3fac3: folds 
Uncalled bet (50) returned to FDIBA2009
FDIBA2009 collected 100 from pot
*** SUMMARY ***
Total pot 100 | Rake 0 
Seat 1: s70n3fac3 (button) (small blind) folded before Flop
Seat 2: FDIBA2009 (big blind) collected (100)



PokerStars Home Game Hand #225969911087: {Club #4781089}  Hold'em No Limit (50/100) - 2021/04/18 22:18:47 EET [2021/04/18 15:18:47 ET]
Table 'Session 3' 2-max (Play Money) Seat #2 is the button
Seat 1: s70n3fac3 (9950 in chips) 
Seat 2: FDIBA2009 (10050 in chips) 
FDIBA2009: posts small blind 50
s70n3fac3: posts big blind 100
*** HOLE CARDS ***
FDIBA2009: raises 100 to 200
s70n3fac3: folds 
Uncalled bet (100) returned to FDIBA2009
FDIBA2009 collected 200 from pot
*** SUMMARY ***
Total pot 200 | Rake 0 
Seat 1: s70n3fac3 (big blind) folded before Flop
Seat 2: FDIBA2009 (button) (small blind) collected (200)



PokerStars Home Game Hand #225969916439: {Club #4781089}  Hold'em No Limit (50/100) - 2021/04/18 22:18:54 EET [2021/04/18 15:18:54 ET]
Table 'Session 3' 2-max (Play Money) Seat #1 is the button
Seat 1: s70n3fac3 (9850 in chips) 
Seat 2: FDIBA2009 (10150 in chips) 
s70n3fac3: posts small blind 50
FDIBA2009: posts big blind 100
*** HOLE CARDS ***
s70n3fac3: folds 
Uncalled bet (50) returned to FDIBA2009
FDIBA2009 collected 100 from pot
*** SUMMARY ***
Total pot 100 | Rake 0 
Seat 1: s70n3fac3 (button) (small blind) folded before Flop
Seat 2: FDIBA2009 (big blind) collected (100)



PokerStars Home Game Hand #225969919972: {Club #4781089}  Hold'em No Limit (50/100) - 2021/04/18 22:18:58 EET [2021/04/18 15:18:58 ET]
Table 'Session 3' 2-max (Play Money) Seat #2 is the button
Seat 1: s70n3fac3 (9800 in chips) 
Seat 2: FDIBA2009 (10200 in chips) 
FDIBA2009: posts small blind 50
s70n3fac3: posts big blind 100
*** HOLE CARDS ***
FDIBA2009: raises 100 to 200
s70n3fac3: calls 100
*** FLOP *** [5h Kc Ad]
s70n3fac3: checks 
FDIBA2009: bets 189
s70n3fac3: folds 
Uncalled bet (189) returned to FDIBA2009
FDIBA2009 collected 378 from pot
*** SUMMARY ***
Total pot 400 | Rake 22 
Board [5h Kc Ad]
Seat 1: s70n3fac3 (big blind) folded on the Flop
Seat 2: FDIBA2009 (button) (small blind) collected (378)



PokerStars Home Game Hand #225969943269: {Club #4781089}  Hold'em No Limit (50/100) - 2021/04/18 22:19:27 EET [2021/04/18 15:19:27 ET]
Table 'Session 3' 2-max (Play Money) Seat #1 is the button
Seat 1: s70n3fac3 (9600 in chips) 
Seat 2: FDIBA2009 (10378 in chips) 
s70n3fac3: posts small blind 50
FDIBA2009: posts big blind 100
*** HOLE CARDS ***
s70n3fac3: raises 100 to 200
FDIBA2009: folds 
Uncalled bet (100) returned to s70n3fac3
s70n3fac3 collected 200 from pot
s70n3fac3: doesn't show hand 
*** SUMMARY ***
Total pot 200 | Rake 0 
Seat 1: s70n3fac3 (button) (small blind) collected (200)
Seat 2: FDIBA2009 (big blind) folded before Flop



PokerStars Home Game Hand #225969947378: {Club #4781089}  Hold'em No Limit (50/100) - 2021/04/18 22:19:32 EET [2021/04/18 15:19:32 ET]
Table 'Session 3' 2-max (Play Money) Seat #2 is the button
Seat 1: s70n3fac3 (9700 in chips) 
Seat 2: FDIBA2009 (10278 in chips) 
FDIBA2009: posts small blind 50
s70n3fac3: posts big blind 100
*** HOLE CARDS ***
FDIBA2009: raises 100 to 200
s70n3fac3: calls 100
*** FLOP *** [Js 3s Tc]
s70n3fac3: checks 
FDIBA2009: bets 189
s70n3fac3: calls 189
*** TURN *** [Js 3s Tc] [7s]
s70n3fac3: checks 
FDIBA2009: bets 367
s70n3fac3: calls 367
*** RIVER *** [Js 3s Tc 7s] [3d]
s70n3fac3: checks 
FDIBA2009: checks 
*** SHOW DOWN ***
s70n3fac3: shows [Qs Th] (two pair, Tens and Threes)
FDIBA2009: mucks hand 
s70n3fac3 collected 1429 from pot
*** SUMMARY ***
Total pot 1512 | Rake 83 
Board [Js 3s Tc 7s 3d]
Seat 1: s70n3fac3 (big blind) showed [Qs Th] and won (1429) with two pair, Tens and Threes
Seat 2: FDIBA2009 (button) (small blind) mucked [8h Td]



PokerStars Home Game Hand #225969969200: {Club #4781089}  Hold'em No Limit (50/100) - 2021/04/18 22:19:59 EET [2021/04/18 15:19:59 ET]
Table 'Session 3' 2-max (Play Money) Seat #1 is the button
Seat 1: s70n3fac3 (10373 in chips) 
Seat 2: FDIBA2009 (9522 in chips) 
s70n3fac3: posts small blind 50
FDIBA2009: posts big blind 100
*** HOLE CARDS ***
s70n3fac3: folds 
Uncalled bet (50) returned to FDIBA2009
FDIBA2009 collected 100 from pot
*** SUMMARY ***
Total pot 100 | Rake 0 
Seat 1: s70n3fac3 (button) (small blind) folded before Flop
Seat 2: FDIBA2009 (big blind) collected (100)



PokerStars Home Game Hand #225969973195: {Club #4781089}  Hold'em No Limit (50/100) - 2021/04/18 22:20:04 EET [2021/04/18 15:20:04 ET]
Table 'Session 3' 2-max (Play Money) Seat #2 is the button
Seat 1: s70n3fac3 (10323 in chips) 
Seat 2: FDIBA2009 (9572 in chips) 
FDIBA2009: posts small blind 50
s70n3fac3: posts big blind 100
*** HOLE CARDS ***
FDIBA2009: raises 100 to 200
s70n3fac3: folds 
Uncalled bet (100) returned to FDIBA2009
FDIBA2009 collected 200 from pot
*** SUMMARY ***
Total pot 200 | Rake 0 
Seat 1: s70n3fac3 (big blind) folded before Flop
Seat 2: FDIBA2009 (button) (small blind) collected (200)



PokerStars Home Game Hand #225969978504: {Club #4781089}  Hold'em No Limit (50/100) - 2021/04/18 22:20:10 EET [2021/04/18 15:20:10 ET]
Table 'Session 3' 2-max (Play Money) Seat #1 is the button
Seat 1: s70n3fac3 (10223 in chips) 
Seat 2: FDIBA2009 (9672 in chips) 
s70n3fac3: posts small blind 50
FDIBA2009: posts big blind 100
*** HOLE CARDS ***
s70n3fac3: raises 150 to 250
FDIBA2009: calls 150
*** FLOP *** [4s 3d 2c]
FDIBA2009: checks 
s70n3fac3: checks 
*** TURN *** [4s 3d 2c] [7c]
FDIBA2009: bets 300
s70n3fac3: folds 
Uncalled bet (300) returned to FDIBA2009
FDIBA2009 collected 472 from pot
*** SUMMARY ***
Total pot 500 | Rake 28 
Board [4s 3d 2c 7c]
Seat 1: s70n3fac3 (button) (small blind) folded on the Turn
Seat 2: FDIBA2009 (big blind) collected (472)



PokerStars Home Game Hand #225969999002: {Club #4781089}  Hold'em No Limit (50/100) - 2021/04/18 22:20:36 EET [2021/04/18 15:20:36 ET]
Table 'Session 3' 2-max (Play Money) Seat #2 is the button
Seat 1: s70n3fac3 (9973 in chips) 
Seat 2: FDIBA2009 (9894 in chips) 
FDIBA2009: posts small blind 50
s70n3fac3: posts big blind 100
*** HOLE CARDS ***
FDIBA2009: raises 100 to 200
s70n3fac3: calls 100
*** FLOP *** [Ah Ts 9h]
s70n3fac3: checks 
FDIBA2009: bets 189
s70n3fac3: calls 189
*** TURN *** [Ah Ts 9h] [2d]
s70n3fac3: bets 275
FDIBA2009: folds 
Uncalled bet (275) returned to s70n3fac3
s70n3fac3 collected 735 from pot
s70n3fac3: doesn't show hand 
*** SUMMARY ***
Total pot 778 | Rake 43 
Board [Ah Ts 9h 2d]
Seat 1: s70n3fac3 (big blind) collected (735)
Seat 2: FDIBA2009 (button) (small blind) folded on the Turn



PokerStars Home Game Hand #225970022394: {Club #4781089}  Hold'em No Limit (50/100) - 2021/04/18 22:21:05 EET [2021/04/18 15:21:05 ET]
Table 'Session 3' 2-max (Play Money) Seat #1 is the button
Seat 1: s70n3fac3 (10319 in chips) 
Seat 2: FDIBA2009 (9505 in chips) 
s70n3fac3: posts small blind 50
FDIBA2009: posts big blind 100
*** HOLE CARDS ***
s70n3fac3: raises 100 to 200
FDIBA2009: folds 
Uncalled bet (100) returned to s70n3fac3
s70n3fac3 collected 200 from pot
s70n3fac3: doesn't show hand 
*** SUMMARY ***
Total pot 200 | Rake 0 
Seat 1: s70n3fac3 (button) (small blind) collected (200)
Seat 2: FDIBA2009 (big blind) folded before Flop



PokerStars Home Game Hand #225970027371: {Club #4781089}  Hold'em No Limit (50/100) - 2021/04/18 22:21:11 EET [2021/04/18 15:21:11 ET]
Table 'Session 3' 2-max (Play Money) Seat #2 is the button
Seat 1: s70n3fac3 (10419 in chips) 
Seat 2: FDIBA2009 (9405 in chips) 
FDIBA2009: posts small blind 50
s70n3fac3: posts big blind 100
*** HOLE CARDS ***
FDIBA2009: raises 100 to 200
s70n3fac3: calls 100
*** FLOP *** [Qs Js Kd]
s70n3fac3: checks 
FDIBA2009: bets 189
s70n3fac3: calls 189
*** TURN *** [Qs Js Kd] [7h]
s70n3fac3: checks 
FDIBA2009: bets 500
s70n3fac3: folds 
Uncalled bet (500) returned to FDIBA2009
FDIBA2009 collected 735 from pot
*** SUMMARY ***
Total pot 778 | Rake 43 
Board [Qs Js Kd 7h]
Seat 1: s70n3fac3 (big blind) folded on the Turn
Seat 2: FDIBA2009 (button) (small blind) collected (735)



PokerStars Home Game Hand #225970051784: {Club #4781089}  Hold'em No Limit (50/100) - 2021/04/18 22:21:41 EET [2021/04/18 15:21:41 ET]
Table 'Session 3' 2-max (Play Money) Seat #1 is the button
Seat 1: s70n3fac3 (10030 in chips) 
Seat 2: FDIBA2009 (9751 in chips) 
s70n3fac3: posts small blind 50
FDIBA2009: posts big blind 100
*** HOLE CARDS ***
s70n3fac3: raises 150 to 250
FDIBA2009: calls 150
*** FLOP *** [3h Kd 7h]
FDIBA2009: checks 
s70n3fac3: bets 280
FDIBA2009: calls 280
*** TURN *** [3h Kd 7h] [9d]
FDIBA2009: checks 
s70n3fac3: bets 445
FDIBA2009: calls 445
*** RIVER *** [3h Kd 7h 9d] [Js]
FDIBA2009: checks 
s70n3fac3: checks 
*** SHOW DOWN ***
FDIBA2009: shows [Kc 7c] (two pair, Kings and Sevens)
s70n3fac3: mucks hand 
FDIBA2009 collected 1843 from pot
*** SUMMARY ***
Total pot 1950 | Rake 107 
Board [3h Kd 7h 9d Js]
Seat 1: s70n3fac3 (button) (small blind) mucked [6h 5h]
Seat 2: FDIBA2009 (big blind) showed [Kc 7c] and won (1843) with two pair, Kings and Sevens



PokerStars Home Game Hand #225970089996: {Club #4781089}  Hold'em No Limit (50/100) - 2021/04/18 22:22:29 EET [2021/04/18 15:22:29 ET]
Table 'Session 3' 2-max (Play Money) Seat #2 is the button
Seat 1: s70n3fac3 (9055 in chips) 
Seat 2: FDIBA2009 (10619 in chips) 
FDIBA2009: posts small blind 50
s70n3fac3: posts big blind 100
*** HOLE CARDS ***
FDIBA2009: raises 100 to 200
s70n3fac3: calls 100
*** FLOP *** [5s Td Ac]
s70n3fac3: checks 
FDIBA2009: checks 
*** TURN *** [5s Td Ac] [Js]
s70n3fac3: checks 
FDIBA2009: bets 100
s70n3fac3: calls 100
*** RIVER *** [5s Td Ac Js] [3c]
s70n3fac3: checks 
FDIBA2009: bets 283
s70n3fac3: folds 
Uncalled bet (283) returned to FDIBA2009
FDIBA2009 collected 567 from pot
*** SUMMARY ***
Total pot 600 | Rake 33 
Board [5s Td Ac Js 3c]
Seat 1: s70n3fac3 (big blind) folded on the River
Seat 2: FDIBA2009 (button) (small blind) collected (567)



PokerStars Home Game Hand #225970125201: {Club #4781089}  Hold'em No Limit (50/100) - 2021/04/18 22:23:13 EET [2021/04/18 15:23:13 ET]
Table 'Session 3' 2-max (Play Money) Seat #1 is the button
Seat 1: s70n3fac3 (8755 in chips) 
Seat 2: FDIBA2009 (10886 in chips) 
s70n3fac3: posts small blind 50
FDIBA2009: posts big blind 100
*** HOLE CARDS ***
s70n3fac3: raises 100 to 200
FDIBA2009: folds 
Uncalled bet (100) returned to s70n3fac3
s70n3fac3 collected 200 from pot
s70n3fac3: doesn't show hand 
*** SUMMARY ***
Total pot 200 | Rake 0 
Seat 1: s70n3fac3 (button) (small blind) collected (200)
Seat 2: FDIBA2009 (big blind) folded before Flop



PokerStars Home Game Hand #225970135521: {Club #4781089}  Hold'em No Limit (50/100) - 2021/04/18 22:23:22 EET [2021/04/18 15:23:22 ET]
Table 'Session 3' 2-max (Play Money) Seat #2 is the button
Seat 1: s70n3fac3 (8855 in chips) 
Seat 2: FDIBA2009 (10786 in chips) 
FDIBA2009: posts small blind 50
s70n3fac3: posts big blind 100
*** HOLE CARDS ***
FDIBA2009: raises 200 to 300
s70n3fac3: folds 
Uncalled bet (200) returned to FDIBA2009
FDIBA2009 collected 200 from pot
*** SUMMARY ***
Total pot 200 | Rake 0 
Seat 1: s70n3fac3 (big blind) folded before Flop
Seat 2: FDIBA2009 (button) (small blind) collected (200)



PokerStars Home Game Hand #225970141801: {Club #4781089}  Hold'em No Limit (50/100) - 2021/04/18 22:23:30 EET [2021/04/18 15:23:30 ET]
Table 'Session 3' 2-max (Play Money) Seat #1 is the button
Seat 1: s70n3fac3 (8755 in chips) 
Seat 2: FDIBA2009 (10886 in chips) 
s70n3fac3: posts small blind 50
FDIBA2009: posts big blind 100
*** HOLE CARDS ***
s70n3fac3: raises 100 to 200
FDIBA2009: folds 
Uncalled bet (100) returned to s70n3fac3
s70n3fac3 collected 200 from pot
s70n3fac3: doesn't show hand 
*** SUMMARY ***
Total pot 200 | Rake 0 
Seat 1: s70n3fac3 (button) (small blind) collected (200)
Seat 2: FDIBA2009 (big blind) folded before Flop



PokerStars Home Game Hand #225970148750: {Club #4781089}  Hold'em No Limit (50/100) - 2021/04/18 22:23:39 EET [2021/04/18 15:23:39 ET]
Table 'Session 3' 2-max (Play Money) Seat #2 is the button
Seat 1: s70n3fac3 (8855 in chips) 
Seat 2: FDIBA2009 (10786 in chips) 
FDIBA2009: posts small blind 50
s70n3fac3: posts big blind 100
*** HOLE CARDS ***
FDIBA2009: raises 100 to 200
s70n3fac3: folds 
Uncalled bet (100) returned to FDIBA2009
FDIBA2009 collected 200 from pot
*** SUMMARY ***
Total pot 200 | Rake 0 
Seat 1: s70n3fac3 (big blind) folded before Flop
Seat 2: FDIBA2009 (button) (small blind) collected (200)



PokerStars Home Game Hand #225970155770: {Club #4781089}  Hold'em No Limit (50/100) - 2021/04/18 22:23:48 EET [2021/04/18 15:23:48 ET]
Table 'Session 3' 2-max (Play Money) Seat #1 is the button
Seat 1: s70n3fac3 (8755 in chips) 
Seat 2: FDIBA2009 (10886 in chips) 
s70n3fac3: posts small blind 50
FDIBA2009: posts big blind 100
*** HOLE CARDS ***
s70n3fac3: raises 150 to 250
FDIBA2009: folds 
Uncalled bet (150) returned to s70n3fac3
s70n3fac3 collected 200 from pot
s70n3fac3: doesn't show hand 
*** SUMMARY ***
Total pot 200 | Rake 0 
Seat 1: s70n3fac3 (button) (small blind) collected (200)
Seat 2: FDIBA2009 (big blind) folded before Flop



PokerStars Home Game Hand #225970160781: {Club #4781089}  Hold'em No Limit (50/100) - 2021/04/18 22:23:54 EET [2021/04/18 15:23:54 ET]
Table 'Session 3' 2-max (Play Money) Seat #2 is the button
Seat 1: s70n3fac3 (8855 in chips) 
Seat 2: FDIBA2009 (10786 in chips) 
FDIBA2009: posts small blind 50
s70n3fac3: posts big blind 100
*** HOLE CARDS ***
FDIBA2009: raises 200 to 300
s70n3fac3: raises 600 to 900
FDIBA2009: folds 
Uncalled bet (600) returned to s70n3fac3
s70n3fac3 collected 600 from pot
s70n3fac3: doesn't show hand 
*** SUMMARY ***
Total pot 600 | Rake 0 
Seat 1: s70n3fac3 (big blind) collected (600)
Seat 2: FDIBA2009 (button) (small blind) folded before Flop



PokerStars Home Game Hand #225970171905: {Club #4781089}  Hold'em No Limit (50/100) - 2021/04/18 22:24:08 EET [2021/04/18 15:24:08 ET]
Table 'Session 3' 2-max (Play Money) Seat #1 is the button
Seat 1: s70n3fac3 (9155 in chips) 
Seat 2: FDIBA2009 (10486 in chips) 
s70n3fac3: posts small blind 50
FDIBA2009: posts big blind 100
*** HOLE CARDS ***
s70n3fac3: raises 100 to 200
FDIBA2009: folds 
Uncalled bet (100) returned to s70n3fac3
s70n3fac3 collected 200 from pot
s70n3fac3: doesn't show hand 
*** SUMMARY ***
Total pot 200 | Rake 0 
Seat 1: s70n3fac3 (button) (small blind) collected (200)
Seat 2: FDIBA2009 (big blind) folded before Flop



PokerStars Home Game Hand #225970176488: {Club #4781089}  Hold'em No Limit (50/100) - 2021/04/18 22:24:14 EET [2021/04/18 15:24:14 ET]
Table 'Session 3' 2-max (Play Money) Seat #2 is the button
Seat 1: s70n3fac3 (9255 in chips) 
Seat 2: FDIBA2009 (10386 in chips) 
FDIBA2009: posts small blind 50
s70n3fac3: posts big blind 100
*** HOLE CARDS ***
FDIBA2009: raises 100 to 200
s70n3fac3: calls 100
*** FLOP *** [6c 2d Td]
s70n3fac3: checks 
FDIBA2009: bets 300
s70n3fac3: folds 
Uncalled bet (300) returned to FDIBA2009
FDIBA2009 collected 378 from pot
*** SUMMARY ***
Total pot 400 | Rake 22 
Board [6c 2d Td]
Seat 1: s70n3fac3 (big blind) folded on the Flop
Seat 2: FDIBA2009 (button) (small blind) collected (378)



PokerStars Home Game Hand #225970191578: {Club #4781089}  Hold'em No Limit (50/100) - 2021/04/18 22:24:32 EET [2021/04/18 15:24:32 ET]
Table 'Session 3' 2-max (Play Money) Seat #1 is the button
Seat 1: s70n3fac3 (9055 in chips) 
Seat 2: FDIBA2009 (10564 in chips) 
s70n3fac3: posts small blind 50
FDIBA2009: posts big blind 100
*** HOLE CARDS ***
s70n3fac3: raises 100 to 200
FDIBA2009: calls 100
*** FLOP *** [5s 4h 5c]
FDIBA2009: checks 
s70n3fac3: checks 
*** TURN *** [5s 4h 5c] [7h]
FDIBA2009: checks 
s70n3fac3: bets 200
FDIBA2009: calls 200
*** RIVER *** [5s 4h 5c 7h] [5h]
FDIBA2009: checks 
s70n3fac3: bets 475
FDIBA2009: raises 853 to 1328
s70n3fac3: calls 853
*** SHOW DOWN ***
FDIBA2009: shows [Ks 7c] (a full house, Fives full of Sevens)
s70n3fac3: shows [9c 7s] (a full house, Fives full of Sevens)
FDIBA2009 collected 1633 from pot
s70n3fac3 collected 1633 from pot
*** SUMMARY ***
Total pot 3456 | Rake 190 
Board [5s 4h 5c 7h 5h]
Seat 1: s70n3fac3 (button) (small blind) showed [9c 7s] and won (1633) with a full house, Fives full of Sevens
Seat 2: FDIBA2009 (big blind) showed [Ks 7c] and won (1633) with a full house, Fives full of Sevens



PokerStars Home Game Hand #225970234846: {Club #4781089}  Hold'em No Limit (50/100) - 2021/04/18 22:25:26 EET [2021/04/18 15:25:26 ET]
Table 'Session 3' 2-max (Play Money) Seat #2 is the button
Seat 1: s70n3fac3 (8960 in chips) 
Seat 2: FDIBA2009 (10469 in chips) 
FDIBA2009: posts small blind 50
s70n3fac3: posts big blind 100
*** HOLE CARDS ***
FDIBA2009: raises 200 to 300
s70n3fac3: folds 
Uncalled bet (200) returned to FDIBA2009
FDIBA2009 collected 200 from pot
*** SUMMARY ***
Total pot 200 | Rake 0 
Seat 1: s70n3fac3 (big blind) folded before Flop
Seat 2: FDIBA2009 (button) (small blind) collected (200)



PokerStars Home Game Hand #225970243498: {Club #4781089}  Hold'em No Limit (50/100) - 2021/04/18 22:25:37 EET [2021/04/18 15:25:37 ET]
Table 'Session 3' 2-max (Play Money) Seat #1 is the button
Seat 1: s70n3fac3 (8860 in chips) 
Seat 2: FDIBA2009 (10569 in chips) 
s70n3fac3: posts small blind 50
FDIBA2009: posts big blind 100
*** HOLE CARDS ***
s70n3fac3: folds 
Uncalled bet (50) returned to FDIBA2009
FDIBA2009 collected 100 from pot
*** SUMMARY ***
Total pot 100 | Rake 0 
Seat 1: s70n3fac3 (button) (small blind) folded before Flop
Seat 2: FDIBA2009 (big blind) collected (100)



PokerStars Home Game Hand #225970246870: {Club #4781089}  Hold'em No Limit (50/100) - 2021/04/18 22:25:41 EET [2021/04/18 15:25:41 ET]
Table 'Session 3' 2-max (Play Money) Seat #2 is the button
Seat 1: s70n3fac3 (8810 in chips) 
Seat 2: FDIBA2009 (10619 in chips) 
FDIBA2009: posts small blind 50
s70n3fac3: posts big blind 100
*** HOLE CARDS ***
FDIBA2009: raises 100 to 200
s70n3fac3: calls 100
*** FLOP *** [9c 7c 4s]
s70n3fac3: checks 
FDIBA2009: bets 189
s70n3fac3: folds 
Uncalled bet (189) returned to FDIBA2009
FDIBA2009 collected 378 from pot
*** SUMMARY ***
Total pot 400 | Rake 22 
Board [9c 7c 4s]
Seat 1: s70n3fac3 (big blind) folded on the Flop
Seat 2: FDIBA2009 (button) (small blind) collected (378)



PokerStars Home Game Hand #225970257836: {Club #4781089}  Hold'em No Limit (50/100) - 2021/04/18 22:25:55 EET [2021/04/18 15:25:55 ET]
Table 'Session 3' 2-max (Play Money) Seat #1 is the button
Seat 1: s70n3fac3 (8610 in chips) 
Seat 2: FDIBA2009 (10797 in chips) 
s70n3fac3: posts small blind 50
FDIBA2009: posts big blind 100
*** HOLE CARDS ***
s70n3fac3: folds 
Uncalled bet (50) returned to FDIBA2009
FDIBA2009 collected 100 from pot
*** SUMMARY ***
Total pot 100 | Rake 0 
Seat 1: s70n3fac3 (button) (small blind) folded before Flop
Seat 2: FDIBA2009 (big blind) collected (100)



PokerStars Home Game Hand #225970261108: {Club #4781089}  Hold'em No Limit (50/100) - 2021/04/18 22:25:59 EET [2021/04/18 15:25:59 ET]
Table 'Session 3' 2-max (Play Money) Seat #2 is the button
Seat 1: s70n3fac3 (8560 in chips) 
Seat 2: FDIBA2009 (10847 in chips) 
FDIBA2009: posts small blind 50
s70n3fac3: posts big blind 100
*** HOLE CARDS ***
FDIBA2009: raises 200 to 300
s70n3fac3: calls 200
*** FLOP *** [3c 9d Ks]
s70n3fac3: checks 
FDIBA2009: bets 283
s70n3fac3: folds 
Uncalled bet (283) returned to FDIBA2009
FDIBA2009 collected 567 from pot
*** SUMMARY ***
Total pot 600 | Rake 33 
Board [3c 9d Ks]
Seat 1: s70n3fac3 (big blind) folded on the Flop
Seat 2: FDIBA2009 (button) (small blind) collected (567)



PokerStars Home Game Hand #225970275749: {Club #4781089}  Hold'em No Limit (50/100) - 2021/04/18 22:26:17 EET [2021/04/18 15:26:17 ET]
Table 'Session 3' 2-max (Play Money) Seat #1 is the button
Seat 1: s70n3fac3 (8260 in chips) 
Seat 2: FDIBA2009 (11114 in chips) 
s70n3fac3: posts small blind 50
FDIBA2009: posts big blind 100
*** HOLE CARDS ***
s70n3fac3: raises 100 to 200
FDIBA2009: calls 100
*** FLOP *** [Jc Kc Qs]
FDIBA2009: checks 
s70n3fac3: bets 200
FDIBA2009: folds 
Uncalled bet (200) returned to s70n3fac3
s70n3fac3 collected 378 from pot
s70n3fac3: doesn't show hand 
*** SUMMARY ***
Total pot 400 | Rake 22 
Board [Jc Kc Qs]
Seat 1: s70n3fac3 (button) (small blind) collected (378)
Seat 2: FDIBA2009 (big blind) folded on the Flop



PokerStars Home Game Hand #225970285674: {Club #4781089}  Hold'em No Limit (50/100) - 2021/04/18 22:26:30 EET [2021/04/18 15:26:30 ET]
Table 'Session 3' 2-max (Play Money) Seat #2 is the button
Seat 1: s70n3fac3 (8438 in chips) 
Seat 2: FDIBA2009 (10914 in chips) 
FDIBA2009: posts small blind 50
s70n3fac3: posts big blind 100
*** HOLE CARDS ***
FDIBA2009: raises 200 to 300
s70n3fac3: folds 
Uncalled bet (200) returned to FDIBA2009
FDIBA2009 collected 200 from pot
*** SUMMARY ***
Total pot 200 | Rake 0 
Seat 1: s70n3fac3 (big blind) folded before Flop
Seat 2: FDIBA2009 (button) (small blind) collected (200)



PokerStars Home Game Hand #225970291422: {Club #4781089}  Hold'em No Limit (50/100) - 2021/04/18 22:26:37 EET [2021/04/18 15:26:37 ET]
Table 'Session 3' 2-max (Play Money) Seat #1 is the button
Seat 1: s70n3fac3 (8338 in chips) 
Seat 2: FDIBA2009 (11014 in chips) 
s70n3fac3: posts small blind 50
FDIBA2009: posts big blind 100
*** HOLE CARDS ***
s70n3fac3: folds 
Uncalled bet (50) returned to FDIBA2009
FDIBA2009 collected 100 from pot
*** SUMMARY ***
Total pot 100 | Rake 0 
Seat 1: s70n3fac3 (button) (small blind) folded before Flop
Seat 2: FDIBA2009 (big blind) collected (100)



PokerStars Home Game Hand #225970295511: {Club #4781089}  Hold'em No Limit (50/100) - 2021/04/18 22:26:42 EET [2021/04/18 15:26:42 ET]
Table 'Session 3' 2-max (Play Money) Seat #2 is the button
Seat 1: s70n3fac3 (8288 in chips) 
Seat 2: FDIBA2009 (11064 in chips) 
FDIBA2009: posts small blind 50
s70n3fac3: posts big blind 100
*** HOLE CARDS ***
FDIBA2009: raises 100 to 200
s70n3fac3: folds 
Uncalled bet (100) returned to FDIBA2009
FDIBA2009 collected 200 from pot
*** SUMMARY ***
Total pot 200 | Rake 0 
Seat 1: s70n3fac3 (big blind) folded before Flop
Seat 2: FDIBA2009 (button) (small blind) collected (200)



PokerStars Home Game Hand #225970300683: {Club #4781089}  Hold'em No Limit (50/100) - 2021/04/18 22:26:49 EET [2021/04/18 15:26:49 ET]
Table 'Session 3' 2-max (Play Money) Seat #1 is the button
Seat 1: s70n3fac3 (8188 in chips) 
Seat 2: FDIBA2009 (11164 in chips) 
s70n3fac3: posts small blind 50
FDIBA2009: posts big blind 100
*** HOLE CARDS ***
s70n3fac3: raises 150 to 250
FDIBA2009: folds 
Uncalled bet (150) returned to s70n3fac3
s70n3fac3 collected 200 from pot
s70n3fac3: doesn't show hand 
*** SUMMARY ***
Total pot 200 | Rake 0 
Seat 1: s70n3fac3 (button) (small blind) collected (200)
Seat 2: FDIBA2009 (big blind) folded before Flop



PokerStars Home Game Hand #225970305469: {Club #4781089}  Hold'em No Limit (50/100) - 2021/04/18 22:26:55 EET [2021/04/18 15:26:55 ET]
Table 'Session 3' 2-max (Play Money) Seat #2 is the button
Seat 1: s70n3fac3 (8288 in chips) 
Seat 2: FDIBA2009 (11064 in chips) 
FDIBA2009: posts small blind 50
s70n3fac3: posts big blind 100
*** HOLE CARDS ***
FDIBA2009: raises 100 to 200
s70n3fac3: calls 100
*** FLOP *** [Jd Ts Td]
s70n3fac3: checks 
FDIBA2009: bets 189
s70n3fac3: calls 189
*** TURN *** [Jd Ts Td] [8s]
s70n3fac3: checks 
FDIBA2009: checks 
*** RIVER *** [Jd Ts Td 8s] [Ad]
s70n3fac3: bets 300
FDIBA2009: folds 
Uncalled bet (300) returned to s70n3fac3
s70n3fac3 collected 735 from pot
s70n3fac3: doesn't show hand 
*** SUMMARY ***
Total pot 778 | Rake 43 
Board [Jd Ts Td 8s Ad]
Seat 1: s70n3fac3 (big blind) collected (735)
Seat 2: FDIBA2009 (button) (small blind) folded on the River



PokerStars Home Game Hand #225970322393: {Club #4781089}  Hold'em No Limit (50/100) - 2021/04/18 22:27:16 EET [2021/04/18 15:27:16 ET]
Table 'Session 3' 2-max (Play Money) Seat #1 is the button
Seat 1: s70n3fac3 (8634 in chips) 
Seat 2: FDIBA2009 (10675 in chips) 
s70n3fac3: posts small blind 50
FDIBA2009: posts big blind 100
*** HOLE CARDS ***
s70n3fac3: raises 150 to 250
FDIBA2009: folds 
Uncalled bet (150) returned to s70n3fac3
s70n3fac3 collected 200 from pot
s70n3fac3: doesn't show hand 
*** SUMMARY ***
Total pot 200 | Rake 0 
Seat 1: s70n3fac3 (button) (small blind) collected (200)
Seat 2: FDIBA2009 (big blind) folded before Flop



PokerStars Home Game Hand #225970326702: {Club #4781089}  Hold'em No Limit (50/100) - 2021/04/18 22:27:21 EET [2021/04/18 15:27:21 ET]
Table 'Session 3' 2-max (Play Money) Seat #2 is the button
Seat 1: s70n3fac3 (8734 in chips) 
Seat 2: FDIBA2009 (10575 in chips) 
FDIBA2009: posts small blind 50
s70n3fac3: posts big blind 100
*** HOLE CARDS ***
FDIBA2009: raises 100 to 200
s70n3fac3: folds 
Uncalled bet (100) returned to FDIBA2009
FDIBA2009 collected 200 from pot
*** SUMMARY ***
Total pot 200 | Rake 0 
Seat 1: s70n3fac3 (big blind) folded before Flop
Seat 2: FDIBA2009 (button) (small blind) collected (200)



PokerStars Home Game Hand #225970332703: {Club #4781089}  Hold'em No Limit (50/100) - 2021/04/18 22:27:29 EET [2021/04/18 15:27:29 ET]
Table 'Session 3' 2-max (Play Money) Seat #1 is the button
Seat 1: s70n3fac3 (8634 in chips) 
Seat 2: FDIBA2009 (10675 in chips) 
s70n3fac3: posts small blind 50
FDIBA2009: posts big blind 100
*** HOLE CARDS ***
s70n3fac3: raises 100 to 200
FDIBA2009: calls 100
*** FLOP *** [4d 9s 5s]
FDIBA2009: checks 
s70n3fac3: bets 200
FDIBA2009: calls 200
*** TURN *** [4d 9s 5s] [7c]
FDIBA2009: checks 
s70n3fac3: bets 385
FDIBA2009: raises 763 to 1148
s70n3fac3: calls 763
*** RIVER *** [4d 9s 5s 7c] [5d]
FDIBA2009: checks 
s70n3fac3: checks 
*** SHOW DOWN ***
FDIBA2009: shows [7s 9h] (two pair, Nines and Sevens)
s70n3fac3: mucks hand 
FDIBA2009 collected 2926 from pot
*** SUMMARY ***
Total pot 3096 | Rake 170 
Board [4d 9s 5s 7c 5d]
Seat 1: s70n3fac3 (button) (small blind) mucked [6s 9c]
Seat 2: FDIBA2009 (big blind) showed [7s 9h] and won (2926) with two pair, Nines and Sevens



PokerStars Home Game Hand #225970374574: {Club #4781089}  Hold'em No Limit (50/100) - 2021/04/18 22:28:22 EET [2021/04/18 15:28:22 ET]
Table 'Session 3' 2-max (Play Money) Seat #2 is the button
Seat 1: s70n3fac3 (7086 in chips) 
Seat 2: FDIBA2009 (12053 in chips) 
FDIBA2009: posts small blind 50
s70n3fac3: posts big blind 100
*** HOLE CARDS ***
FDIBA2009: folds 
Uncalled bet (50) returned to s70n3fac3
s70n3fac3 collected 100 from pot
s70n3fac3: doesn't show hand 
*** SUMMARY ***
Total pot 100 | Rake 0 
Seat 1: s70n3fac3 (big blind) collected (100)
Seat 2: FDIBA2009 (button) (small blind) folded before Flop



PokerStars Home Game Hand #225970378563: {Club #4781089}  Hold'em No Limit (50/100) - 2021/04/18 22:28:27 EET [2021/04/18 15:28:27 ET]
Table 'Session 3' 2-max (Play Money) Seat #1 is the button
Seat 1: s70n3fac3 (7136 in chips) 
Seat 2: FDIBA2009 (12003 in chips) 
s70n3fac3: posts small blind 50
FDIBA2009: posts big blind 100
*** HOLE CARDS ***
s70n3fac3: folds 
Uncalled bet (50) returned to FDIBA2009
FDIBA2009 collected 100 from pot
*** SUMMARY ***
Total pot 100 | Rake 0 
Seat 1: s70n3fac3 (button) (small blind) folded before Flop
Seat 2: FDIBA2009 (big blind) collected (100)



PokerStars Home Game Hand #225970382347: {Club #4781089}  Hold'em No Limit (50/100) - 2021/04/18 22:28:31 EET [2021/04/18 15:28:31 ET]
Table 'Session 3' 2-max (Play Money) Seat #2 is the button
Seat 1: s70n3fac3 (7086 in chips) 
Seat 2: FDIBA2009 (12053 in chips) 
FDIBA2009: posts small blind 50
s70n3fac3: posts big blind 100
*** HOLE CARDS ***
FDIBA2009: raises 200 to 300
s70n3fac3: raises 500 to 800
FDIBA2009: calls 500
*** FLOP *** [Jd 3h 3c]
s70n3fac3: checks 
FDIBA2009: checks 
*** TURN *** [Jd 3h 3c] [9c]
s70n3fac3: bets 550
FDIBA2009: folds 
Uncalled bet (550) returned to s70n3fac3
s70n3fac3 collected 1512 from pot
s70n3fac3: doesn't show hand 
*** SUMMARY ***
Total pot 1600 | Rake 88 
Board [Jd 3h 3c 9c]
Seat 1: s70n3fac3 (big blind) collected (1512)
Seat 2: FDIBA2009 (button) (small blind) folded on the Turn



PokerStars Home Game Hand #225970414087: {Club #4781089}  Hold'em No Limit (50/100) - 2021/04/18 22:29:12 EET [2021/04/18 15:29:12 ET]
Table 'Session 3' 2-max (Play Money) Seat #1 is the button
Seat 1: s70n3fac3 (7798 in chips) 
Seat 2: FDIBA2009 (11253 in chips) 
s70n3fac3: posts small blind 50
FDIBA2009: posts big blind 100
*** HOLE CARDS ***
s70n3fac3: folds 
Uncalled bet (50) returned to FDIBA2009
FDIBA2009 collected 100 from pot
*** SUMMARY ***
Total pot 100 | Rake 0 
Seat 1: s70n3fac3 (button) (small blind) folded before Flop
Seat 2: FDIBA2009 (big blind) collected (100)



PokerStars Home Game Hand #225970417834: {Club #4781089}  Hold'em No Limit (50/100) - 2021/04/18 22:29:16 EET [2021/04/18 15:29:16 ET]
Table 'Session 3' 2-max (Play Money) Seat #2 is the button
Seat 1: s70n3fac3 (7748 in chips) 
Seat 2: FDIBA2009 (11303 in chips) 
FDIBA2009: posts small blind 50
s70n3fac3: posts big blind 100
*** HOLE CARDS ***
FDIBA2009: raises 100 to 200
s70n3fac3: calls 100
*** FLOP *** [Ah 7d 3d]
s70n3fac3: checks 
FDIBA2009: bets 189
s70n3fac3: folds 
Uncalled bet (189) returned to FDIBA2009
FDIBA2009 collected 378 from pot
*** SUMMARY ***
Total pot 400 | Rake 22 
Board [Ah 7d 3d]
Seat 1: s70n3fac3 (big blind) folded on the Flop
Seat 2: FDIBA2009 (button) (small blind) collected (378)



PokerStars Home Game Hand #225970430903: {Club #4781089}  Hold'em No Limit (50/100) - 2021/04/18 22:29:33 EET [2021/04/18 15:29:33 ET]
Table 'Session 3' 2-max (Play Money) Seat #1 is the button
Seat 1: s70n3fac3 (7548 in chips) 
Seat 2: FDIBA2009 (11481 in chips) 
s70n3fac3: posts small blind 50
FDIBA2009: posts big blind 100
*** HOLE CARDS ***
s70n3fac3: folds 
Uncalled bet (50) returned to FDIBA2009
FDIBA2009 collected 100 from pot
*** SUMMARY ***
Total pot 100 | Rake 0 
Seat 1: s70n3fac3 (button) (small blind) folded before Flop
Seat 2: FDIBA2009 (big blind) collected (100)



PokerStars Home Game Hand #225970434145: {Club #4781089}  Hold'em No Limit (50/100) - 2021/04/18 22:29:37 EET [2021/04/18 15:29:37 ET]
Table 'Session 3' 2-max (Play Money) Seat #2 is the button
Seat 1: s70n3fac3 (7498 in chips) 
Seat 2: FDIBA2009 (11531 in chips) 
FDIBA2009: posts small blind 50
s70n3fac3: posts big blind 100
*** HOLE CARDS ***
FDIBA2009: raises 200 to 300
s70n3fac3: folds 
Uncalled bet (200) returned to FDIBA2009
FDIBA2009 collected 200 from pot
*** SUMMARY ***
Total pot 200 | Rake 0 
Seat 1: s70n3fac3 (big blind) folded before Flop
Seat 2: FDIBA2009 (button) (small blind) collected (200)



PokerStars Home Game Hand #225970439806: {Club #4781089}  Hold'em No Limit (50/100) - 2021/04/18 22:29:44 EET [2021/04/18 15:29:44 ET]
Table 'Session 3' 2-max (Play Money) Seat #1 is the button
Seat 1: s70n3fac3 (7398 in chips) 
Seat 2: FDIBA2009 (11631 in chips) 
s70n3fac3: posts small blind 50
FDIBA2009: posts big blind 100
*** HOLE CARDS ***
s70n3fac3: raises 100 to 200
FDIBA2009: calls 100
*** FLOP *** [3c 4c 6c]
FDIBA2009: checks 
s70n3fac3: checks 
*** TURN *** [3c 4c 6c] [As]
FDIBA2009: bets 189
s70n3fac3: raises 291 to 480
FDIBA2009: folds 
Uncalled bet (291) returned to s70n3fac3
s70n3fac3 collected 735 from pot
s70n3fac3: doesn't show hand 
*** SUMMARY ***
Total pot 778 | Rake 43 
Board [3c 4c 6c As]
Seat 1: s70n3fac3 (button) (small blind) collected (735)
Seat 2: FDIBA2009 (big blind) folded on the Turn



PokerStars Home Game Hand #225970460336: {Club #4781089}  Hold'em No Limit (50/100) - 2021/04/18 22:30:09 EET [2021/04/18 15:30:09 ET]
Table 'Session 3' 2-max (Play Money) Seat #2 is the button
Seat 1: s70n3fac3 (7744 in chips) 
Seat 2: FDIBA2009 (11242 in chips) 
FDIBA2009: posts small blind 50
s70n3fac3: posts big blind 100
*** HOLE CARDS ***
FDIBA2009: raises 200 to 300
s70n3fac3: folds 
Uncalled bet (200) returned to FDIBA2009
FDIBA2009 collected 200 from pot
*** SUMMARY ***
Total pot 200 | Rake 0 
Seat 1: s70n3fac3 (big blind) folded before Flop
Seat 2: FDIBA2009 (button) (small blind) collected (200)



PokerStars Home Game Hand #225970465602: {Club #4781089}  Hold'em No Limit (50/100) - 2021/04/18 22:30:15 EET [2021/04/18 15:30:15 ET]
Table 'Session 3' 2-max (Play Money) Seat #1 is the button
Seat 1: s70n3fac3 (7644 in chips) 
Seat 2: FDIBA2009 (11342 in chips) 
s70n3fac3: posts small blind 50
FDIBA2009: posts big blind 100
*** HOLE CARDS ***
s70n3fac3: raises 150 to 250
FDIBA2009: folds 
Uncalled bet (150) returned to s70n3fac3
s70n3fac3 collected 200 from pot
s70n3fac3: doesn't show hand 
*** SUMMARY ***
Total pot 200 | Rake 0 
Seat 1: s70n3fac3 (button) (small blind) collected (200)
Seat 2: FDIBA2009 (big blind) folded before Flop



PokerStars Home Game Hand #225970471393: {Club #4781089}  Hold'em No Limit (50/100) - 2021/04/18 22:30:22 EET [2021/04/18 15:30:22 ET]
Table 'Session 3' 2-max (Play Money) Seat #2 is the button
Seat 1: s70n3fac3 (7744 in chips) 
Seat 2: FDIBA2009 (11242 in chips) 
FDIBA2009: posts small blind 50
s70n3fac3: posts big blind 100
*** HOLE CARDS ***
FDIBA2009: folds 
Uncalled bet (50) returned to s70n3fac3
s70n3fac3 collected 100 from pot
s70n3fac3: doesn't show hand 
*** SUMMARY ***
Total pot 100 | Rake 0 
Seat 1: s70n3fac3 (big blind) collected (100)
Seat 2: FDIBA2009 (button) (small blind) folded before Flop



PokerStars Home Game Hand #225970474958: {Club #4781089}  Hold'em No Limit (50/100) - 2021/04/18 22:30:27 EET [2021/04/18 15:30:27 ET]
Table 'Session 3' 2-max (Play Money) Seat #1 is the button
Seat 1: s70n3fac3 (7794 in chips) 
Seat 2: FDIBA2009 (11192 in chips) 
s70n3fac3: posts small blind 50
FDIBA2009: posts big blind 100
*** HOLE CARDS ***
s70n3fac3: raises 100 to 200
FDIBA2009: calls 100
*** FLOP *** [6h 4d 9c]
FDIBA2009: checks 
s70n3fac3: bets 200
FDIBA2009: calls 200
*** TURN *** [6h 4d 9c] [5h]
FDIBA2009: checks 
s70n3fac3: checks 
*** RIVER *** [6h 4d 9c 5h] [As]
FDIBA2009: bets 600
s70n3fac3: raises 825 to 1425
FDIBA2009: folds 
Uncalled bet (825) returned to s70n3fac3
s70n3fac3 collected 1890 from pot
s70n3fac3: doesn't show hand 
*** SUMMARY ***
Total pot 2000 | Rake 110 
Board [6h 4d 9c 5h As]
Seat 1: s70n3fac3 (button) (small blind) collected (1890)
Seat 2: FDIBA2009 (big blind) folded on the River



PokerStars Home Game Hand #225970514522: {Club #4781089}  Hold'em No Limit (50/100) - 2021/04/18 22:31:16 EET [2021/04/18 15:31:16 ET]
Table 'Session 3' 2-max (Play Money) Seat #2 is the button
Seat 1: s70n3fac3 (8684 in chips) 
Seat 2: FDIBA2009 (10192 in chips) 
FDIBA2009: posts small blind 50
s70n3fac3: posts big blind 100
*** HOLE CARDS ***
FDIBA2009: raises 100 to 200
s70n3fac3: folds 
Uncalled bet (100) returned to FDIBA2009
FDIBA2009 collected 200 from pot
*** SUMMARY ***
Total pot 200 | Rake 0 
Seat 1: s70n3fac3 (big blind) folded before Flop
Seat 2: FDIBA2009 (button) (small blind) collected (200)



PokerStars Home Game Hand #225970519934: {Club #4781089}  Hold'em No Limit (50/100) - 2021/04/18 22:31:23 EET [2021/04/18 15:31:23 ET]
Table 'Session 3' 2-max (Play Money) Seat #1 is the button
Seat 1: s70n3fac3 (8584 in chips) 
Seat 2: FDIBA2009 (10292 in chips) 
s70n3fac3: posts small blind 50
FDIBA2009: posts big blind 100
*** HOLE CARDS ***
s70n3fac3: folds 
Uncalled bet (50) returned to FDIBA2009
FDIBA2009 collected 100 from pot
*** SUMMARY ***
Total pot 100 | Rake 0 
Seat 1: s70n3fac3 (button) (small blind) folded before Flop
Seat 2: FDIBA2009 (big blind) collected (100)



PokerStars Home Game Hand #225970523748: {Club #4781089}  Hold'em No Limit (50/100) - 2021/04/18 22:31:27 EET [2021/04/18 15:31:27 ET]
Table 'Session 3' 2-max (Play Money) Seat #2 is the button
Seat 1: s70n3fac3 (8534 in chips) 
Seat 2: FDIBA2009 (10342 in chips) 
FDIBA2009: posts small blind 50
s70n3fac3: posts big blind 100
*** HOLE CARDS ***
FDIBA2009: raises 100 to 200
s70n3fac3: calls 100
*** FLOP *** [Jh Ah 9c]
s70n3fac3: checks 
FDIBA2009: bets 189
s70n3fac3: calls 189
*** TURN *** [Jh Ah 9c] [5h]
s70n3fac3: checks 
FDIBA2009: checks 
*** RIVER *** [Jh Ah 9c 5h] [9h]
s70n3fac3: checks 
FDIBA2009: checks 
*** SHOW DOWN ***
s70n3fac3: shows [Js Td] (two pair, Jacks and Nines)
FDIBA2009: mucks hand 
s70n3fac3 collected 735 from pot
*** SUMMARY ***
Total pot 778 | Rake 43 
Board [Jh Ah 9c 5h 9h]
Seat 1: s70n3fac3 (big blind) showed [Js Td] and won (735) with two pair, Jacks and Nines
Seat 2: FDIBA2009 (button) (small blind) mucked [3d 3c]



PokerStars Home Game Hand #225970543666: {Club #4781089}  Hold'em No Limit (50/100) - 2021/04/18 22:31:52 EET [2021/04/18 15:31:52 ET]
Table 'Session 3' 2-max (Play Money) Seat #1 is the button
Seat 1: s70n3fac3 (8880 in chips) 
Seat 2: FDIBA2009 (9953 in chips) 
s70n3fac3: posts small blind 50
FDIBA2009: posts big blind 100
*** HOLE CARDS ***
s70n3fac3: folds 
Uncalled bet (50) returned to FDIBA2009
FDIBA2009 collected 100 from pot
*** SUMMARY ***
Total pot 100 | Rake 0 
Seat 1: s70n3fac3 (button) (small blind) folded before Flop
Seat 2: FDIBA2009 (big blind) collected (100)



PokerStars Home Game Hand #225970546933: {Club #4781089}  Hold'em No Limit (50/100) - 2021/04/18 22:31:56 EET [2021/04/18 15:31:56 ET]
Table 'Session 3' 2-max (Play Money) Seat #2 is the button
Seat 1: s70n3fac3 (8830 in chips) 
Seat 2: FDIBA2009 (10003 in chips) 
FDIBA2009: posts small blind 50
s70n3fac3: posts big blind 100
*** HOLE CARDS ***
FDIBA2009: raises 100 to 200
s70n3fac3: calls 100
*** FLOP *** [8c Js 5h]
s70n3fac3: checks 
FDIBA2009: bets 189
s70n3fac3: folds 
Uncalled bet (189) returned to FDIBA2009
FDIBA2009 collected 378 from pot
*** SUMMARY ***
Total pot 400 | Rake 22 
Board [8c Js 5h]
Seat 1: s70n3fac3 (big blind) folded on the Flop
Seat 2: FDIBA2009 (button) (small blind) collected (378)



PokerStars Home Game Hand #225970556432: {Club #4781089}  Hold'em No Limit (50/100) - 2021/04/18 22:32:08 EET [2021/04/18 15:32:08 ET]
Table 'Session 3' 2-max (Play Money) Seat #1 is the button
Seat 1: s70n3fac3 (8630 in chips) 
Seat 2: FDIBA2009 (10181 in chips) 
s70n3fac3: posts small blind 50
FDIBA2009: posts big blind 100
*** HOLE CARDS ***
s70n3fac3: raises 150 to 250
FDIBA2009: calls 150
*** FLOP *** [7d Ad 2s]
FDIBA2009: checks 
s70n3fac3: bets 245
FDIBA2009: raises 962 to 1207
s70n3fac3: calls 962
*** TURN *** [7d Ad 2s] [As]
FDIBA2009: bets 2754
s70n3fac3: folds 
Uncalled bet (2754) returned to FDIBA2009
FDIBA2009 collected 2754 from pot
*** SUMMARY ***
Total pot 2914 | Rake 160 
Board [7d Ad 2s As]
Seat 1: s70n3fac3 (button) (small blind) folded on the Turn
Seat 2: FDIBA2009 (big blind) collected (2754)



PokerStars Home Game Hand #225970590520: {Club #4781089}  Hold'em No Limit (50/100) - 2021/04/18 22:32:50 EET [2021/04/18 15:32:50 ET]
Table 'Session 3' 2-max (Play Money) Seat #2 is the button
Seat 1: s70n3fac3 (7173 in chips) 
Seat 2: FDIBA2009 (11478 in chips) 
FDIBA2009: posts small blind 50
s70n3fac3: posts big blind 100
*** HOLE CARDS ***
FDIBA2009: raises 100 to 200
s70n3fac3: raises 300 to 500
FDIBA2009: calls 300
*** FLOP *** [7h 4h Td]
s70n3fac3: bets 485
FDIBA2009: folds 
Uncalled bet (485) returned to s70n3fac3
s70n3fac3 collected 945 from pot
s70n3fac3: doesn't show hand 
*** SUMMARY ***
Total pot 1000 | Rake 55 
Board [7h 4h Td]
Seat 1: s70n3fac3 (big blind) collected (945)
Seat 2: FDIBA2009 (button) (small blind) folded on the Flop



PokerStars Home Game Hand #225970609283: {Club #4781089}  Hold'em No Limit (50/100) - 2021/04/18 22:33:06 EET [2021/04/18 15:33:06 ET]
Table 'Session 3' 2-max (Play Money) Seat #1 is the button
Seat 1: s70n3fac3 (7618 in chips) 
Seat 2: FDIBA2009 (10978 in chips) 
s70n3fac3: posts small blind 50
FDIBA2009: posts big blind 100
*** HOLE CARDS ***
s70n3fac3: raises 150 to 250
FDIBA2009: folds 
Uncalled bet (150) returned to s70n3fac3
s70n3fac3 collected 200 from pot
s70n3fac3: doesn't show hand 
*** SUMMARY ***
Total pot 200 | Rake 0 
Seat 1: s70n3fac3 (button) (small blind) collected (200)
Seat 2: FDIBA2009 (big blind) folded before Flop



PokerStars Home Game Hand #225970614093: {Club #4781089}  Hold'em No Limit (50/100) - 2021/04/18 22:33:12 EET [2021/04/18 15:33:12 ET]
Table 'Session 3' 2-max (Play Money) Seat #2 is the button
Seat 1: s70n3fac3 (7718 in chips) 
Seat 2: FDIBA2009 (10878 in chips) 
FDIBA2009: posts small blind 50
s70n3fac3: posts big blind 100
*** HOLE CARDS ***
FDIBA2009: raises 100 to 200
s70n3fac3: calls 100
*** FLOP *** [Ts 7d 7s]
s70n3fac3: checks 
FDIBA2009: bets 189
s70n3fac3: calls 189
*** TURN *** [Ts 7d 7s] [5d]
s70n3fac3: checks 
FDIBA2009: bets 367
s70n3fac3: calls 367
*** RIVER *** [Ts 7d 7s 5d] [4c]
s70n3fac3: checks 
FDIBA2009: checks 
*** SHOW DOWN ***
s70n3fac3: shows [Ac 5s] (two pair, Sevens and Fives)
FDIBA2009: mucks hand 
s70n3fac3 collected 1429 from pot
*** SUMMARY ***
Total pot 1512 | Rake 83 
Board [Ts 7d 7s 5d 4c]
Seat 1: s70n3fac3 (big blind) showed [Ac 5s] and won (1429) with two pair, Sevens and Fives
Seat 2: FDIBA2009 (button) (small blind) mucked [3s 9s]



PokerStars Home Game Hand #225970636542: {Club #4781089}  Hold'em No Limit (50/100) - 2021/04/18 22:33:39 EET [2021/04/18 15:33:39 ET]
Table 'Session 3' 2-max (Play Money) Seat #1 is the button
Seat 1: s70n3fac3 (8391 in chips) 
Seat 2: FDIBA2009 (10122 in chips) 
s70n3fac3: posts small blind 50
FDIBA2009: posts big blind 100
*** HOLE CARDS ***
s70n3fac3: raises 150 to 250
FDIBA2009: folds 
Uncalled bet (150) returned to s70n3fac3
s70n3fac3 collected 200 from pot
s70n3fac3: doesn't show hand 
*** SUMMARY ***
Total pot 200 | Rake 0 
Seat 1: s70n3fac3 (button) (small blind) collected (200)
Seat 2: FDIBA2009 (big blind) folded before Flop



PokerStars Home Game Hand #225970640946: {Club #4781089}  Hold'em No Limit (50/100) - 2021/04/18 22:33:45 EET [2021/04/18 15:33:45 ET]
Table 'Session 3' 2-max (Play Money) Seat #2 is the button
Seat 1: s70n3fac3 (8491 in chips) 
Seat 2: FDIBA2009 (10022 in chips) 
FDIBA2009: posts small blind 50
s70n3fac3: posts big blind 100
*** HOLE CARDS ***
FDIBA2009: raises 100 to 200
s70n3fac3: calls 100
*** FLOP *** [4h 5d Tc]
s70n3fac3: checks 
FDIBA2009: bets 189
s70n3fac3: calls 189
*** TURN *** [4h 5d Tc] [3c]
s70n3fac3: checks 
FDIBA2009: bets 735
s70n3fac3: folds 
Uncalled bet (735) returned to FDIBA2009
FDIBA2009 collected 735 from pot
*** SUMMARY ***
Total pot 778 | Rake 43 
Board [4h 5d Tc 3c]
Seat 1: s70n3fac3 (big blind) folded on the Turn
Seat 2: FDIBA2009 (button) (small blind) collected (735)



PokerStars Home Game Hand #225970659379: {Club #4781089}  Hold'em No Limit (50/100) - 2021/04/18 22:34:08 EET [2021/04/18 15:34:08 ET]
Table 'Session 3' 2-max (Play Money) Seat #1 is the button
Seat 1: s70n3fac3 (8102 in chips) 
Seat 2: FDIBA2009 (10368 in chips) 
s70n3fac3: posts small blind 50
FDIBA2009: posts big blind 100
*** HOLE CARDS ***
s70n3fac3: folds 
Uncalled bet (50) returned to FDIBA2009
FDIBA2009 collected 100 from pot
*** SUMMARY ***
Total pot 100 | Rake 0 
Seat 1: s70n3fac3 (button) (small blind) folded before Flop
Seat 2: FDIBA2009 (big blind) collected (100)



PokerStars Home Game Hand #225970662282: {Club #4781089}  Hold'em No Limit (50/100) - 2021/04/18 22:34:12 EET [2021/04/18 15:34:12 ET]
Table 'Session 3' 2-max (Play Money) Seat #2 is the button
Seat 1: s70n3fac3 (8052 in chips) 
Seat 2: FDIBA2009 (10418 in chips) 
FDIBA2009: posts small blind 50
s70n3fac3: posts big blind 100
*** HOLE CARDS ***
FDIBA2009: raises 100 to 200
s70n3fac3: calls 100
*** FLOP *** [6h Qd Ac]
s70n3fac3: checks 
FDIBA2009: bets 189
s70n3fac3: folds 
Uncalled bet (189) returned to FDIBA2009
FDIBA2009 collected 378 from pot
*** SUMMARY ***
Total pot 400 | Rake 22 
Board [6h Qd Ac]
Seat 1: s70n3fac3 (big blind) folded on the Flop
Seat 2: FDIBA2009 (button) (small blind) collected (378)



PokerStars Home Game Hand #225970673882: {Club #4781089}  Hold'em No Limit (50/100) - 2021/04/18 22:34:26 EET [2021/04/18 15:34:26 ET]
Table 'Session 3' 2-max (Play Money) Seat #1 is the button
Seat 1: s70n3fac3 (7852 in chips) 
Seat 2: FDIBA2009 (10596 in chips) 
s70n3fac3: posts small blind 50
FDIBA2009: posts big blind 100
*** HOLE CARDS ***
s70n3fac3: folds 
Uncalled bet (50) returned to FDIBA2009
FDIBA2009 collected 100 from pot
*** SUMMARY ***
Total pot 100 | Rake 0 
Seat 1: s70n3fac3 (button) (small blind) folded before Flop
Seat 2: FDIBA2009 (big blind) collected (100)



PokerStars Home Game Hand #225970677112: {Club #4781089}  Hold'em No Limit (50/100) - 2021/04/18 22:34:30 EET [2021/04/18 15:34:30 ET]
Table 'Session 3' 2-max (Play Money) Seat #2 is the button
Seat 1: s70n3fac3 (7802 in chips) 
Seat 2: FDIBA2009 (10646 in chips) 
FDIBA2009: posts small blind 50
s70n3fac3: posts big blind 100
*** HOLE CARDS ***
FDIBA2009: raises 100 to 200
s70n3fac3: raises 300 to 500
FDIBA2009: calls 300
*** FLOP *** [6s 2c Td]
s70n3fac3: bets 485
FDIBA2009: calls 485
*** TURN *** [6s 2c Td] [5h]
s70n3fac3: bets 865
FDIBA2009: folds 
Uncalled bet (865) returned to s70n3fac3
s70n3fac3 collected 1862 from pot
s70n3fac3: doesn't show hand 
*** SUMMARY ***
Total pot 1970 | Rake 108 
Board [6s 2c Td 5h]
Seat 1: s70n3fac3 (big blind) collected (1862)
Seat 2: FDIBA2009 (button) (small blind) folded on the Turn



PokerStars Home Game Hand #225970702724: {Club #4781089}  Hold'em No Limit (50/100) - 2021/04/18 22:35:02 EET [2021/04/18 15:35:02 ET]
Table 'Session 3' 2-max (Play Money) Seat #1 is the button
Seat 1: s70n3fac3 (8679 in chips) 
Seat 2: FDIBA2009 (9661 in chips) 
s70n3fac3: posts small blind 50
FDIBA2009: posts big blind 100
*** HOLE CARDS ***
s70n3fac3: folds 
Uncalled bet (50) returned to FDIBA2009
FDIBA2009 collected 100 from pot
*** SUMMARY ***
Total pot 100 | Rake 0 
Seat 1: s70n3fac3 (button) (small blind) folded before Flop
Seat 2: FDIBA2009 (big blind) collected (100)



PokerStars Home Game Hand #225970706088: {Club #4781089}  Hold'em No Limit (50/100) - 2021/04/18 22:35:06 EET [2021/04/18 15:35:06 ET]
Table 'Session 3' 2-max (Play Money) Seat #2 is the button
Seat 1: s70n3fac3 (8629 in chips) 
Seat 2: FDIBA2009 (9711 in chips) 
FDIBA2009: posts small blind 50
s70n3fac3: posts big blind 100
*** HOLE CARDS ***
FDIBA2009: raises 100 to 200
s70n3fac3: calls 100
*** FLOP *** [3s 3d 3c]
s70n3fac3: checks 
FDIBA2009: checks 
*** TURN *** [3s 3d 3c] [8d]
s70n3fac3: checks 
FDIBA2009: checks 
*** RIVER *** [3s 3d 3c 8d] [5c]
s70n3fac3: checks 
FDIBA2009: bets 378
s70n3fac3: folds 
Uncalled bet (378) returned to FDIBA2009
FDIBA2009 collected 378 from pot
*** SUMMARY ***
Total pot 400 | Rake 22 
Board [3s 3d 3c 8d 5c]
Seat 1: s70n3fac3 (big blind) folded on the River
Seat 2: FDIBA2009 (button) (small blind) collected (378)



PokerStars Home Game Hand #225970722913: {Club #4781089}  Hold'em No Limit (50/100) - 2021/04/18 22:35:27 EET [2021/04/18 15:35:27 ET]
Table 'Session 3' 2-max (Play Money) Seat #1 is the button
Seat 1: s70n3fac3 (8429 in chips) 
Seat 2: FDIBA2009 (9889 in chips) 
s70n3fac3: posts small blind 50
FDIBA2009: posts big blind 100
*** HOLE CARDS ***
s70n3fac3: folds 
Uncalled bet (50) returned to FDIBA2009
FDIBA2009 collected 100 from pot
*** SUMMARY ***
Total pot 100 | Rake 0 
Seat 1: s70n3fac3 (button) (small blind) folded before Flop
Seat 2: FDIBA2009 (big blind) collected (100)



PokerStars Home Game Hand #225970726013: {Club #4781089}  Hold'em No Limit (50/100) - 2021/04/18 22:35:31 EET [2021/04/18 15:35:31 ET]
Table 'Session 3' 2-max (Play Money) Seat #2 is the button
Seat 1: s70n3fac3 (8379 in chips) 
Seat 2: FDIBA2009 (9939 in chips) 
FDIBA2009: posts small blind 50
s70n3fac3: posts big blind 100
*** HOLE CARDS ***
FDIBA2009: raises 100 to 200
s70n3fac3: folds 
Uncalled bet (100) returned to FDIBA2009
FDIBA2009 collected 200 from pot
*** SUMMARY ***
Total pot 200 | Rake 0 
Seat 1: s70n3fac3 (big blind) folded before Flop
Seat 2: FDIBA2009 (button) (small blind) collected (200)



PokerStars Home Game Hand #225970731351: {Club #4781089}  Hold'em No Limit (50/100) - 2021/04/18 22:35:37 EET [2021/04/18 15:35:37 ET]
Table 'Session 3' 2-max (Play Money) Seat #1 is the button
Seat 1: s70n3fac3 (8279 in chips) 
Seat 2: FDIBA2009 (10039 in chips) 
s70n3fac3: posts small blind 50
FDIBA2009: posts big blind 100
*** HOLE CARDS ***
s70n3fac3: raises 150 to 250
FDIBA2009: calls 150
*** FLOP *** [2d Ac 7s]
FDIBA2009: checks 
s70n3fac3: bets 260
FDIBA2009: folds 
Uncalled bet (260) returned to s70n3fac3
s70n3fac3 collected 472 from pot
s70n3fac3: doesn't show hand 
*** SUMMARY ***
Total pot 500 | Rake 28 
Board [2d Ac 7s]
Seat 1: s70n3fac3 (button) (small blind) collected (472)
Seat 2: FDIBA2009 (big blind) folded on the Flop



PokerStars Home Game Hand #225970741806: {Club #4781089}  Hold'em No Limit (50/100) - 2021/04/18 22:35:50 EET [2021/04/18 15:35:50 ET]
Table 'Session 3' 2-max (Play Money) Seat #2 is the button
Seat 1: s70n3fac3 (8501 in chips) 
Seat 2: FDIBA2009 (9789 in chips) 
FDIBA2009: posts small blind 50
s70n3fac3: posts big blind 100
*** HOLE CARDS ***
FDIBA2009: raises 100 to 200
s70n3fac3: calls 100
*** FLOP *** [2h 7d 6d]
s70n3fac3: checks 
FDIBA2009: bets 189
s70n3fac3: calls 189
*** TURN *** [2h 7d 6d] [9d]
s70n3fac3: checks 
FDIBA2009: bets 367
s70n3fac3: raises 433 to 800
FDIBA2009: folds 
Uncalled bet (433) returned to s70n3fac3
s70n3fac3 collected 1429 from pot
s70n3fac3: doesn't show hand 
*** SUMMARY ***
Total pot 1512 | Rake 83 
Board [2h 7d 6d 9d]
Seat 1: s70n3fac3 (big blind) collected (1429)
Seat 2: FDIBA2009 (button) (small blind) folded on the Turn



PokerStars Home Game Hand #225970761331: {Club #4781089}  Hold'em No Limit (50/100) - 2021/04/18 22:36:15 EET [2021/04/18 15:36:15 ET]
Table 'Session 3' 2-max (Play Money) Seat #1 is the button
Seat 1: s70n3fac3 (9174 in chips) 
Seat 2: FDIBA2009 (9033 in chips) 
s70n3fac3: posts small blind 50
FDIBA2009: posts big blind 100
*** HOLE CARDS ***
s70n3fac3: raises 100 to 200
FDIBA2009: calls 100
*** FLOP *** [Ah Jc Ad]
FDIBA2009: checks 
s70n3fac3: bets 200
FDIBA2009: folds 
Uncalled bet (200) returned to s70n3fac3
s70n3fac3 collected 378 from pot
s70n3fac3: doesn't show hand 
*** SUMMARY ***
Total pot 400 | Rake 22 
Board [Ah Jc Ad]
Seat 1: s70n3fac3 (button) (small blind) collected (378)
Seat 2: FDIBA2009 (big blind) folded on the Flop



PokerStars Home Game Hand #225970770404: {Club #4781089}  Hold'em No Limit (50/100) - 2021/04/18 22:36:26 EET [2021/04/18 15:36:26 ET]
Table 'Session 3' 2-max (Play Money) Seat #2 is the button
Seat 1: s70n3fac3 (9352 in chips) 
Seat 2: FDIBA2009 (8833 in chips) 
FDIBA2009: posts small blind 50
s70n3fac3: posts big blind 100
*** HOLE CARDS ***
FDIBA2009: raises 200 to 300
s70n3fac3: folds 
Uncalled bet (200) returned to FDIBA2009
FDIBA2009 collected 200 from pot
*** SUMMARY ***
Total pot 200 | Rake 0 
Seat 1: s70n3fac3 (big blind) folded before Flop
Seat 2: FDIBA2009 (button) (small blind) collected (200)



PokerStars Home Game Hand #225970776013: {Club #4781089}  Hold'em No Limit (50/100) - 2021/04/18 22:36:33 EET [2021/04/18 15:36:33 ET]
Table 'Session 3' 2-max (Play Money) Seat #1 is the button
Seat 1: s70n3fac3 (9252 in chips) 
Seat 2: FDIBA2009 (8933 in chips) 
s70n3fac3: posts small blind 50
FDIBA2009: posts big blind 100
*** HOLE CARDS ***
s70n3fac3: raises 100 to 200
FDIBA2009: raises 400 to 600
s70n3fac3: folds 
Uncalled bet (400) returned to FDIBA2009
FDIBA2009 collected 400 from pot
*** SUMMARY ***
Total pot 400 | Rake 0 
Seat 1: s70n3fac3 (button) (small blind) folded before Flop
Seat 2: FDIBA2009 (big blind) collected (400)



PokerStars Home Game Hand #225970787567: {Club #4781089}  Hold'em No Limit (50/100) - 2021/04/18 22:36:47 EET [2021/04/18 15:36:47 ET]
Table 'Session 3' 2-max (Play Money) Seat #2 is the button
Seat 1: s70n3fac3 (9052 in chips) 
Seat 2: FDIBA2009 (9133 in chips) 
FDIBA2009: posts small blind 50
s70n3fac3: posts big blind 100
*** HOLE CARDS ***
FDIBA2009: raises 100 to 200
s70n3fac3: calls 100
*** FLOP *** [2s 9d Ks]
s70n3fac3: checks 
FDIBA2009: checks 
*** TURN *** [2s 9d Ks] [Qh]
s70n3fac3: checks 
FDIBA2009: checks 
*** RIVER *** [2s 9d Ks Qh] [Js]
s70n3fac3: bets 300
FDIBA2009: folds 
Uncalled bet (300) returned to s70n3fac3
s70n3fac3 collected 378 from pot
s70n3fac3: doesn't show hand 
*** SUMMARY ***
Total pot 400 | Rake 22 
Board [2s 9d Ks Qh Js]
Seat 1: s70n3fac3 (big blind) collected (378)
Seat 2: FDIBA2009 (button) (small blind) folded on the River



PokerStars Home Game Hand #225970804468: {Club #4781089}  Hold'em No Limit (50/100) - 2021/04/18 22:37:09 EET [2021/04/18 15:37:09 ET]
Table 'Session 3' 2-max (Play Money) Seat #1 is the button
Seat 1: s70n3fac3 (9230 in chips) 
Seat 2: FDIBA2009 (8933 in chips) 
s70n3fac3: posts small blind 50
FDIBA2009: posts big blind 100
*** HOLE CARDS ***
s70n3fac3: raises 150 to 250
FDIBA2009: folds 
Uncalled bet (150) returned to s70n3fac3
s70n3fac3 collected 200 from pot
s70n3fac3: doesn't show hand 
*** SUMMARY ***
Total pot 200 | Rake 0 
Seat 1: s70n3fac3 (button) (small blind) collected (200)
Seat 2: FDIBA2009 (big blind) folded before Flop



PokerStars Home Game Hand #225970808879: {Club #4781089}  Hold'em No Limit (50/100) - 2021/04/18 22:37:14 EET [2021/04/18 15:37:14 ET]
Table 'Session 3' 2-max (Play Money) Seat #2 is the button
Seat 1: s70n3fac3 (9330 in chips) 
Seat 2: FDIBA2009 (8833 in chips) 
FDIBA2009: posts small blind 50
s70n3fac3: posts big blind 100
*** HOLE CARDS ***
FDIBA2009: raises 200 to 300
s70n3fac3: raises 500 to 800
FDIBA2009: folds 
Uncalled bet (500) returned to s70n3fac3
s70n3fac3 collected 600 from pot
s70n3fac3: doesn't show hand 
*** SUMMARY ***
Total pot 600 | Rake 0 
Seat 1: s70n3fac3 (big blind) collected (600)
Seat 2: FDIBA2009 (button) (small blind) folded before Flop



PokerStars Home Game Hand #225970816423: {Club #4781089}  Hold'em No Limit (50/100) - 2021/04/18 22:37:23 EET [2021/04/18 15:37:23 ET]
Table 'Session 3' 2-max (Play Money) Seat #1 is the button
Seat 1: s70n3fac3 (9630 in chips) 
Seat 2: FDIBA2009 (8533 in chips) 
s70n3fac3: posts small blind 50
FDIBA2009: posts big blind 100
*** HOLE CARDS ***
s70n3fac3: folds 
Uncalled bet (50) returned to FDIBA2009
FDIBA2009 collected 100 from pot
*** SUMMARY ***
Total pot 100 | Rake 0 
Seat 1: s70n3fac3 (button) (small blind) folded before Flop
Seat 2: FDIBA2009 (big blind) collected (100)



PokerStars Home Game Hand #225970819863: {Club #4781089}  Hold'em No Limit (50/100) - 2021/04/18 22:37:28 EET [2021/04/18 15:37:28 ET]
Table 'Session 3' 2-max (Play Money) Seat #2 is the button
Seat 1: s70n3fac3 (9580 in chips) 
Seat 2: FDIBA2009 (8583 in chips) 
FDIBA2009: posts small blind 50
s70n3fac3: posts big blind 100
*** HOLE CARDS ***
FDIBA2009: raises 100 to 200
s70n3fac3: folds 
Uncalled bet (100) returned to FDIBA2009
FDIBA2009 collected 200 from pot
*** SUMMARY ***
Total pot 200 | Rake 0 
Seat 1: s70n3fac3 (big blind) folded before Flop
Seat 2: FDIBA2009 (button) (small blind) collected (200)



PokerStars Home Game Hand #225970825765: {Club #4781089}  Hold'em No Limit (50/100) - 2021/04/18 22:37:35 EET [2021/04/18 15:37:35 ET]
Table 'Session 3' 2-max (Play Money) Seat #1 is the button
Seat 1: s70n3fac3 (9480 in chips) 
Seat 2: FDIBA2009 (8683 in chips) 
s70n3fac3: posts small blind 50
FDIBA2009: posts big blind 100
*** HOLE CARDS ***
s70n3fac3: raises 100 to 200
FDIBA2009: raises 400 to 600
s70n3fac3: folds 
Uncalled bet (400) returned to FDIBA2009
FDIBA2009 collected 400 from pot
*** SUMMARY ***
Total pot 400 | Rake 0 
Seat 1: s70n3fac3 (button) (small blind) folded before Flop
Seat 2: FDIBA2009 (big blind) collected (400)



PokerStars Home Game Hand #225970834202: {Club #4781089}  Hold'em No Limit (50/100) - 2021/04/18 22:37:46 EET [2021/04/18 15:37:46 ET]
Table 'Session 3' 2-max (Play Money) Seat #2 is the button
Seat 1: s70n3fac3 (9280 in chips) 
Seat 2: FDIBA2009 (8883 in chips) 
FDIBA2009: posts small blind 50
s70n3fac3: posts big blind 100
*** HOLE CARDS ***
FDIBA2009: raises 100 to 200
s70n3fac3: calls 100
*** FLOP *** [Ad Kc 8d]
s70n3fac3: checks 
FDIBA2009: bets 378
s70n3fac3: folds 
Uncalled bet (378) returned to FDIBA2009
FDIBA2009 collected 378 from pot
*** SUMMARY ***
Total pot 400 | Rake 22 
Board [Ad Kc 8d]
Seat 1: s70n3fac3 (big blind) folded on the Flop
Seat 2: FDIBA2009 (button) (small blind) collected (378)



PokerStars Home Game Hand #225970845854: {Club #4781089}  Hold'em No Limit (50/100) - 2021/04/18 22:38:00 EET [2021/04/18 15:38:00 ET]
Table 'Session 3' 2-max (Play Money) Seat #1 is the button
Seat 1: s70n3fac3 (9080 in chips) 
Seat 2: FDIBA2009 (9061 in chips) 
s70n3fac3: posts small blind 50
FDIBA2009: posts big blind 100
*** HOLE CARDS ***
s70n3fac3: raises 100 to 200
FDIBA2009: calls 100
*** FLOP *** [Ac 8c 5s]
FDIBA2009: checks 
s70n3fac3: bets 200
FDIBA2009: calls 200
*** TURN *** [Ac 8c 5s] [Ah]
FDIBA2009: checks 
s70n3fac3: checks 
*** RIVER *** [Ac 8c 5s Ah] [4d]
FDIBA2009: bets 756
s70n3fac3: folds 
Uncalled bet (756) returned to FDIBA2009
FDIBA2009 collected 756 from pot
*** SUMMARY ***
Total pot 800 | Rake 44 
Board [Ac 8c 5s Ah 4d]
Seat 1: s70n3fac3 (button) (small blind) folded on the River
Seat 2: FDIBA2009 (big blind) collected (756)



PokerStars Home Game Hand #225970863464: {Club #4781089}  Hold'em No Limit (50/100) - 2021/04/18 22:38:22 EET [2021/04/18 15:38:22 ET]
Table 'Session 3' 2-max (Play Money) Seat #2 is the button
Seat 1: s70n3fac3 (8680 in chips) 
Seat 2: FDIBA2009 (9417 in chips) 
FDIBA2009: posts small blind 50
s70n3fac3: posts big blind 100
*** HOLE CARDS ***
FDIBA2009: raises 100 to 200
s70n3fac3: folds 
Uncalled bet (100) returned to FDIBA2009
FDIBA2009 collected 200 from pot
*** SUMMARY ***
Total pot 200 | Rake 0 
Seat 1: s70n3fac3 (big blind) folded before Flop
Seat 2: FDIBA2009 (button) (small blind) collected (200)



PokerStars Home Game Hand #225970868515: {Club #4781089}  Hold'em No Limit (50/100) - 2021/04/18 22:38:28 EET [2021/04/18 15:38:28 ET]
Table 'Session 3' 2-max (Play Money) Seat #1 is the button
Seat 1: s70n3fac3 (8580 in chips) 
Seat 2: FDIBA2009 (9517 in chips) 
s70n3fac3: posts small blind 50
FDIBA2009: posts big blind 100
*** HOLE CARDS ***
s70n3fac3: raises 100 to 200
FDIBA2009: folds 
Uncalled bet (100) returned to s70n3fac3
s70n3fac3 collected 200 from pot
s70n3fac3: doesn't show hand 
*** SUMMARY ***
Total pot 200 | Rake 0 
Seat 1: s70n3fac3 (button) (small blind) collected (200)
Seat 2: FDIBA2009 (big blind) folded before Flop



PokerStars Home Game Hand #225970872954: {Club #4781089}  Hold'em No Limit (50/100) - 2021/04/18 22:38:34 EET [2021/04/18 15:38:34 ET]
Table 'Session 3' 2-max (Play Money) Seat #2 is the button
Seat 1: s70n3fac3 (8680 in chips) 
Seat 2: FDIBA2009 (9417 in chips) 
FDIBA2009: posts small blind 50
s70n3fac3: posts big blind 100
*** HOLE CARDS ***
FDIBA2009: raises 100 to 200
s70n3fac3: folds 
Uncalled bet (100) returned to FDIBA2009
FDIBA2009 collected 200 from pot
*** SUMMARY ***
Total pot 200 | Rake 0 
Seat 1: s70n3fac3 (big blind) folded before Flop
Seat 2: FDIBA2009 (button) (small blind) collected (200)



PokerStars Home Game Hand #225970877500: {Club #4781089}  Hold'em No Limit (50/100) - 2021/04/18 22:38:40 EET [2021/04/18 15:38:40 ET]
Table 'Session 3' 2-max (Play Money) Seat #1 is the button
Seat 1: s70n3fac3 (8580 in chips) 
Seat 2: FDIBA2009 (9517 in chips) 
s70n3fac3: posts small blind 50
FDIBA2009: posts big blind 100
*** HOLE CARDS ***
s70n3fac3: raises 100 to 200
FDIBA2009: raises 400 to 600
s70n3fac3: folds 
Uncalled bet (400) returned to FDIBA2009
FDIBA2009 collected 400 from pot
*** SUMMARY ***
Total pot 400 | Rake 0 
Seat 1: s70n3fac3 (button) (small blind) folded before Flop
Seat 2: FDIBA2009 (big blind) collected (400)



PokerStars Home Game Hand #225970883832: {Club #4781089}  Hold'em No Limit (50/100) - 2021/04/18 22:38:48 EET [2021/04/18 15:38:48 ET]
Table 'Session 3' 2-max (Play Money) Seat #2 is the button
Seat 1: s70n3fac3 (8380 in chips) 
Seat 2: FDIBA2009 (9717 in chips) 
FDIBA2009: posts small blind 50
s70n3fac3: posts big blind 100
*** HOLE CARDS ***
FDIBA2009: raises 100 to 200
s70n3fac3: calls 100
*** FLOP *** [3d 9c 9d]
s70n3fac3: checks 
FDIBA2009: checks 
*** TURN *** [3d 9c 9d] [Ts]
s70n3fac3: checks 
FDIBA2009: checks 
*** RIVER *** [3d 9c 9d Ts] [7s]
s70n3fac3: checks 
FDIBA2009: bets 378
s70n3fac3: folds 
Uncalled bet (378) returned to FDIBA2009
FDIBA2009 collected 378 from pot
*** SUMMARY ***
Total pot 400 | Rake 22 
Board [3d 9c 9d Ts 7s]
Seat 1: s70n3fac3 (big blind) folded on the River
Seat 2: FDIBA2009 (button) (small blind) collected (378)



PokerStars Home Game Hand #225970904813: {Club #4781089}  Hold'em No Limit (50/100) - 2021/04/18 22:39:06 EET [2021/04/18 15:39:06 ET]
Table 'Session 3' 2-max (Play Money) Seat #1 is the button
Seat 1: s70n3fac3 (8180 in chips) 
Seat 2: FDIBA2009 (9895 in chips) 
s70n3fac3: posts small blind 50
FDIBA2009: posts big blind 100
*** HOLE CARDS ***
s70n3fac3: folds 
Uncalled bet (50) returned to FDIBA2009
FDIBA2009 collected 100 from pot
*** SUMMARY ***
Total pot 100 | Rake 0 
Seat 1: s70n3fac3 (button) (small blind) folded before Flop
Seat 2: FDIBA2009 (big blind) collected (100)



PokerStars Home Game Hand #225970907923: {Club #4781089}  Hold'em No Limit (50/100) - 2021/04/18 22:39:10 EET [2021/04/18 15:39:10 ET]
Table 'Session 3' 2-max (Play Money) Seat #2 is the button
Seat 1: s70n3fac3 (8130 in chips) 
Seat 2: FDIBA2009 (9945 in chips) 
FDIBA2009: posts small blind 50
s70n3fac3: posts big blind 100
*** HOLE CARDS ***
FDIBA2009: raises 100 to 200
s70n3fac3: calls 100
*** FLOP *** [5s Td Qc]
s70n3fac3: checks 
FDIBA2009: checks 
*** TURN *** [5s Td Qc] [2d]
s70n3fac3: checks 
FDIBA2009: checks 
*** RIVER *** [5s Td Qc 2d] [3d]
s70n3fac3: bets 300
FDIBA2009: folds 
Uncalled bet (300) returned to s70n3fac3
s70n3fac3 collected 378 from pot
s70n3fac3: doesn't show hand 
*** SUMMARY ***
Total pot 400 | Rake 22 
Board [5s Td Qc 2d 3d]
Seat 1: s70n3fac3 (big blind) collected (378)
Seat 2: FDIBA2009 (button) (small blind) folded on the River



PokerStars Home Game Hand #225970923455: {Club #4781089}  Hold'em No Limit (50/100) - 2021/04/18 22:39:29 EET [2021/04/18 15:39:29 ET]
Table 'Session 3' 2-max (Play Money) Seat #1 is the button
Seat 1: s70n3fac3 (8308 in chips) 
Seat 2: FDIBA2009 (9745 in chips) 
s70n3fac3: posts small blind 50
FDIBA2009: posts big blind 100
*** HOLE CARDS ***
s70n3fac3: raises 100 to 200
FDIBA2009: folds 
Uncalled bet (100) returned to s70n3fac3
s70n3fac3 collected 200 from pot
s70n3fac3: doesn't show hand 
*** SUMMARY ***
Total pot 200 | Rake 0 
Seat 1: s70n3fac3 (button) (small blind) collected (200)
Seat 2: FDIBA2009 (big blind) folded before Flop



PokerStars Home Game Hand #225970927137: {Club #4781089}  Hold'em No Limit (50/100) - 2021/04/18 22:39:34 EET [2021/04/18 15:39:34 ET]
Table 'Session 3' 2-max (Play Money) Seat #2 is the button
Seat 1: s70n3fac3 (8408 in chips) 
Seat 2: FDIBA2009 (9645 in chips) 
FDIBA2009: posts small blind 50
s70n3fac3: posts big blind 100
*** HOLE CARDS ***
FDIBA2009: raises 100 to 200
s70n3fac3: folds 
Uncalled bet (100) returned to FDIBA2009
FDIBA2009 collected 200 from pot
*** SUMMARY ***
Total pot 200 | Rake 0 
Seat 1: s70n3fac3 (big blind) folded before Flop
Seat 2: FDIBA2009 (button) (small blind) collected (200)



PokerStars Home Game Hand #225970931836: {Club #4781089}  Hold'em No Limit (50/100) - 2021/04/18 22:39:39 EET [2021/04/18 15:39:39 ET]
Table 'Session 3' 2-max (Play Money) Seat #1 is the button
Seat 1: s70n3fac3 (8308 in chips) 
Seat 2: FDIBA2009 (9745 in chips) 
s70n3fac3: posts small blind 50
FDIBA2009: posts big blind 100
*** HOLE CARDS ***
s70n3fac3: raises 150 to 250
FDIBA2009: folds 
Uncalled bet (150) returned to s70n3fac3
s70n3fac3 collected 200 from pot
s70n3fac3: doesn't show hand 
*** SUMMARY ***
Total pot 200 | Rake 0 
Seat 1: s70n3fac3 (button) (small blind) collected (200)
Seat 2: FDIBA2009 (big blind) folded before Flop



PokerStars Home Game Hand #225970936030: {Club #4781089}  Hold'em No Limit (50/100) - 2021/04/18 22:39:45 EET [2021/04/18 15:39:45 ET]
Table 'Session 3' 2-max (Play Money) Seat #2 is the button
Seat 1: s70n3fac3 (8408 in chips) 
Seat 2: FDIBA2009 (9645 in chips) 
FDIBA2009: posts small blind 50
s70n3fac3: posts big blind 100
*** HOLE CARDS ***
FDIBA2009: raises 100 to 200
s70n3fac3: calls 100
*** FLOP *** [2h 8c Jh]
s70n3fac3: checks 
FDIBA2009: bets 189
s70n3fac3: calls 189
*** TURN *** [2h 8c Jh] [Qs]
s70n3fac3: checks 
FDIBA2009: checks 
*** RIVER *** [2h 8c Jh Qs] [2s]
s70n3fac3: bets 300
FDIBA2009: folds 
Uncalled bet (300) returned to s70n3fac3
s70n3fac3 collected 735 from pot
s70n3fac3: doesn't show hand 
*** SUMMARY ***
Total pot 778 | Rake 43 
Board [2h 8c Jh Qs 2s]
Seat 1: s70n3fac3 (big blind) collected (735)
Seat 2: FDIBA2009 (button) (small blind) folded on the River



PokerStars Home Game Hand #225970953541: {Club #4781089}  Hold'em No Limit (50/100) - 2021/04/18 22:40:07 EET [2021/04/18 15:40:07 ET]
Table 'Session 3' 2-max (Play Money) Seat #1 is the button
Seat 1: s70n3fac3 (8754 in chips) 
Seat 2: FDIBA2009 (9256 in chips) 
s70n3fac3: posts small blind 50
FDIBA2009: posts big blind 100
*** HOLE CARDS ***
s70n3fac3: raises 100 to 200
FDIBA2009: raises 400 to 600
s70n3fac3: calls 400
*** FLOP *** [9s 2d 3s]
FDIBA2009: bets 1134
s70n3fac3: folds 
Uncalled bet (1134) returned to FDIBA2009
FDIBA2009 collected 1134 from pot
*** SUMMARY ***
Total pot 1200 | Rake 66 
Board [9s 2d 3s]
Seat 1: s70n3fac3 (button) (small blind) folded on the Flop
Seat 2: FDIBA2009 (big blind) collected (1134)



PokerStars Home Game Hand #225970972144: {Club #4781089}  Hold'em No Limit (50/100) - 2021/04/18 22:40:31 EET [2021/04/18 15:40:31 ET]
Table 'Session 3' 2-max (Play Money) Seat #2 is the button
Seat 1: s70n3fac3 (8154 in chips) 
Seat 2: FDIBA2009 (9790 in chips) 
FDIBA2009: posts small blind 50
s70n3fac3: posts big blind 100
*** HOLE CARDS ***
FDIBA2009: raises 100 to 200
s70n3fac3: folds 
Uncalled bet (100) returned to FDIBA2009
FDIBA2009 collected 200 from pot
*** SUMMARY ***
Total pot 200 | Rake 0 
Seat 1: s70n3fac3 (big blind) folded before Flop
Seat 2: FDIBA2009 (button) (small blind) collected (200)



PokerStars Home Game Hand #225970976885: {Club #4781089}  Hold'em No Limit (50/100) - 2021/04/18 22:40:37 EET [2021/04/18 15:40:37 ET]
Table 'Session 3' 2-max (Play Money) Seat #1 is the button
Seat 1: s70n3fac3 (8054 in chips) 
Seat 2: FDIBA2009 (9890 in chips) 
s70n3fac3: posts small blind 50
FDIBA2009: posts big blind 100
*** HOLE CARDS ***
s70n3fac3: calls 50
FDIBA2009: checks 
*** FLOP *** [As Qc Td]
FDIBA2009: checks 
s70n3fac3: checks 
*** TURN *** [As Qc Td] [Jc]
FDIBA2009: checks 
s70n3fac3: bets 100
FDIBA2009: folds 
Uncalled bet (100) returned to s70n3fac3
s70n3fac3 collected 189 from pot
s70n3fac3: doesn't show hand 
*** SUMMARY ***
Total pot 200 | Rake 11 
Board [As Qc Td Jc]
Seat 1: s70n3fac3 (button) (small blind) collected (189)
Seat 2: FDIBA2009 (big blind) folded on the Turn



PokerStars Home Game Hand #225970988114: {Club #4781089}  Hold'em No Limit (50/100) - 2021/04/18 22:40:51 EET [2021/04/18 15:40:51 ET]
Table 'Session 3' 2-max (Play Money) Seat #2 is the button
Seat 1: s70n3fac3 (8143 in chips) 
Seat 2: FDIBA2009 (9790 in chips) 
FDIBA2009: posts small blind 50
s70n3fac3: posts big blind 100
*** HOLE CARDS ***
FDIBA2009: raises 100 to 200
s70n3fac3: calls 100
*** FLOP *** [4s 2c 9c]
s70n3fac3: checks 
FDIBA2009: bets 378
s70n3fac3: calls 378
*** TURN *** [4s 2c 9c] [5c]
s70n3fac3: checks 
FDIBA2009: bets 546
s70n3fac3: calls 546
*** RIVER *** [4s 2c 9c 5c] [4d]
s70n3fac3: bets 1024
FDIBA2009: raises 2086 to 3110
s70n3fac3: calls 2086
*** SHOW DOWN ***
FDIBA2009: shows [Tc 4c] (a flush, Ten high)
s70n3fac3: mucks hand 
FDIBA2009 collected 8002 from pot
*** SUMMARY ***
Total pot 8468 | Rake 466 
Board [4s 2c 9c 5c 4d]
Seat 1: s70n3fac3 (big blind) mucked [4h Kc]
Seat 2: FDIBA2009 (button) (small blind) showed [Tc 4c] and won (8002) with a flush, Ten high



PokerStars Home Game Hand #225971022325: {Club #4781089}  Hold'em No Limit (50/100) - 2021/04/18 22:41:33 EET [2021/04/18 15:41:33 ET]
Table 'Session 3' 2-max (Play Money) Seat #1 is the button
Seat 1: s70n3fac3 (3909 in chips) 
Seat 2: FDIBA2009 (13558 in chips) 
s70n3fac3: posts small blind 50
FDIBA2009: posts big blind 100
*** HOLE CARDS ***
s70n3fac3: raises 150 to 250
FDIBA2009: calls 150
*** FLOP *** [Th 7s 8s]
FDIBA2009: checks 
s70n3fac3: bets 260
FDIBA2009: folds 
Uncalled bet (260) returned to s70n3fac3
s70n3fac3 collected 472 from pot
s70n3fac3: doesn't show hand 
*** SUMMARY ***
Total pot 500 | Rake 28 
Board [Th 7s 8s]
Seat 1: s70n3fac3 (button) (small blind) collected (472)
Seat 2: FDIBA2009 (big blind) folded on the Flop



PokerStars Home Game Hand #225971040003: {Club #4781089}  Hold'em No Limit (50/100) - 2021/04/18 22:41:56 EET [2021/04/18 15:41:56 ET]
Table 'Session 3' 2-max (Play Money) Seat #2 is the button
Seat 1: s70n3fac3 (4131 in chips) 
Seat 2: FDIBA2009 (13308 in chips) 
FDIBA2009: posts small blind 50
s70n3fac3: posts big blind 100
*** HOLE CARDS ***
FDIBA2009: raises 100 to 200
s70n3fac3: raises 300 to 500
FDIBA2009: calls 300
*** FLOP *** [Td Ad Th]
s70n3fac3: checks 
FDIBA2009: checks 
*** TURN *** [Td Ad Th] [Ks]
s70n3fac3: bets 480
FDIBA2009: folds 
Uncalled bet (480) returned to s70n3fac3
s70n3fac3 collected 945 from pot
s70n3fac3: doesn't show hand 
*** SUMMARY ***
Total pot 1000 | Rake 55 
Board [Td Ad Th Ks]
Seat 1: s70n3fac3 (big blind) collected (945)
Seat 2: FDIBA2009 (button) (small blind) folded on the Turn



PokerStars Home Game Hand #225971061134: {Club #4781089}  Hold'em No Limit (50/100) - 2021/04/18 22:42:23 EET [2021/04/18 15:42:23 ET]
Table 'Session 3' 2-max (Play Money) Seat #1 is the button
Seat 1: s70n3fac3 (4576 in chips) 
Seat 2: FDIBA2009 (12808 in chips) 
s70n3fac3: posts small blind 50
FDIBA2009: posts big blind 100
*** HOLE CARDS ***
s70n3fac3: raises 100 to 200
FDIBA2009: calls 100
*** FLOP *** [Jd 3h Ts]
FDIBA2009: checks 
s70n3fac3: checks 
*** TURN *** [Jd 3h Ts] [Js]
FDIBA2009: checks 
s70n3fac3: checks 
*** RIVER *** [Jd 3h Ts Js] [Td]
FDIBA2009: checks 
s70n3fac3: bets 300
FDIBA2009: folds 
Uncalled bet (300) returned to s70n3fac3
s70n3fac3 collected 378 from pot
s70n3fac3: doesn't show hand 
*** SUMMARY ***
Total pot 400 | Rake 22 
Board [Jd 3h Ts Js Td]
Seat 1: s70n3fac3 (button) (small blind) collected (378)
Seat 2: FDIBA2009 (big blind) folded on the River



PokerStars Home Game Hand #225971084274: {Club #4781089}  Hold'em No Limit (50/100) - 2021/04/18 22:42:52 EET [2021/04/18 15:42:52 ET]
Table 'Session 3' 2-max (Play Money) Seat #2 is the button
Seat 1: s70n3fac3 (4754 in chips) 
Seat 2: FDIBA2009 (12608 in chips) 
FDIBA2009: posts small blind 50
s70n3fac3: posts big blind 100
*** HOLE CARDS ***
FDIBA2009: raises 100 to 200
s70n3fac3: calls 100
*** FLOP *** [8d Kd 8h]
s70n3fac3: checks 
FDIBA2009: bets 189
s70n3fac3: raises 261 to 450
FDIBA2009: folds 
Uncalled bet (261) returned to s70n3fac3
s70n3fac3 collected 735 from pot
s70n3fac3: doesn't show hand 
*** SUMMARY ***
Total pot 778 | Rake 43 
Board [8d Kd 8h]
Seat 1: s70n3fac3 (big blind) collected (735)
Seat 2: FDIBA2009 (button) (small blind) folded on the Flop



PokerStars Home Game Hand #225971100216: {Club #4781089}  Hold'em No Limit (50/100) - 2021/04/18 22:43:12 EET [2021/04/18 15:43:12 ET]
Table 'Session 3' 2-max (Play Money) Seat #1 is the button
Seat 1: s70n3fac3 (5100 in chips) 
Seat 2: FDIBA2009 (12219 in chips) 
s70n3fac3: posts small blind 50
FDIBA2009: posts big blind 100
*** HOLE CARDS ***
s70n3fac3: raises 100 to 200
FDIBA2009: folds 
Uncalled bet (100) returned to s70n3fac3
s70n3fac3 collected 200 from pot
s70n3fac3: doesn't show hand 
*** SUMMARY ***
Total pot 200 | Rake 0 
Seat 1: s70n3fac3 (button) (small blind) collected (200)
Seat 2: FDIBA2009 (big blind) folded before Flop



PokerStars Home Game Hand #225971104552: {Club #4781089}  Hold'em No Limit (50/100) - 2021/04/18 22:43:18 EET [2021/04/18 15:43:18 ET]
Table 'Session 3' 2-max (Play Money) Seat #2 is the button
Seat 1: s70n3fac3 (5200 in chips) 
Seat 2: FDIBA2009 (12119 in chips) 
FDIBA2009: posts small blind 50
s70n3fac3: posts big blind 100
*** HOLE CARDS ***
FDIBA2009: raises 100 to 200
s70n3fac3: calls 100
*** FLOP *** [Qs 5h Qc]
s70n3fac3: checks 
FDIBA2009: bets 189
s70n3fac3: calls 189
*** TURN *** [Qs 5h Qc] [7c]
s70n3fac3: checks 
FDIBA2009: checks 
*** RIVER *** [Qs 5h Qc 7c] [Qd]
s70n3fac3: checks 
FDIBA2009: bets 735
s70n3fac3: calls 735
*** SHOW DOWN ***
FDIBA2009: shows [2s 3s] (three of a kind, Queens)
s70n3fac3: shows [5d 5s] (a full house, Queens full of Fives)
s70n3fac3 collected 2124 from pot
*** SUMMARY ***
Total pot 2248 | Rake 124 
Board [Qs 5h Qc 7c Qd]
Seat 1: s70n3fac3 (big blind) showed [5d 5s] and won (2124) with a full house, Queens full of Fives
Seat 2: FDIBA2009 (button) (small blind) showed [2s 3s] and lost with three of a kind, Queens



PokerStars Home Game Hand #225971130290: {Club #4781089}  Hold'em No Limit (50/100) - 2021/04/18 22:43:50 EET [2021/04/18 15:43:50 ET]
Table 'Session 3' 2-max (Play Money) Seat #1 is the button
Seat 1: s70n3fac3 (6200 in chips) 
Seat 2: FDIBA2009 (10995 in chips) 
s70n3fac3: posts small blind 50
FDIBA2009: posts big blind 100
*** HOLE CARDS ***
s70n3fac3: calls 50
FDIBA2009: raises 200 to 300
s70n3fac3: calls 200
*** FLOP *** [Qh 9s 5h]
FDIBA2009: bets 283
s70n3fac3: folds 
Uncalled bet (283) returned to FDIBA2009
FDIBA2009 collected 567 from pot
*** SUMMARY ***
Total pot 600 | Rake 33 
Board [Qh 9s 5h]
Seat 1: s70n3fac3 (button) (small blind) folded on the Flop
Seat 2: FDIBA2009 (big blind) collected (567)



PokerStars Home Game Hand #225971144777: {Club #4781089}  Hold'em No Limit (50/100) - 2021/04/18 22:44:09 EET [2021/04/18 15:44:09 ET]
Table 'Session 3' 2-max (Play Money) Seat #2 is the button
Seat 1: s70n3fac3 (5900 in chips) 
Seat 2: FDIBA2009 (11262 in chips) 
FDIBA2009: posts small blind 50
s70n3fac3: posts big blind 100
*** HOLE CARDS ***
FDIBA2009: raises 100 to 200
s70n3fac3: folds 
Uncalled bet (100) returned to FDIBA2009
FDIBA2009 collected 200 from pot
*** SUMMARY ***
Total pot 200 | Rake 0 
Seat 1: s70n3fac3 (big blind) folded before Flop
Seat 2: FDIBA2009 (button) (small blind) collected (200)



PokerStars Home Game Hand #225971149671: {Club #4781089}  Hold'em No Limit (50/100) - 2021/04/18 22:44:15 EET [2021/04/18 15:44:15 ET]
Table 'Session 3' 2-max (Play Money) Seat #1 is the button
Seat 1: s70n3fac3 (5800 in chips) 
Seat 2: FDIBA2009 (11362 in chips) 
s70n3fac3: posts small blind 50
FDIBA2009: posts big blind 100
*** HOLE CARDS ***
s70n3fac3: folds 
Uncalled bet (50) returned to FDIBA2009
FDIBA2009 collected 100 from pot
*** SUMMARY ***
Total pot 100 | Rake 0 
Seat 1: s70n3fac3 (button) (small blind) folded before Flop
Seat 2: FDIBA2009 (big blind) collected (100)



PokerStars Home Game Hand #225971152611: {Club #4781089}  Hold'em No Limit (50/100) - 2021/04/18 22:44:19 EET [2021/04/18 15:44:19 ET]
Table 'Session 3' 2-max (Play Money) Seat #2 is the button
Seat 1: s70n3fac3 (5750 in chips) 
Seat 2: FDIBA2009 (11412 in chips) 
FDIBA2009: posts small blind 50
s70n3fac3: posts big blind 100
*** HOLE CARDS ***
FDIBA2009: raises 100 to 200
s70n3fac3: calls 100
*** FLOP *** [6s Ad 2d]
s70n3fac3: checks 
FDIBA2009: bets 189
s70n3fac3: calls 189
*** TURN *** [6s Ad 2d] [3s]
s70n3fac3: checks 
FDIBA2009: checks 
*** RIVER *** [6s Ad 2d 3s] [5d]
s70n3fac3: checks 
FDIBA2009: checks 
*** SHOW DOWN ***
s70n3fac3: shows [2s Ks] (a pair of Deuces)
FDIBA2009: shows [Tc 6c] (a pair of Sixes)
FDIBA2009 collected 735 from pot
*** SUMMARY ***
Total pot 778 | Rake 43 
Board [6s Ad 2d 3s 5d]
Seat 1: s70n3fac3 (big blind) showed [2s Ks] and lost with a pair of Deuces
Seat 2: FDIBA2009 (button) (small blind) showed [Tc 6c] and won (735) with a pair of Sixes



PokerStars Home Game Hand #225971170485: {Club #4781089}  Hold'em No Limit (50/100) - 2021/04/18 22:44:41 EET [2021/04/18 15:44:41 ET]
Table 'Session 3' 2-max (Play Money) Seat #1 is the button
Seat 1: s70n3fac3 (5361 in chips) 
Seat 2: FDIBA2009 (11758 in chips) 
s70n3fac3: posts small blind 50
FDIBA2009: posts big blind 100
*** HOLE CARDS ***
s70n3fac3: folds 
Uncalled bet (50) returned to FDIBA2009
FDIBA2009 collected 100 from pot
*** SUMMARY ***
Total pot 100 | Rake 0 
Seat 1: s70n3fac3 (button) (small blind) folded before Flop
Seat 2: FDIBA2009 (big blind) collected (100)



PokerStars Home Game Hand #225971173990: {Club #4781089}  Hold'em No Limit (50/100) - 2021/04/18 22:44:46 EET [2021/04/18 15:44:46 ET]
Table 'Session 3' 2-max (Play Money) Seat #2 is the button
Seat 1: s70n3fac3 (5311 in chips) 
Seat 2: FDIBA2009 (11808 in chips) 
FDIBA2009: posts small blind 50
s70n3fac3: posts big blind 100
*** HOLE CARDS ***
FDIBA2009: raises 100 to 200
s70n3fac3: calls 100
*** FLOP *** [4s Jd 3d]
s70n3fac3: checks 
FDIBA2009: bets 189
s70n3fac3: calls 189
*** TURN *** [4s Jd 3d] [As]
s70n3fac3: checks 
FDIBA2009: bets 367
s70n3fac3: calls 367
*** RIVER *** [4s Jd 3d As] [6c]
s70n3fac3: checks 
FDIBA2009: checks 
*** SHOW DOWN ***
s70n3fac3: shows [9h Td] (high card Ace)
FDIBA2009: shows [Jh Th] (a pair of Jacks)
FDIBA2009 collected 1429 from pot
*** SUMMARY ***
Total pot 1512 | Rake 83 
Board [4s Jd 3d As 6c]
Seat 1: s70n3fac3 (big blind) showed [9h Td] and lost with high card Ace
Seat 2: FDIBA2009 (button) (small blind) showed [Jh Th] and won (1429) with a pair of Jacks



PokerStars Home Game Hand #225971201043: {Club #4781089}  Hold'em No Limit (50/100) - 2021/04/18 22:45:20 EET [2021/04/18 15:45:20 ET]
Table 'Session 3' 2-max (Play Money) Seat #1 is the button
Seat 1: s70n3fac3 (4555 in chips) 
Seat 2: FDIBA2009 (12481 in chips) 
s70n3fac3: posts small blind 50
FDIBA2009: posts big blind 100
*** HOLE CARDS ***
s70n3fac3: calls 50
FDIBA2009: checks 
*** FLOP *** [9s 3h 4h]
FDIBA2009: checks 
s70n3fac3: checks 
*** TURN *** [9s 3h 4h] [Th]
FDIBA2009: bets 189
s70n3fac3: raises 189 to 378
FDIBA2009: calls 189
*** RIVER *** [9s 3h 4h Th] [9h]
FDIBA2009: checks 
s70n3fac3: checks 
*** SHOW DOWN ***
FDIBA2009: shows [8s Jc] (a pair of Nines)
s70n3fac3: shows [7d Ts] (two pair, Tens and Nines)
s70n3fac3 collected 903 from pot
*** SUMMARY ***
Total pot 956 | Rake 53 
Board [9s 3h 4h Th 9h]
Seat 1: s70n3fac3 (button) (small blind) showed [7d Ts] and won (903) with two pair, Tens and Nines
Seat 2: FDIBA2009 (big blind) showed [8s Jc] and lost with a pair of Nines



PokerStars Home Game Hand #225971223403: {Club #4781089}  Hold'em No Limit (50/100) - 2021/04/18 22:45:49 EET [2021/04/18 15:45:49 ET]
Table 'Session 3' 2-max (Play Money) Seat #2 is the button
Seat 1: s70n3fac3 (4980 in chips) 
Seat 2: FDIBA2009 (12003 in chips) 
FDIBA2009: posts small blind 50
s70n3fac3: posts big blind 100
*** HOLE CARDS ***
FDIBA2009: folds 
Uncalled bet (50) returned to s70n3fac3
s70n3fac3 collected 100 from pot
s70n3fac3: doesn't show hand 
*** SUMMARY ***
Total pot 100 | Rake 0 
Seat 1: s70n3fac3 (big blind) collected (100)
Seat 2: FDIBA2009 (button) (small blind) folded before Flop



PokerStars Home Game Hand #225971226696: {Club #4781089}  Hold'em No Limit (50/100) - 2021/04/18 22:45:53 EET [2021/04/18 15:45:53 ET]
Table 'Session 3' 2-max (Play Money) Seat #1 is the button
Seat 1: s70n3fac3 (5030 in chips) 
Seat 2: FDIBA2009 (11953 in chips) 
s70n3fac3: posts small blind 50
FDIBA2009: posts big blind 100
*** HOLE CARDS ***
s70n3fac3: folds 
Uncalled bet (50) returned to FDIBA2009
FDIBA2009 collected 100 from pot
*** SUMMARY ***
Total pot 100 | Rake 0 
Seat 1: s70n3fac3 (button) (small blind) folded before Flop
Seat 2: FDIBA2009 (big blind) collected (100)



PokerStars Home Game Hand #225971229770: {Club #4781089}  Hold'em No Limit (50/100) - 2021/04/18 22:45:57 EET [2021/04/18 15:45:57 ET]
Table 'Session 3' 2-max (Play Money) Seat #2 is the button
Seat 1: s70n3fac3 (4980 in chips) 
Seat 2: FDIBA2009 (12003 in chips) 
FDIBA2009: posts small blind 50
s70n3fac3: posts big blind 100
*** HOLE CARDS ***
FDIBA2009: folds 
Uncalled bet (50) returned to s70n3fac3
s70n3fac3 collected 100 from pot
s70n3fac3: doesn't show hand 
*** SUMMARY ***
Total pot 100 | Rake 0 
Seat 1: s70n3fac3 (big blind) collected (100)
Seat 2: FDIBA2009 (button) (small blind) folded before Flop



PokerStars Home Game Hand #225971233052: {Club #4781089}  Hold'em No Limit (50/100) - 2021/04/18 22:46:01 EET [2021/04/18 15:46:01 ET]
Table 'Session 3' 2-max (Play Money) Seat #1 is the button
Seat 1: s70n3fac3 (5030 in chips) 
Seat 2: FDIBA2009 (11953 in chips) 
s70n3fac3: posts small blind 50
FDIBA2009: posts big blind 100
*** HOLE CARDS ***
s70n3fac3: folds 
Uncalled bet (50) returned to FDIBA2009
FDIBA2009 collected 100 from pot
*** SUMMARY ***
Total pot 100 | Rake 0 
Seat 1: s70n3fac3 (button) (small blind) folded before Flop
Seat 2: FDIBA2009 (big blind) collected (100)



PokerStars Home Game Hand #225971236240: {Club #4781089}  Hold'em No Limit (50/100) - 2021/04/18 22:46:05 EET [2021/04/18 15:46:05 ET]
Table 'Session 3' 2-max (Play Money) Seat #2 is the button
Seat 1: s70n3fac3 (4980 in chips) 
Seat 2: FDIBA2009 (12003 in chips) 
FDIBA2009: posts small blind 50
s70n3fac3: posts big blind 100
*** HOLE CARDS ***
FDIBA2009: raises 100 to 200
s70n3fac3: calls 100
*** FLOP *** [Qh 7c Ah]
s70n3fac3: checks 
FDIBA2009: checks 
*** TURN *** [Qh 7c Ah] [4d]
s70n3fac3: bets 200
FDIBA2009: calls 200
*** RIVER *** [Qh 7c Ah 4d] [Kh]
s70n3fac3: checks 
FDIBA2009: bets 756
s70n3fac3: folds 
Uncalled bet (756) returned to FDIBA2009
FDIBA2009 collected 756 from pot
*** SUMMARY ***
Total pot 800 | Rake 44 
Board [Qh 7c Ah 4d Kh]
Seat 1: s70n3fac3 (big blind) folded on the River
Seat 2: FDIBA2009 (button) (small blind) collected (756)



PokerStars Home Game Hand #225971254139: {Club #4781089}  Hold'em No Limit (50/100) - 2021/04/18 22:46:28 EET [2021/04/18 15:46:28 ET]
Table 'Session 3' 2-max (Play Money) Seat #1 is the button
Seat 1: s70n3fac3 (4580 in chips) 
Seat 2: FDIBA2009 (12359 in chips) 
s70n3fac3: posts small blind 50
FDIBA2009: posts big blind 100
*** HOLE CARDS ***
s70n3fac3: raises 100 to 200
FDIBA2009: calls 100
*** FLOP *** [Kh Qs Qd]
FDIBA2009: checks 
s70n3fac3: checks 
*** TURN *** [Kh Qs Qd] [8s]
FDIBA2009: bets 189
s70n3fac3: folds 
Uncalled bet (189) returned to FDIBA2009
FDIBA2009 collected 378 from pot
*** SUMMARY ***
Total pot 400 | Rake 22 
Board [Kh Qs Qd 8s]
Seat 1: s70n3fac3 (button) (small blind) folded on the Turn
Seat 2: FDIBA2009 (big blind) collected (378)



PokerStars Home Game Hand #225971268094: {Club #4781089}  Hold'em No Limit (50/100) - 2021/04/18 22:46:46 EET [2021/04/18 15:46:46 ET]
Table 'Session 3' 2-max (Play Money) Seat #2 is the button
Seat 1: s70n3fac3 (4380 in chips) 
Seat 2: FDIBA2009 (12537 in chips) 
FDIBA2009: posts small blind 50
s70n3fac3: posts big blind 100
*** HOLE CARDS ***
FDIBA2009: raises 100 to 200
s70n3fac3: calls 100
*** FLOP *** [Ks Jh 9d]
s70n3fac3: checks 
FDIBA2009: bets 189
s70n3fac3: calls 189
*** TURN *** [Ks Jh 9d] [Td]
s70n3fac3: checks 
FDIBA2009: checks 
*** RIVER *** [Ks Jh 9d Td] [4d]
s70n3fac3: bets 400
FDIBA2009: raises 11748 to 12148 and is all-in
s70n3fac3: folds 
Uncalled bet (11748) returned to FDIBA2009
FDIBA2009 collected 1491 from pot
*** SUMMARY ***
Total pot 1578 | Rake 87 
Board [Ks Jh 9d Td 4d]
Seat 1: s70n3fac3 (big blind) folded on the River
Seat 2: FDIBA2009 (button) (small blind) collected (1491)



PokerStars Home Game Hand #225971298750: {Club #4781089}  Hold'em No Limit (50/100) - 2021/04/18 22:47:25 EET [2021/04/18 15:47:25 ET]
Table 'Session 3' 2-max (Play Money) Seat #1 is the button
Seat 1: s70n3fac3 (3591 in chips) 
Seat 2: FDIBA2009 (13239 in chips) 
s70n3fac3: posts small blind 50
FDIBA2009: posts big blind 100
*** HOLE CARDS ***
s70n3fac3: raises 100 to 200
FDIBA2009: folds 
Uncalled bet (100) returned to s70n3fac3
s70n3fac3 collected 200 from pot
s70n3fac3: doesn't show hand 
*** SUMMARY ***
Total pot 200 | Rake 0 
Seat 1: s70n3fac3 (button) (small blind) collected (200)
Seat 2: FDIBA2009 (big blind) folded before Flop



PokerStars Home Game Hand #225971303169: {Club #4781089}  Hold'em No Limit (50/100) - 2021/04/18 22:47:30 EET [2021/04/18 15:47:30 ET]
Table 'Session 3' 2-max (Play Money) Seat #2 is the button
Seat 1: s70n3fac3 (3691 in chips) 
Seat 2: FDIBA2009 (13139 in chips) 
FDIBA2009: posts small blind 50
s70n3fac3: posts big blind 100
*** HOLE CARDS ***
FDIBA2009: raises 100 to 200
s70n3fac3: raises 300 to 500
FDIBA2009: folds 
Uncalled bet (300) returned to s70n3fac3
s70n3fac3 collected 400 from pot
s70n3fac3: doesn't show hand 
*** SUMMARY ***
Total pot 400 | Rake 0 
Seat 1: s70n3fac3 (big blind) collected (400)
Seat 2: FDIBA2009 (button) (small blind) folded before Flop



PokerStars Home Game Hand #225971310637: {Club #4781089}  Hold'em No Limit (50/100) - 2021/04/18 22:47:40 EET [2021/04/18 15:47:40 ET]
Table 'Session 3' 2-max (Play Money) Seat #1 is the button
Seat 1: s70n3fac3 (3891 in chips) 
Seat 2: FDIBA2009 (12939 in chips) 
s70n3fac3: posts small blind 50
FDIBA2009: posts big blind 100
*** HOLE CARDS ***
s70n3fac3: raises 100 to 200
FDIBA2009: calls 100
*** FLOP *** [6h 2d 8d]
FDIBA2009: checks 
s70n3fac3: bets 200
FDIBA2009: calls 200
*** TURN *** [6h 2d 8d] [Qh]
FDIBA2009: checks 
s70n3fac3: bets 400
FDIBA2009: calls 400
*** RIVER *** [6h 2d 8d Qh] [Jc]
FDIBA2009: checks 
s70n3fac3: bets 800
FDIBA2009: folds 
Uncalled bet (800) returned to s70n3fac3
s70n3fac3 collected 1512 from pot
s70n3fac3: doesn't show hand 
*** SUMMARY ***
Total pot 1600 | Rake 88 
Board [6h 2d 8d Qh Jc]
Seat 1: s70n3fac3 (button) (small blind) collected (1512)
Seat 2: FDIBA2009 (big blind) folded on the River



PokerStars Home Game Hand #225971345223: {Club #4781089}  Hold'em No Limit (50/100) - 2021/04/18 22:48:24 EET [2021/04/18 15:48:24 ET]
Table 'Session 3' 2-max (Play Money) Seat #2 is the button
Seat 1: s70n3fac3 (4603 in chips) 
Seat 2: FDIBA2009 (12139 in chips) 
FDIBA2009: posts small blind 50
s70n3fac3: posts big blind 100
*** HOLE CARDS ***
FDIBA2009: raises 100 to 200
s70n3fac3: folds 
Uncalled bet (100) returned to FDIBA2009
FDIBA2009 collected 200 from pot
*** SUMMARY ***
Total pot 200 | Rake 0 
Seat 1: s70n3fac3 (big blind) folded before Flop
Seat 2: FDIBA2009 (button) (small blind) collected (200)



PokerStars Home Game Hand #225971350851: {Club #4781089}  Hold'em No Limit (50/100) - 2021/04/18 22:48:32 EET [2021/04/18 15:48:32 ET]
Table 'Session 3' 2-max (Play Money) Seat #1 is the button
Seat 1: s70n3fac3 (4503 in chips) 
Seat 2: FDIBA2009 (12239 in chips) 
s70n3fac3: posts small blind 50
FDIBA2009: posts big blind 100
*** HOLE CARDS ***
s70n3fac3: raises 100 to 200
FDIBA2009: raises 400 to 600
s70n3fac3: folds 
Uncalled bet (400) returned to FDIBA2009
FDIBA2009 collected 400 from pot
*** SUMMARY ***
Total pot 400 | Rake 0 
Seat 1: s70n3fac3 (button) (small blind) folded before Flop
Seat 2: FDIBA2009 (big blind) collected (400)



PokerStars Home Game Hand #225971362569: {Club #4781089}  Hold'em No Limit (50/100) - 2021/04/18 22:48:47 EET [2021/04/18 15:48:47 ET]
Table 'Session 3' 2-max (Play Money) Seat #2 is the button
Seat 1: s70n3fac3 (4303 in chips) 
Seat 2: FDIBA2009 (12439 in chips) 
FDIBA2009: posts small blind 50
s70n3fac3: posts big blind 100
*** HOLE CARDS ***
FDIBA2009: raises 100 to 200
s70n3fac3: raises 300 to 500
FDIBA2009: folds 
Uncalled bet (300) returned to s70n3fac3
s70n3fac3 collected 400 from pot
s70n3fac3: doesn't show hand 
*** SUMMARY ***
Total pot 400 | Rake 0 
Seat 1: s70n3fac3 (big blind) collected (400)
Seat 2: FDIBA2009 (button) (small blind) folded before Flop



PokerStars Home Game Hand #225971370943: {Club #4781089}  Hold'em No Limit (50/100) - 2021/04/18 22:48:57 EET [2021/04/18 15:48:57 ET]
Table 'Session 3' 2-max (Play Money) Seat #1 is the button
Seat 1: s70n3fac3 (4503 in chips) 
Seat 2: FDIBA2009 (12239 in chips) 
s70n3fac3: posts small blind 50
FDIBA2009: posts big blind 100
*** HOLE CARDS ***
s70n3fac3: raises 100 to 200
FDIBA2009: calls 100
*** FLOP *** [2d 3s 9h]
FDIBA2009: checks 
s70n3fac3: bets 200
FDIBA2009: calls 200
*** TURN *** [2d 3s 9h] [Td]
FDIBA2009: checks 
s70n3fac3: bets 380
FDIBA2009: calls 380
*** RIVER *** [2d 3s 9h Td] [As]
FDIBA2009: checks 
s70n3fac3: checks 
*** SHOW DOWN ***
FDIBA2009: shows [3h Qs] (a pair of Threes)
s70n3fac3: mucks hand 
FDIBA2009 collected 1474 from pot
*** SUMMARY ***
Total pot 1560 | Rake 86 
Board [2d 3s 9h Td As]
Seat 1: s70n3fac3 (button) (small blind) mucked [4d 3d]
Seat 2: FDIBA2009 (big blind) showed [3h Qs] and won (1474) with a pair of Threes



PokerStars Home Game Hand #225971395560: {Club #4781089}  Hold'em No Limit (50/100) - 2021/04/18 22:49:29 EET [2021/04/18 15:49:29 ET]
Table 'Session 3' 2-max (Play Money) Seat #2 is the button
Seat 1: s70n3fac3 (3723 in chips) 
Seat 2: FDIBA2009 (12933 in chips) 
FDIBA2009: posts small blind 50
s70n3fac3: posts big blind 100
*** HOLE CARDS ***
FDIBA2009: raises 100 to 200
s70n3fac3: calls 100
*** FLOP *** [Qc Ac 8h]
s70n3fac3: checks 
FDIBA2009: bets 378
s70n3fac3: folds 
Uncalled bet (378) returned to FDIBA2009
FDIBA2009 collected 378 from pot
*** SUMMARY ***
Total pot 400 | Rake 22 
Board [Qc Ac 8h]
Seat 1: s70n3fac3 (big blind) folded on the Flop
Seat 2: FDIBA2009 (button) (small blind) collected (378)



PokerStars Home Game Hand #225971408869: {Club #4781089}  Hold'em No Limit (50/100) - 2021/04/18 22:49:46 EET [2021/04/18 15:49:46 ET]
Table 'Session 3' 2-max (Play Money) Seat #1 is the button
Seat 1: s70n3fac3 (3523 in chips) 
Seat 2: FDIBA2009 (13111 in chips) 
s70n3fac3: posts small blind 50
FDIBA2009: posts big blind 100
*** HOLE CARDS ***
s70n3fac3: folds 
Uncalled bet (50) returned to FDIBA2009
FDIBA2009 collected 100 from pot
*** SUMMARY ***
Total pot 100 | Rake 0 
Seat 1: s70n3fac3 (button) (small blind) folded before Flop
Seat 2: FDIBA2009 (big blind) collected (100)



PokerStars Home Game Hand #225971412292: {Club #4781089}  Hold'em No Limit (50/100) - 2021/04/18 22:49:51 EET [2021/04/18 15:49:51 ET]
Table 'Session 3' 2-max (Play Money) Seat #2 is the button
Seat 1: s70n3fac3 (3473 in chips) 
Seat 2: FDIBA2009 (13161 in chips) 
FDIBA2009: posts small blind 50
s70n3fac3: posts big blind 100
*** HOLE CARDS ***
FDIBA2009: raises 100 to 200
s70n3fac3: raises 300 to 500
FDIBA2009: raises 12661 to 13161 and is all-in
s70n3fac3: calls 2973 and is all-in
Uncalled bet (9688) returned to FDIBA2009
*** FLOP *** [3d 9c 8s]
*** TURN *** [3d 9c 8s] [Jh]
*** RIVER *** [3d 9c 8s Jh] [3h]
*** SHOW DOWN ***
s70n3fac3: shows [Kh Ad] (a pair of Threes)
FDIBA2009: shows [4s 4c] (two pair, Fours and Threes)
FDIBA2009 collected 6564 from pot
*** SUMMARY ***
Total pot 6946 | Rake 382 
Board [3d 9c 8s Jh 3h]
Seat 1: s70n3fac3 (big blind) showed [Kh Ad] and lost with a pair of Threes
Seat 2: FDIBA2009 (button) (small blind) showed [4s 4c] and won (6564) with two pair, Fours and Threes



PokerStars Home Game Hand #225971434969: {Club #4781089}  Hold'em No Limit (50/100) - 2021/04/18 22:50:20 EET [2021/04/18 15:50:20 ET]
Table 'Session 3' 2-max (Play Money) Seat #1 is the button
Seat 1: s70n3fac3 (10000 in chips) 
Seat 2: FDIBA2009 (16252 in chips) 
s70n3fac3: posts small blind 50
FDIBA2009: posts big blind 100
*** HOLE CARDS ***
s70n3fac3: folds 
Uncalled bet (50) returned to FDIBA2009
FDIBA2009 collected 100 from pot
*** SUMMARY ***
Total pot 100 | Rake 0 
Seat 1: s70n3fac3 (button) (small blind) folded before Flop
Seat 2: FDIBA2009 (big blind) collected (100)



PokerStars Home Game Hand #225971437941: {Club #4781089}  Hold'em No Limit (50/100) - 2021/04/18 22:50:24 EET [2021/04/18 15:50:24 ET]
Table 'Session 3' 2-max (Play Money) Seat #2 is the button
Seat 1: s70n3fac3 (9950 in chips) 
Seat 2: FDIBA2009 (16302 in chips) 
FDIBA2009: posts small blind 50
s70n3fac3: posts big blind 100
*** HOLE CARDS ***
FDIBA2009: raises 100 to 200
s70n3fac3: raises 300 to 500
FDIBA2009: calls 300
*** FLOP *** [3h Js Ah]
s70n3fac3: checks 
FDIBA2009: checks 
*** TURN *** [3h Js Ah] [5d]
s70n3fac3: checks 
FDIBA2009: bets 472
s70n3fac3: calls 472
*** RIVER *** [3h Js Ah 5d] [Jd]
s70n3fac3: checks 
FDIBA2009: checks 
*** SHOW DOWN ***
s70n3fac3: shows [Kc Kh] (two pair, Kings and Jacks)
FDIBA2009: mucks hand 
s70n3fac3 collected 1837 from pot
*** SUMMARY ***
Total pot 1944 | Rake 107 
Board [3h Js Ah 5d Jd]
Seat 1: s70n3fac3 (big blind) showed [Kc Kh] and won (1837) with two pair, Kings and Jacks
Seat 2: FDIBA2009 (button) (small blind) mucked [Qc 6s]



PokerStars Home Game Hand #225971460645: {Club #4781089}  Hold'em No Limit (50/100) - 2021/04/18 22:50:53 EET [2021/04/18 15:50:53 ET]
Table 'Session 3' 2-max (Play Money) Seat #1 is the button
Seat 1: s70n3fac3 (10815 in chips) 
Seat 2: FDIBA2009 (15330 in chips) 
s70n3fac3: posts small blind 50
FDIBA2009: posts big blind 100
*** HOLE CARDS ***
s70n3fac3: raises 100 to 200
FDIBA2009: calls 100
*** FLOP *** [Qc Td Ts]
FDIBA2009: checks 
s70n3fac3: checks 
*** TURN *** [Qc Td Ts] [Th]
FDIBA2009: checks 
s70n3fac3: bets 200
FDIBA2009: folds 
Uncalled bet (200) returned to s70n3fac3
s70n3fac3 collected 378 from pot
s70n3fac3: doesn't show hand 
*** SUMMARY ***
Total pot 400 | Rake 22 
Board [Qc Td Ts Th]
Seat 1: s70n3fac3 (button) (small blind) collected (378)
Seat 2: FDIBA2009 (big blind) folded on the Turn



PokerStars Home Game Hand #225971472253: {Club #4781089}  Hold'em No Limit (50/100) - 2021/04/18 22:51:08 EET [2021/04/18 15:51:08 ET]
Table 'Session 3' 2-max (Play Money) Seat #2 is the button
Seat 1: s70n3fac3 (10993 in chips) 
Seat 2: FDIBA2009 (15130 in chips) 
FDIBA2009: posts small blind 50
s70n3fac3: posts big blind 100
*** HOLE CARDS ***
FDIBA2009: raises 100 to 200
s70n3fac3: raises 300 to 500
FDIBA2009: folds 
Uncalled bet (300) returned to s70n3fac3
s70n3fac3 collected 400 from pot
s70n3fac3: doesn't show hand 
*** SUMMARY ***
Total pot 400 | Rake 0 
Seat 1: s70n3fac3 (big blind) collected (400)
Seat 2: FDIBA2009 (button) (small blind) folded before Flop



PokerStars Home Game Hand #225971478285: {Club #4781089}  Hold'em No Limit (50/100) - 2021/04/18 22:51:16 EET [2021/04/18 15:51:16 ET]
Table 'Session 3' 2-max (Play Money) Seat #1 is the button
Seat 1: s70n3fac3 (11193 in chips) 
Seat 2: FDIBA2009 (14930 in chips) 
s70n3fac3: posts small blind 50
FDIBA2009: posts big blind 100
*** HOLE CARDS ***
s70n3fac3: raises 100 to 200
FDIBA2009: raises 400 to 600
s70n3fac3: calls 400
*** FLOP *** [Th As Ac]
FDIBA2009: checks 
s70n3fac3: bets 400
FDIBA2009: calls 400
*** TURN *** [Th As Ac] [9c]
FDIBA2009: checks 
s70n3fac3: bets 675
FDIBA2009: calls 675
*** RIVER *** [Th As Ac 9c] [4c]
FDIBA2009: checks 
s70n3fac3: checks 
*** SHOW DOWN ***
FDIBA2009: shows [Qs Jh] (a pair of Aces)
s70n3fac3: shows [Js Tc] (two pair, Aces and Tens)
s70n3fac3 collected 3166 from pot
*** SUMMARY ***
Total pot 3350 | Rake 184 
Board [Th As Ac 9c 4c]
Seat 1: s70n3fac3 (button) (small blind) showed [Js Tc] and won (3166) with two pair, Aces and Tens
Seat 2: FDIBA2009 (big blind) showed [Qs Jh] and lost with a pair of Aces



PokerStars Home Game Hand #225971501387: {Club #4781089}  Hold'em No Limit (50/100) - 2021/04/18 22:51:45 EET [2021/04/18 15:51:45 ET]
Table 'Session 3' 2-max (Play Money) Seat #2 is the button
Seat 1: s70n3fac3 (12684 in chips) 
Seat 2: FDIBA2009 (13255 in chips) 
FDIBA2009: posts small blind 50
s70n3fac3: posts big blind 100
*** HOLE CARDS ***
FDIBA2009: raises 200 to 300
s70n3fac3: folds 
Uncalled bet (200) returned to FDIBA2009
FDIBA2009 collected 200 from pot
*** SUMMARY ***
Total pot 200 | Rake 0 
Seat 1: s70n3fac3 (big blind) folded before Flop
Seat 2: FDIBA2009 (button) (small blind) collected (200)



PokerStars Home Game Hand #225971507019: {Club #4781089}  Hold'em No Limit (50/100) - 2021/04/18 22:51:53 EET [2021/04/18 15:51:53 ET]
Table 'Session 3' 2-max (Play Money) Seat #1 is the button
Seat 1: s70n3fac3 (12584 in chips) 
Seat 2: FDIBA2009 (13355 in chips) 
s70n3fac3: posts small blind 50
FDIBA2009: posts big blind 100
*** HOLE CARDS ***
s70n3fac3: folds 
Uncalled bet (50) returned to FDIBA2009
FDIBA2009 collected 100 from pot
*** SUMMARY ***
Total pot 100 | Rake 0 
Seat 1: s70n3fac3 (button) (small blind) folded before Flop
Seat 2: FDIBA2009 (big blind) collected (100)



PokerStars Home Game Hand #225971510480: {Club #4781089}  Hold'em No Limit (50/100) - 2021/04/18 22:51:57 EET [2021/04/18 15:51:57 ET]
Table 'Session 3' 2-max (Play Money) Seat #2 is the button
Seat 1: s70n3fac3 (12534 in chips) 
Seat 2: FDIBA2009 (13405 in chips) 
FDIBA2009: posts small blind 50
s70n3fac3: posts big blind 100
*** HOLE CARDS ***
FDIBA2009: raises 100 to 200
s70n3fac3: raises 300 to 500
FDIBA2009: calls 300
*** FLOP *** [Qc Jd 2c]
s70n3fac3: checks 
FDIBA2009: checks 
*** TURN *** [Qc Jd 2c] [Ks]
s70n3fac3: bets 400
FDIBA2009: calls 400
*** RIVER *** [Qc Jd 2c Ks] [6c]
s70n3fac3: bets 850
FDIBA2009: calls 850
*** SHOW DOWN ***
s70n3fac3: shows [Ts Ac] (a straight, Ten to Ace)
FDIBA2009: mucks hand 
s70n3fac3 collected 3307 from pot
*** SUMMARY ***
Total pot 3500 | Rake 193 
Board [Qc Jd 2c Ks 6c]
Seat 1: s70n3fac3 (big blind) showed [Ts Ac] and won (3307) with a straight, Ten to Ace
Seat 2: FDIBA2009 (button) (small blind) mucked [Kh 7c]



PokerStars Home Game Hand #225971534430: {Club #4781089}  Hold'em No Limit (50/100) - 2021/04/18 22:52:26 EET [2021/04/18 15:52:26 ET]
Table 'Session 3' 2-max (Play Money) Seat #1 is the button
Seat 1: s70n3fac3 (14091 in chips) 
Seat 2: FDIBA2009 (11655 in chips) 
s70n3fac3: posts small blind 50
FDIBA2009: posts big blind 100
*** HOLE CARDS ***
s70n3fac3: raises 100 to 200
FDIBA2009: calls 100
*** FLOP *** [8s 3d 8c]
FDIBA2009: checks 
s70n3fac3: checks 
*** TURN *** [8s 3d 8c] [Kd]
FDIBA2009: checks 
s70n3fac3: checks 
*** RIVER *** [8s 3d 8c Kd] [5d]
FDIBA2009: checks 
s70n3fac3: checks 
*** SHOW DOWN ***
FDIBA2009: shows [6c Jd] (a pair of Eights)
s70n3fac3: shows [Qh 6d] (a pair of Eights - King+Queen kicker)
s70n3fac3 collected 378 from pot
*** SUMMARY ***
Total pot 400 | Rake 22 
Board [8s 3d 8c Kd 5d]
Seat 1: s70n3fac3 (button) (small blind) showed [Qh 6d] and won (378) with a pair of Eights
Seat 2: FDIBA2009 (big blind) showed [6c Jd] and lost with a pair of Eights



PokerStars Home Game Hand #225971549200: {Club #4781089}  Hold'em No Limit (50/100) - 2021/04/18 22:52:45 EET [2021/04/18 15:52:45 ET]
Table 'Session 3' 2-max (Play Money) Seat #2 is the button
Seat 1: s70n3fac3 (14269 in chips) 
Seat 2: FDIBA2009 (11455 in chips) 
FDIBA2009: posts small blind 50
s70n3fac3: posts big blind 100
*** HOLE CARDS ***
FDIBA2009: raises 100 to 200
s70n3fac3: calls 100
*** FLOP *** [6h Jd Ac]
s70n3fac3: checks 
FDIBA2009: bets 189
s70n3fac3: calls 189
*** TURN *** [6h Jd Ac] [7c]
s70n3fac3: checks 
FDIBA2009: checks 
*** RIVER *** [6h Jd Ac 7c] [9s]
s70n3fac3: bets 400
FDIBA2009: folds 
Uncalled bet (400) returned to s70n3fac3
s70n3fac3 collected 735 from pot
s70n3fac3: doesn't show hand 
*** SUMMARY ***
Total pot 778 | Rake 43 
Board [6h Jd Ac 7c 9s]
Seat 1: s70n3fac3 (big blind) collected (735)
Seat 2: FDIBA2009 (button) (small blind) folded on the River



PokerStars Home Game Hand #225971565050: {Club #4781089}  Hold'em No Limit (50/100) - 2021/04/18 22:53:05 EET [2021/04/18 15:53:05 ET]
Table 'Session 3' 2-max (Play Money) Seat #1 is the button
Seat 1: s70n3fac3 (14615 in chips) 
Seat 2: FDIBA2009 (11066 in chips) 
s70n3fac3: posts small blind 50
FDIBA2009: posts big blind 100
*** HOLE CARDS ***
s70n3fac3: folds 
Uncalled bet (50) returned to FDIBA2009
FDIBA2009 collected 100 from pot
*** SUMMARY ***
Total pot 100 | Rake 0 
Seat 1: s70n3fac3 (button) (small blind) folded before Flop
Seat 2: FDIBA2009 (big blind) collected (100)



PokerStars Home Game Hand #225971568225: {Club #4781089}  Hold'em No Limit (50/100) - 2021/04/18 22:53:09 EET [2021/04/18 15:53:09 ET]
Table 'Session 3' 2-max (Play Money) Seat #2 is the button
Seat 1: s70n3fac3 (14565 in chips) 
Seat 2: FDIBA2009 (11116 in chips) 
FDIBA2009: posts small blind 50
s70n3fac3: posts big blind 100
*** HOLE CARDS ***
FDIBA2009: raises 200 to 300
s70n3fac3: calls 200
*** FLOP *** [3c 2c Ah]
s70n3fac3: checks 
FDIBA2009: bets 567
s70n3fac3: folds 
Uncalled bet (567) returned to FDIBA2009
FDIBA2009 collected 567 from pot
*** SUMMARY ***
Total pot 600 | Rake 33 
Board [3c 2c Ah]
Seat 1: s70n3fac3 (big blind) folded on the Flop
Seat 2: FDIBA2009 (button) (small blind) collected (567)



PokerStars Home Game Hand #225971578865: {Club #4781089}  Hold'em No Limit (50/100) - 2021/04/18 22:53:23 EET [2021/04/18 15:53:23 ET]
Table 'Session 3' 2-max (Play Money) Seat #1 is the button
Seat 1: s70n3fac3 (14265 in chips) 
Seat 2: FDIBA2009 (11383 in chips) 
s70n3fac3: posts small blind 50
FDIBA2009: posts big blind 100
*** HOLE CARDS ***
s70n3fac3: raises 100 to 200
FDIBA2009: raises 400 to 600
s70n3fac3: calls 400
*** FLOP *** [Kh 8s 5c]
FDIBA2009: checks 
s70n3fac3: bets 550
FDIBA2009: calls 550
*** TURN *** [Kh 8s 5c] [9s]
FDIBA2009: checks 
s70n3fac3: bets 860
FDIBA2009: folds 
Uncalled bet (860) returned to s70n3fac3
s70n3fac3 collected 2173 from pot
s70n3fac3: doesn't show hand 
*** SUMMARY ***
Total pot 2300 | Rake 127 
Board [Kh 8s 5c 9s]
Seat 1: s70n3fac3 (button) (small blind) collected (2173)
Seat 2: FDIBA2009 (big blind) folded on the Turn



PokerStars Home Game Hand #225971604836: {Club #4781089}  Hold'em No Limit (50/100) - 2021/04/18 22:53:57 EET [2021/04/18 15:53:57 ET]
Table 'Session 3' 2-max (Play Money) Seat #2 is the button
Seat 1: s70n3fac3 (15288 in chips) 
Seat 2: FDIBA2009 (10233 in chips) 
FDIBA2009: posts small blind 50
s70n3fac3: posts big blind 100
*** HOLE CARDS ***
FDIBA2009: raises 200 to 300
s70n3fac3: folds 
Uncalled bet (200) returned to FDIBA2009
FDIBA2009 collected 200 from pot
*** SUMMARY ***
Total pot 200 | Rake 0 
Seat 1: s70n3fac3 (big blind) folded before Flop
Seat 2: FDIBA2009 (button) (small blind) collected (200)



PokerStars Home Game Hand #225971610069: {Club #4781089}  Hold'em No Limit (50/100) - 2021/04/18 22:54:04 EET [2021/04/18 15:54:04 ET]
Table 'Session 3' 2-max (Play Money) Seat #1 is the button
Seat 1: s70n3fac3 (15188 in chips) 
Seat 2: FDIBA2009 (10333 in chips) 
s70n3fac3: posts small blind 50
FDIBA2009: posts big blind 100
*** HOLE CARDS ***
s70n3fac3: folds 
Uncalled bet (50) returned to FDIBA2009
FDIBA2009 collected 100 from pot
*** SUMMARY ***
Total pot 100 | Rake 0 
Seat 1: s70n3fac3 (button) (small blind) folded before Flop
Seat 2: FDIBA2009 (big blind) collected (100)



PokerStars Home Game Hand #225971613164: {Club #4781089}  Hold'em No Limit (50/100) - 2021/04/18 22:54:08 EET [2021/04/18 15:54:08 ET]
Table 'Session 3' 2-max (Play Money) Seat #2 is the button
Seat 1: s70n3fac3 (15138 in chips) 
Seat 2: FDIBA2009 (10383 in chips) 
FDIBA2009: posts small blind 50
s70n3fac3: posts big blind 100
*** HOLE CARDS ***
FDIBA2009: raises 100 to 200
s70n3fac3: raises 300 to 500
FDIBA2009: folds 
Uncalled bet (300) returned to s70n3fac3
s70n3fac3 collected 400 from pot
s70n3fac3: doesn't show hand 
*** SUMMARY ***
Total pot 400 | Rake 0 
Seat 1: s70n3fac3 (big blind) collected (400)
Seat 2: FDIBA2009 (button) (small blind) folded before Flop



PokerStars Home Game Hand #225971618817: {Club #4781089}  Hold'em No Limit (50/100) - 2021/04/18 22:54:15 EET [2021/04/18 15:54:15 ET]
Table 'Session 3' 2-max (Play Money) Seat #1 is the button
Seat 1: s70n3fac3 (15338 in chips) 
Seat 2: FDIBA2009 (10183 in chips) 
s70n3fac3: posts small blind 50
FDIBA2009: posts big blind 100
*** HOLE CARDS ***
s70n3fac3: folds 
Uncalled bet (50) returned to FDIBA2009
FDIBA2009 collected 100 from pot
*** SUMMARY ***
Total pot 100 | Rake 0 
Seat 1: s70n3fac3 (button) (small blind) folded before Flop
Seat 2: FDIBA2009 (big blind) collected (100)



PokerStars Home Game Hand #225971621942: {Club #4781089}  Hold'em No Limit (50/100) - 2021/04/18 22:54:19 EET [2021/04/18 15:54:19 ET]
Table 'Session 3' 2-max (Play Money) Seat #2 is the button
Seat 1: s70n3fac3 (15288 in chips) 
Seat 2: FDIBA2009 (10233 in chips) 
FDIBA2009: posts small blind 50
s70n3fac3: posts big blind 100
*** HOLE CARDS ***
FDIBA2009: raises 100 to 200
s70n3fac3: folds 
Uncalled bet (100) returned to FDIBA2009
FDIBA2009 collected 200 from pot
*** SUMMARY ***
Total pot 200 | Rake 0 
Seat 1: s70n3fac3 (big blind) folded before Flop
Seat 2: FDIBA2009 (button) (small blind) collected (200)



PokerStars Home Game Hand #225971626282: {Club #4781089}  Hold'em No Limit (50/100) - 2021/04/18 22:54:25 EET [2021/04/18 15:54:25 ET]
Table 'Session 3' 2-max (Play Money) Seat #1 is the button
Seat 1: s70n3fac3 (15188 in chips) 
Seat 2: FDIBA2009 (10333 in chips) 
s70n3fac3: posts small blind 50
FDIBA2009: posts big blind 100
*** HOLE CARDS ***
s70n3fac3: raises 100 to 200
FDIBA2009: raises 400 to 600
s70n3fac3: calls 400
*** FLOP *** [6h 9d 3d]
FDIBA2009: bets 567
s70n3fac3: raises 658 to 1225
FDIBA2009: raises 3584 to 4809
s70n3fac3: raises 9779 to 14588 and is all-in
FDIBA2009: calls 4924 and is all-in
Uncalled bet (4855) returned to s70n3fac3
*** TURN *** [6h 9d 3d] [9c]
*** RIVER *** [6h 9d 3d 9c] [Ad]
*** SHOW DOWN ***
FDIBA2009: shows [Qs Qc] (two pair, Queens and Nines)
s70n3fac3: shows [Qd Td] (a flush, Ace high)
s70n3fac3 collected 19529 from pot
*** SUMMARY ***
Total pot 20666 | Rake 1137 
Board [6h 9d 3d 9c Ad]
Seat 1: s70n3fac3 (button) (small blind) showed [Qd Td] and won (19529) with a flush, Ace high
Seat 2: FDIBA2009 (big blind) showed [Qs Qc] and lost with two pair, Queens and Nines



PokerStars Home Game Hand #225971670526: {Club #4781089}  Hold'em No Limit (50/100) - 2021/04/18 22:55:31 EET [2021/04/18 15:55:31 ET]
Table 'Session 3' 2-max (Play Money) Seat #2 is the button
Seat 1: s70n3fac3 (24384 in chips) 
Seat 2: FDIBA2009 (10000 in chips) 
FDIBA2009: posts small blind 50
s70n3fac3: posts big blind 100
*** HOLE CARDS ***
FDIBA2009: calls 50
s70n3fac3: checks 
*** FLOP *** [6h 4d Ad]
s70n3fac3: checks 
FDIBA2009: bets 189
s70n3fac3: folds 
Uncalled bet (189) returned to FDIBA2009
FDIBA2009 collected 189 from pot
*** SUMMARY ***
Total pot 200 | Rake 11 
Board [6h 4d Ad]
Seat 1: s70n3fac3 (big blind) folded on the Flop
Seat 2: FDIBA2009 (button) (small blind) collected (189)



PokerStars Home Game Hand #225971683804: {Club #4781089}  Hold'em No Limit (50/100) - 2021/04/18 22:56:01 EET [2021/04/18 15:56:01 ET]
Table 'Session 3' 2-max (Play Money) Seat #1 is the button
Seat 1: s70n3fac3 (24284 in chips) 
Seat 2: FDIBA2009 (10089 in chips) 
s70n3fac3: posts small blind 50
FDIBA2009: posts big blind 100
*** HOLE CARDS ***
s70n3fac3: raises 100 to 200
FDIBA2009: calls 100
*** FLOP *** [Kh 3s 3c]
FDIBA2009: checks 
s70n3fac3: checks 
*** TURN *** [Kh 3s 3c] [8d]
FDIBA2009: checks 
s70n3fac3: bets 200
FDIBA2009: folds 
Uncalled bet (200) returned to s70n3fac3
s70n3fac3 collected 378 from pot
s70n3fac3: doesn't show hand 
*** SUMMARY ***
Total pot 400 | Rake 22 
Board [Kh 3s 3c 8d]
Seat 1: s70n3fac3 (button) (small blind) collected (378)
Seat 2: FDIBA2009 (big blind) folded on the Turn



PokerStars Home Game Hand #225971690786: {Club #4781089}  Hold'em No Limit (50/100) - 2021/04/18 22:56:17 EET [2021/04/18 15:56:17 ET]
Table 'Session 3' 2-max (Play Money) Seat #2 is the button
Seat 1: s70n3fac3 (24462 in chips) 
Seat 2: FDIBA2009 (9889 in chips) 
FDIBA2009: posts small blind 50
s70n3fac3: posts big blind 100
*** HOLE CARDS ***
FDIBA2009: raises 100 to 200
s70n3fac3: calls 100
*** FLOP *** [Qc 8s Th]
s70n3fac3: checks 
FDIBA2009: bets 189
s70n3fac3: folds 
Uncalled bet (189) returned to FDIBA2009
FDIBA2009 collected 378 from pot
*** SUMMARY ***
Total pot 400 | Rake 22 
Board [Qc 8s Th]
Seat 1: s70n3fac3 (big blind) folded on the Flop
Seat 2: FDIBA2009 (button) (small blind) collected (378)



PokerStars Home Game Hand #225971697493: {Club #4781089}  Hold'em No Limit (50/100) - 2021/04/18 22:56:32 EET [2021/04/18 15:56:32 ET]
Table 'Session 3' 2-max (Play Money) Seat #1 is the button
Seat 1: s70n3fac3 (24262 in chips) 
Seat 2: FDIBA2009 (10067 in chips) 
s70n3fac3: posts small blind 50
FDIBA2009: posts big blind 100
*** HOLE CARDS ***
s70n3fac3: folds 
Uncalled bet (50) returned to FDIBA2009
FDIBA2009 collected 100 from pot
*** SUMMARY ***
Total pot 100 | Rake 0 
Seat 1: s70n3fac3 (button) (small blind) folded before Flop
Seat 2: FDIBA2009 (big blind) collected (100)



PokerStars Home Game Hand #225971699329: {Club #4781089}  Hold'em No Limit (50/100) - 2021/04/18 22:56:37 EET [2021/04/18 15:56:37 ET]
Table 'Session 3' 2-max (Play Money) Seat #2 is the button
Seat 1: s70n3fac3 (24212 in chips) 
Seat 2: FDIBA2009 (10117 in chips) 
FDIBA2009: posts small blind 50
s70n3fac3: posts big blind 100
*** HOLE CARDS ***
FDIBA2009: raises 200 to 300
s70n3fac3: calls 200
*** FLOP *** [Ad Ts 5d]
s70n3fac3: checks 
FDIBA2009: bets 283
s70n3fac3: raises 417 to 700
FDIBA2009: calls 417
*** TURN *** [Ad Ts 5d] [9s]
s70n3fac3: checks 
FDIBA2009: bets 1600
s70n3fac3: folds 
Uncalled bet (1600) returned to FDIBA2009
FDIBA2009 collected 1890 from pot
*** SUMMARY ***
Total pot 2000 | Rake 110 
Board [Ad Ts 5d 9s]
Seat 1: s70n3fac3 (big blind) folded on the Turn
Seat 2: FDIBA2009 (button) (small blind) collected (1890)



PokerStars Home Game Hand #225971717126: {Club #4781089}  Hold'em No Limit (50/100) - 2021/04/18 22:57:17 EET [2021/04/18 15:57:17 ET]
Table 'Session 3' 2-max (Play Money) Seat #1 is the button
Seat 1: s70n3fac3 (23212 in chips) 
Seat 2: FDIBA2009 (11007 in chips) 
s70n3fac3: posts small blind 50
FDIBA2009: posts big blind 100
*** HOLE CARDS ***
s70n3fac3: raises 100 to 200
FDIBA2009: calls 100
*** FLOP *** [2d 9s Qd]
FDIBA2009: checks 
s70n3fac3: bets 200
FDIBA2009: folds 
Uncalled bet (200) returned to s70n3fac3
s70n3fac3 collected 378 from pot
s70n3fac3: doesn't show hand 
*** SUMMARY ***
Total pot 400 | Rake 22 
Board [2d 9s Qd]
Seat 1: s70n3fac3 (button) (small blind) collected (378)
Seat 2: FDIBA2009 (big blind) folded on the Flop



PokerStars Home Game Hand #225971722257: {Club #4781089}  Hold'em No Limit (50/100) - 2021/04/18 22:57:28 EET [2021/04/18 15:57:28 ET]
Table 'Session 3' 2-max (Play Money) Seat #2 is the button
Seat 1: s70n3fac3 (23390 in chips) 
Seat 2: FDIBA2009 (10807 in chips) 
FDIBA2009: posts small blind 50
s70n3fac3: posts big blind 100
*** HOLE CARDS ***
FDIBA2009: folds 
Uncalled bet (50) returned to s70n3fac3
s70n3fac3 collected 100 from pot
s70n3fac3: doesn't show hand 
*** SUMMARY ***
Total pot 100 | Rake 0 
Seat 1: s70n3fac3 (big blind) collected (100)
Seat 2: FDIBA2009 (button) (small blind) folded before Flop



PokerStars Home Game Hand #225971724277: {Club #4781089}  Hold'em No Limit (50/100) - 2021/04/18 22:57:33 EET [2021/04/18 15:57:33 ET]
Table 'Session 3' 2-max (Play Money) Seat #1 is the button
Seat 1: s70n3fac3 (23440 in chips) 
Seat 2: FDIBA2009 (10757 in chips) 
s70n3fac3: posts small blind 50
FDIBA2009: posts big blind 100
*** HOLE CARDS ***
s70n3fac3: folds 
Uncalled bet (50) returned to FDIBA2009
FDIBA2009 collected 100 from pot
*** SUMMARY ***
Total pot 100 | Rake 0 
Seat 1: s70n3fac3 (button) (small blind) folded before Flop
Seat 2: FDIBA2009 (big blind) collected (100)



PokerStars Home Game Hand #225971725903: {Club #4781089}  Hold'em No Limit (50/100) - 2021/04/18 22:57:36 EET [2021/04/18 15:57:36 ET]
Table 'Session 3' 2-max (Play Money) Seat #2 is the button
Seat 1: s70n3fac3 (23390 in chips) 
Seat 2: FDIBA2009 (10807 in chips) 
FDIBA2009: posts small blind 50
s70n3fac3: posts big blind 100
*** HOLE CARDS ***
FDIBA2009: raises 100 to 200
s70n3fac3: raises 300 to 500
FDIBA2009: folds 
Uncalled bet (300) returned to s70n3fac3
s70n3fac3 collected 400 from pot
s70n3fac3: doesn't show hand 
*** SUMMARY ***
Total pot 400 | Rake 0 
Seat 1: s70n3fac3 (big blind) collected (400)
Seat 2: FDIBA2009 (button) (small blind) folded before Flop



PokerStars Home Game Hand #225971731441: {Club #4781089}  Hold'em No Limit (50/100) - 2021/04/18 22:57:49 EET [2021/04/18 15:57:49 ET]
Table 'Session 3' 2-max (Play Money) Seat #1 is the button
Seat 1: s70n3fac3 (23590 in chips) 
Seat 2: FDIBA2009 (10607 in chips) 
s70n3fac3: posts small blind 50
FDIBA2009: posts big blind 100
*** HOLE CARDS ***
s70n3fac3: folds 
Uncalled bet (50) returned to FDIBA2009
FDIBA2009 collected 100 from pot
*** SUMMARY ***
Total pot 100 | Rake 0 
Seat 1: s70n3fac3 (button) (small blind) folded before Flop
Seat 2: FDIBA2009 (big blind) collected (100)



PokerStars Home Game Hand #225971733134: {Club #4781089}  Hold'em No Limit (50/100) - 2021/04/18 22:57:53 EET [2021/04/18 15:57:53 ET]
Table 'Session 3' 2-max (Play Money) Seat #2 is the button
Seat 1: s70n3fac3 (23540 in chips) 
Seat 2: FDIBA2009 (10657 in chips) 
FDIBA2009: posts small blind 50
s70n3fac3: posts big blind 100
*** HOLE CARDS ***
FDIBA2009: raises 100 to 200
s70n3fac3: raises 300 to 500
FDIBA2009: calls 300
*** FLOP *** [4h 5d 8s]
s70n3fac3: checks 
FDIBA2009: checks 
*** TURN *** [4h 5d 8s] [9c]
s70n3fac3: checks 
FDIBA2009: bets 945
s70n3fac3: folds 
Uncalled bet (945) returned to FDIBA2009
FDIBA2009 collected 945 from pot
*** SUMMARY ***
Total pot 1000 | Rake 55 
Board [4h 5d 8s 9c]
Seat 1: s70n3fac3 (big blind) folded on the Turn
Seat 2: FDIBA2009 (button) (small blind) collected (945)



PokerStars Home Game Hand #225971745627: {Club #4781089}  Hold'em No Limit (50/100) - 2021/04/18 22:58:16 EET [2021/04/18 15:58:16 ET]
Table 'Session 3' 2-max (Play Money) Seat #1 is the button
Seat 1: s70n3fac3 (23040 in chips) 
Seat 2: FDIBA2009 (11102 in chips) 
s70n3fac3: posts small blind 50
FDIBA2009: posts big blind 100
*** HOLE CARDS ***
s70n3fac3: raises 100 to 200
FDIBA2009: raises 400 to 600
s70n3fac3: folds 
Uncalled bet (400) returned to FDIBA2009
FDIBA2009 collected 400 from pot
*** SUMMARY ***
Total pot 400 | Rake 0 
Seat 1: s70n3fac3 (button) (small blind) folded before Flop
Seat 2: FDIBA2009 (big blind) collected (400)



PokerStars Home Game Hand #225971752807: {Club #4781089}  Hold'em No Limit (50/100) - 2021/04/18 22:58:24 EET [2021/04/18 15:58:24 ET]
Table 'Session 3' 2-max (Play Money) Seat #2 is the button
Seat 1: s70n3fac3 (22840 in chips) 
Seat 2: FDIBA2009 (11302 in chips) 
FDIBA2009: posts small blind 50
s70n3fac3: posts big blind 100
*** HOLE CARDS ***
FDIBA2009: raises 100 to 200
s70n3fac3: calls 100
*** FLOP *** [Jc 3d Ac]
s70n3fac3: checks 
FDIBA2009: checks 
*** TURN *** [Jc 3d Ac] [2s]
s70n3fac3: bets 200
FDIBA2009: folds 
Uncalled bet (200) returned to s70n3fac3
s70n3fac3 collected 378 from pot
s70n3fac3: doesn't show hand 
*** SUMMARY ***
Total pot 400 | Rake 22 
Board [Jc 3d Ac 2s]
Seat 1: s70n3fac3 (big blind) collected (378)
Seat 2: FDIBA2009 (button) (small blind) folded on the Turn



PokerStars Home Game Hand #225971758099: {Club #4781089}  Hold'em No Limit (50/100) - 2021/04/18 22:58:36 EET [2021/04/18 15:58:36 ET]
Table 'Session 3' 2-max (Play Money) Seat #1 is the button
Seat 1: s70n3fac3 (23018 in chips) 
Seat 2: FDIBA2009 (11102 in chips) 
s70n3fac3: posts small blind 50
FDIBA2009: posts big blind 100
*** HOLE CARDS ***
s70n3fac3: raises 150 to 250
FDIBA2009: calls 150
*** FLOP *** [2h 4c Js]
FDIBA2009: checks 
s70n3fac3: bets 270
FDIBA2009: folds 
Uncalled bet (270) returned to s70n3fac3
s70n3fac3 collected 472 from pot
s70n3fac3: doesn't show hand 
*** SUMMARY ***
Total pot 500 | Rake 28 
Board [2h 4c Js]
Seat 1: s70n3fac3 (button) (small blind) collected (472)
Seat 2: FDIBA2009 (big blind) folded on the Flop



PokerStars Home Game Hand #225971764428: {Club #4781089}  Hold'em No Limit (50/100) - 2021/04/18 22:58:51 EET [2021/04/18 15:58:51 ET]
Table 'Session 3' 2-max (Play Money) Seat #2 is the button
Seat 1: s70n3fac3 (23240 in chips) 
Seat 2: FDIBA2009 (10852 in chips) 
FDIBA2009: posts small blind 50
s70n3fac3: posts big blind 100
*** HOLE CARDS ***
FDIBA2009: raises 100 to 200
s70n3fac3: folds 
Uncalled bet (100) returned to FDIBA2009
FDIBA2009 collected 200 from pot
*** SUMMARY ***
Total pot 200 | Rake 0 
Seat 1: s70n3fac3 (big blind) folded before Flop
Seat 2: FDIBA2009 (button) (small blind) collected (200)



PokerStars Home Game Hand #225971767569: {Club #4781089}  Hold'em No Limit (50/100) - 2021/04/18 22:58:58 EET [2021/04/18 15:58:58 ET]
Table 'Session 3' 2-max (Play Money) Seat #1 is the button
Seat 1: s70n3fac3 (23140 in chips) 
Seat 2: FDIBA2009 (10952 in chips) 
s70n3fac3: posts small blind 50
FDIBA2009: posts big blind 100
*** HOLE CARDS ***
s70n3fac3: raises 100 to 200
FDIBA2009: raises 400 to 600
s70n3fac3: calls 400
*** FLOP *** [4d Js Td]
FDIBA2009: bets 567
s70n3fac3: calls 567
*** TURN *** [4d Js Td] [4c]
FDIBA2009: bets 1103
s70n3fac3: calls 1103
*** RIVER *** [4d Js Td 4c] [2h]
FDIBA2009: bets 2145
s70n3fac3: calls 2145
*** SHOW DOWN ***
FDIBA2009: shows [Ks Kh] (two pair, Kings and Fours)
s70n3fac3: mucks hand 
FDIBA2009 collected 8344 from pot
*** SUMMARY ***
Total pot 8830 | Rake 486 
Board [4d Js Td 4c 2h]
Seat 1: s70n3fac3 (button) (small blind) mucked [Ac 7s]
Seat 2: FDIBA2009 (big blind) showed [Ks Kh] and won (8344) with two pair, Kings and Fours



PokerStars Home Game Hand #225971788947: {Club #4781089}  Hold'em No Limit (50/100) - 2021/04/18 22:59:45 EET [2021/04/18 15:59:45 ET]
Table 'Session 3' 2-max (Play Money) Seat #2 is the button
Seat 1: s70n3fac3 (18725 in chips) 
Seat 2: FDIBA2009 (14881 in chips) 
FDIBA2009: posts small blind 50
s70n3fac3: posts big blind 100
*** HOLE CARDS ***
FDIBA2009: raises 100 to 200
s70n3fac3: calls 100
*** FLOP *** [2d Td 9c]
s70n3fac3: checks 
FDIBA2009: bets 189
s70n3fac3: calls 189
*** TURN *** [2d Td 9c] [8d]
s70n3fac3: checks 
FDIBA2009: checks 
*** RIVER *** [2d Td 9c 8d] [Qh]
s70n3fac3: checks 
FDIBA2009: checks 
*** SHOW DOWN ***
s70n3fac3: shows [4s 4h] (a pair of Fours)
FDIBA2009: shows [9s 6s] (a pair of Nines)
FDIBA2009 collected 735 from pot
*** SUMMARY ***
Total pot 778 | Rake 43 
Board [2d Td 9c 8d Qh]
Seat 1: s70n3fac3 (big blind) showed [4s 4h] and lost with a pair of Fours
Seat 2: FDIBA2009 (button) (small blind) showed [9s 6s] and won (735) with a pair of Nines



PokerStars Home Game Hand #225971801228: {Club #4781089}  Hold'em No Limit (50/100) - 2021/04/18 23:00:11 EET [2021/04/18 16:00:11 ET]
Table 'Session 3' 2-max (Play Money) Seat #1 is the button
Seat 1: s70n3fac3 (18336 in chips) 
Seat 2: FDIBA2009 (15227 in chips) 
s70n3fac3: posts small blind 50
FDIBA2009: posts big blind 100
*** HOLE CARDS ***
s70n3fac3: raises 100 to 200
FDIBA2009: calls 100
*** FLOP *** [4d 6s 2c]
FDIBA2009: checks 
s70n3fac3: checks 
*** TURN *** [4d 6s 2c] [Th]
FDIBA2009: checks 
s70n3fac3: checks 
*** RIVER *** [4d 6s 2c Th] [3c]
FDIBA2009: checks 
s70n3fac3: checks 
*** SHOW DOWN ***
FDIBA2009: shows [Kd 9c] (high card King)
s70n3fac3: mucks hand 
FDIBA2009 collected 378 from pot
*** SUMMARY ***
Total pot 400 | Rake 22 
Board [4d 6s 2c Th 3c]
Seat 1: s70n3fac3 (button) (small blind) mucked [9s Qh]
Seat 2: FDIBA2009 (big blind) showed [Kd 9c] and won (378) with high card King



PokerStars Home Game Hand #225971810777: {Club #4781089}  Hold'em No Limit (50/100) - 2021/04/18 23:00:31 EET [2021/04/18 16:00:31 ET]
Table 'Session 3' 2-max (Play Money) Seat #2 is the button
Seat 1: s70n3fac3 (18136 in chips) 
Seat 2: FDIBA2009 (15405 in chips) 
FDIBA2009: posts small blind 50
s70n3fac3: posts big blind 100
*** HOLE CARDS ***
FDIBA2009: raises 100 to 200
s70n3fac3: calls 100
*** FLOP *** [Ks 7h Kd]
s70n3fac3: checks 
FDIBA2009: checks 
*** TURN *** [Ks 7h Kd] [3c]
s70n3fac3: bets 200
FDIBA2009: folds 
Uncalled bet (200) returned to s70n3fac3
s70n3fac3 collected 378 from pot
s70n3fac3: doesn't show hand 
*** SUMMARY ***
Total pot 400 | Rake 22 
Board [Ks 7h Kd 3c]
Seat 1: s70n3fac3 (big blind) collected (378)
Seat 2: FDIBA2009 (button) (small blind) folded on the Turn



PokerStars Home Game Hand #225971816888: {Club #4781089}  Hold'em No Limit (50/100) - 2021/04/18 23:00:43 EET [2021/04/18 16:00:43 ET]
Table 'Session 3' 2-max (Play Money) Seat #1 is the button
Seat 1: s70n3fac3 (18314 in chips) 
Seat 2: FDIBA2009 (15205 in chips) 
s70n3fac3: posts small blind 50
FDIBA2009: posts big blind 100
*** HOLE CARDS ***
s70n3fac3: raises 100 to 200
FDIBA2009: folds 
Uncalled bet (100) returned to s70n3fac3
s70n3fac3 collected 200 from pot
s70n3fac3: doesn't show hand 
*** SUMMARY ***
Total pot 200 | Rake 0 
Seat 1: s70n3fac3 (button) (small blind) collected (200)
Seat 2: FDIBA2009 (big blind) folded before Flop



PokerStars Home Game Hand #225971819463: {Club #4781089}  Hold'em No Limit (50/100) - 2021/04/18 23:00:48 EET [2021/04/18 16:00:48 ET]
Table 'Session 3' 2-max (Play Money) Seat #2 is the button
Seat 1: s70n3fac3 (18414 in chips) 
Seat 2: FDIBA2009 (15105 in chips) 
FDIBA2009: posts small blind 50
s70n3fac3: posts big blind 100
*** HOLE CARDS ***
FDIBA2009: raises 100 to 200
s70n3fac3: raises 300 to 500
FDIBA2009: folds 
Uncalled bet (300) returned to s70n3fac3
s70n3fac3 collected 400 from pot
s70n3fac3: doesn't show hand 
*** SUMMARY ***
Total pot 400 | Rake 0 
Seat 1: s70n3fac3 (big blind) collected (400)
Seat 2: FDIBA2009 (button) (small blind) folded before Flop



PokerStars Home Game Hand #225971825810: {Club #4781089}  Hold'em No Limit (50/100) - 2021/04/18 23:01:00 EET [2021/04/18 16:01:00 ET]
Table 'Session 3' 2-max (Play Money) Seat #1 is the button
Seat 1: s70n3fac3 (18614 in chips) 
Seat 2: FDIBA2009 (14905 in chips) 
s70n3fac3: posts small blind 50
FDIBA2009: posts big blind 100
*** HOLE CARDS ***
s70n3fac3: folds 
Uncalled bet (50) returned to FDIBA2009
FDIBA2009 collected 100 from pot
*** SUMMARY ***
Total pot 100 | Rake 0 
Seat 1: s70n3fac3 (button) (small blind) folded before Flop
Seat 2: FDIBA2009 (big blind) collected (100)



PokerStars Home Game Hand #225971828196: {Club #4781089}  Hold'em No Limit (50/100) - 2021/04/18 23:01:04 EET [2021/04/18 16:01:04 ET]
Table 'Session 3' 2-max (Play Money) Seat #2 is the button
Seat 1: s70n3fac3 (18564 in chips) 
Seat 2: FDIBA2009 (14955 in chips) 
FDIBA2009: posts small blind 50
s70n3fac3: posts big blind 100
*** HOLE CARDS ***
FDIBA2009: raises 100 to 200
s70n3fac3: raises 300 to 500
FDIBA2009: calls 300
*** FLOP *** [Jh Kh 7c]
s70n3fac3: bets 500
FDIBA2009: folds 
Uncalled bet (500) returned to s70n3fac3
s70n3fac3 collected 945 from pot
s70n3fac3: doesn't show hand 
*** SUMMARY ***
Total pot 1000 | Rake 55 
Board [Jh Kh 7c]
Seat 1: s70n3fac3 (big blind) collected (945)
Seat 2: FDIBA2009 (button) (small blind) folded on the Flop



PokerStars Home Game Hand #225971836326: {Club #4781089}  Hold'em No Limit (50/100) - 2021/04/18 23:01:19 EET [2021/04/18 16:01:19 ET]
Table 'Session 3' 2-max (Play Money) Seat #1 is the button
Seat 1: s70n3fac3 (19009 in chips) 
Seat 2: FDIBA2009 (14455 in chips) 
s70n3fac3: posts small blind 50
FDIBA2009: posts big blind 100
*** HOLE CARDS ***
s70n3fac3: raises 150 to 250
FDIBA2009: raises 150 to 400
s70n3fac3: calls 150
*** FLOP *** [6c 7d 9h]
FDIBA2009: checks 
s70n3fac3: bets 300
FDIBA2009: calls 300
*** TURN *** [6c 7d 9h] [6d]
FDIBA2009: checks 
s70n3fac3: bets 450
FDIBA2009: folds 
Uncalled bet (450) returned to s70n3fac3
s70n3fac3 collected 1323 from pot
s70n3fac3: doesn't show hand 
*** SUMMARY ***
Total pot 1400 | Rake 77 
Board [6c 7d 9h 6d]
Seat 1: s70n3fac3 (button) (small blind) collected (1323)
Seat 2: FDIBA2009 (big blind) folded on the Turn



PokerStars Home Game Hand #225971851599: {Club #4781089}  Hold'em No Limit (50/100) - 2021/04/18 23:01:46 EET [2021/04/18 16:01:46 ET]
Table 'Session 3' 2-max (Play Money) Seat #2 is the button
Seat 1: s70n3fac3 (19632 in chips) 
Seat 2: FDIBA2009 (13755 in chips) 
FDIBA2009: posts small blind 50
s70n3fac3: posts big blind 100
*** HOLE CARDS ***
FDIBA2009: raises 100 to 200
s70n3fac3: calls 100
*** FLOP *** [8s 4d Qd]
s70n3fac3: bets 200
FDIBA2009: folds 
Uncalled bet (200) returned to s70n3fac3
s70n3fac3 collected 378 from pot
s70n3fac3: doesn't show hand 
*** SUMMARY ***
Total pot 400 | Rake 22 
Board [8s 4d Qd]
Seat 1: s70n3fac3 (big blind) collected (378)
Seat 2: FDIBA2009 (button) (small blind) folded on the Flop



PokerStars Home Game Hand #225971858106: {Club #4781089}  Hold'em No Limit (50/100) - 2021/04/18 23:01:56 EET [2021/04/18 16:01:56 ET]
Table 'Session 3' 2-max (Play Money) Seat #1 is the button
Seat 1: s70n3fac3 (19810 in chips) 
Seat 2: FDIBA2009 (13555 in chips) 
s70n3fac3: posts small blind 50
FDIBA2009: posts big blind 100
*** HOLE CARDS ***
s70n3fac3: folds 
Uncalled bet (50) returned to FDIBA2009
FDIBA2009 collected 100 from pot
*** SUMMARY ***
Total pot 100 | Rake 0 
Seat 1: s70n3fac3 (button) (small blind) folded before Flop
Seat 2: FDIBA2009 (big blind) collected (100)



PokerStars Home Game Hand #225971860761: {Club #4781089}  Hold'em No Limit (50/100) - 2021/04/18 23:01:59 EET [2021/04/18 16:01:59 ET]
Table 'Session 3' 2-max (Play Money) Seat #2 is the button
Seat 1: s70n3fac3 (19760 in chips) 
Seat 2: FDIBA2009 (13605 in chips) 
FDIBA2009: posts small blind 50
s70n3fac3: posts big blind 100
*** HOLE CARDS ***
FDIBA2009: folds 
Uncalled bet (50) returned to s70n3fac3
s70n3fac3 collected 100 from pot
s70n3fac3: doesn't show hand 
*** SUMMARY ***
Total pot 100 | Rake 0 
Seat 1: s70n3fac3 (big blind) collected (100)
Seat 2: FDIBA2009 (button) (small blind) folded before Flop



PokerStars Home Game Hand #225971862902: {Club #4781089}  Hold'em No Limit (50/100) - 2021/04/18 23:02:03 EET [2021/04/18 16:02:03 ET]
Table 'Session 3' 2-max (Play Money) Seat #1 is the button
Seat 1: s70n3fac3 (19810 in chips) 
Seat 2: FDIBA2009 (13555 in chips) 
s70n3fac3: posts small blind 50
FDIBA2009: posts big blind 100
*** HOLE CARDS ***
s70n3fac3: folds 
Uncalled bet (50) returned to FDIBA2009
FDIBA2009 collected 100 from pot
*** SUMMARY ***
Total pot 100 | Rake 0 
Seat 1: s70n3fac3 (button) (small blind) folded before Flop
Seat 2: FDIBA2009 (big blind) collected (100)



PokerStars Home Game Hand #225971865051: {Club #4781089}  Hold'em No Limit (50/100) - 2021/04/18 23:02:07 EET [2021/04/18 16:02:07 ET]
Table 'Session 3' 2-max (Play Money) Seat #2 is the button
Seat 1: s70n3fac3 (19760 in chips) 
Seat 2: FDIBA2009 (13605 in chips) 
FDIBA2009: posts small blind 50
s70n3fac3: posts big blind 100
*** HOLE CARDS ***
FDIBA2009: raises 100 to 200
s70n3fac3: calls 100
*** FLOP *** [6c 3s 2s]
s70n3fac3: checks 
FDIBA2009: bets 189
s70n3fac3: calls 189
*** TURN *** [6c 3s 2s] [Td]
s70n3fac3: checks 
FDIBA2009: bets 735
s70n3fac3: folds 
Uncalled bet (735) returned to FDIBA2009
FDIBA2009 collected 735 from pot
*** SUMMARY ***
Total pot 778 | Rake 43 
Board [6c 3s 2s Td]
Seat 1: s70n3fac3 (big blind) folded on the Turn
Seat 2: FDIBA2009 (button) (small blind) collected (735)



PokerStars Home Game Hand #225971879774: {Club #4781089}  Hold'em No Limit (50/100) - 2021/04/18 23:02:28 EET [2021/04/18 16:02:28 ET]
Table 'Session 3' 2-max (Play Money) Seat #1 is the button
Seat 1: s70n3fac3 (19371 in chips) 
Seat 2: FDIBA2009 (13951 in chips) 
s70n3fac3: posts small blind 50
FDIBA2009: posts big blind 100
*** HOLE CARDS ***
s70n3fac3: raises 100 to 200
FDIBA2009: calls 100
*** FLOP *** [2s 5c 8s]
FDIBA2009: checks 
s70n3fac3: bets 200
FDIBA2009: raises 389 to 589
s70n3fac3: calls 389
*** TURN *** [2s 5c 8s] [8h]
FDIBA2009: bets 745
s70n3fac3: raises 855 to 1600
FDIBA2009: folds 
Uncalled bet (855) returned to s70n3fac3
s70n3fac3 collected 2899 from pot
s70n3fac3: doesn't show hand 
*** SUMMARY ***
Total pot 3068 | Rake 169 
Board [2s 5c 8s 8h]
Seat 1: s70n3fac3 (button) (small blind) collected (2899)
Seat 2: FDIBA2009 (big blind) folded on the Turn



PokerStars Home Game Hand #225971908903: {Club #4781089}  Hold'em No Limit (50/100) - 2021/04/18 23:03:10 EET [2021/04/18 16:03:10 ET]
Table 'Session 3' 2-max (Play Money) Seat #2 is the button
Seat 1: s70n3fac3 (20736 in chips) 
Seat 2: FDIBA2009 (12417 in chips) 
FDIBA2009: posts small blind 50
s70n3fac3: posts big blind 100
*** HOLE CARDS ***
FDIBA2009: raises 100 to 200
s70n3fac3: folds 
Uncalled bet (100) returned to FDIBA2009
FDIBA2009 collected 200 from pot
*** SUMMARY ***
Total pot 200 | Rake 0 
Seat 1: s70n3fac3 (big blind) folded before Flop
Seat 2: FDIBA2009 (button) (small blind) collected (200)



PokerStars Home Game Hand #225971913194: {Club #4781089}  Hold'em No Limit (50/100) - 2021/04/18 23:03:16 EET [2021/04/18 16:03:16 ET]
Table 'Session 3' 2-max (Play Money) Seat #1 is the button
Seat 1: s70n3fac3 (20636 in chips) 
Seat 2: FDIBA2009 (12517 in chips) 
s70n3fac3: posts small blind 50
FDIBA2009: posts big blind 100
*** HOLE CARDS ***
s70n3fac3: calls 50
FDIBA2009: checks 
*** FLOP *** [Js 7d Jd]
FDIBA2009: checks 
s70n3fac3: bets 200
FDIBA2009: folds 
Uncalled bet (200) returned to s70n3fac3
s70n3fac3 collected 189 from pot
s70n3fac3: doesn't show hand 
*** SUMMARY ***
Total pot 200 | Rake 11 
Board [Js 7d Jd]
Seat 1: s70n3fac3 (button) (small blind) collected (189)
Seat 2: FDIBA2009 (big blind) folded on the Flop



PokerStars Home Game Hand #225971921065: {Club #4781089}  Hold'em No Limit (50/100) - 2021/04/18 23:03:26 EET [2021/04/18 16:03:26 ET]
Table 'Session 3' 2-max (Play Money) Seat #2 is the button
Seat 1: s70n3fac3 (20725 in chips) 
Seat 2: FDIBA2009 (12417 in chips) 
FDIBA2009: posts small blind 50
s70n3fac3: posts big blind 100
*** HOLE CARDS ***
FDIBA2009: raises 100 to 200
s70n3fac3: folds 
Uncalled bet (100) returned to FDIBA2009
FDIBA2009 collected 200 from pot
*** SUMMARY ***
Total pot 200 | Rake 0 
Seat 1: s70n3fac3 (big blind) folded before Flop
Seat 2: FDIBA2009 (button) (small blind) collected (200)



PokerStars Home Game Hand #225971925434: {Club #4781089}  Hold'em No Limit (50/100) - 2021/04/18 23:03:32 EET [2021/04/18 16:03:32 ET]
Table 'Session 3' 2-max (Play Money) Seat #1 is the button
Seat 1: s70n3fac3 (20625 in chips) 
Seat 2: FDIBA2009 (12517 in chips) 
s70n3fac3: posts small blind 50
FDIBA2009: posts big blind 100
*** HOLE CARDS ***
s70n3fac3: calls 50
FDIBA2009: raises 200 to 300
s70n3fac3: calls 200
*** FLOP *** [As 2c 4h]
FDIBA2009: checks 
s70n3fac3: bets 200
FDIBA2009: calls 200
*** TURN *** [As 2c 4h] [5d]
FDIBA2009: checks 
s70n3fac3: checks 
*** RIVER *** [As 2c 4h 5d] [6d]
FDIBA2009: bets 472
s70n3fac3: folds 
Uncalled bet (472) returned to FDIBA2009
FDIBA2009 collected 945 from pot
*** SUMMARY ***
Total pot 1000 | Rake 55 
Board [As 2c 4h 5d 6d]
Seat 1: s70n3fac3 (button) (small blind) folded on the River
Seat 2: FDIBA2009 (big blind) collected (945)



PokerStars Home Game Hand #225971947458: {Club #4781089}  Hold'em No Limit (50/100) - 2021/04/18 23:03:59 EET [2021/04/18 16:03:59 ET]
Table 'Session 3' 2-max (Play Money) Seat #2 is the button
Seat 1: s70n3fac3 (20125 in chips) 
Seat 2: FDIBA2009 (12962 in chips) 
FDIBA2009: posts small blind 50
s70n3fac3: posts big blind 100
*** HOLE CARDS ***
FDIBA2009: raises 100 to 200
s70n3fac3: calls 100
*** FLOP *** [4s Qs 5d]
s70n3fac3: checks 
FDIBA2009: bets 189
s70n3fac3: calls 189
*** TURN *** [4s Qs 5d] [Qc]
s70n3fac3: checks 
FDIBA2009: bets 367
s70n3fac3: calls 367
*** RIVER *** [4s Qs 5d Qc] [8s]
s70n3fac3: checks 
FDIBA2009: bets 1429
s70n3fac3: raises 2819 to 4248
FDIBA2009: folds 
Uncalled bet (2819) returned to s70n3fac3
s70n3fac3 collected 4130 from pot
s70n3fac3: doesn't show hand 
*** SUMMARY ***
Total pot 4370 | Rake 240 
Board [4s Qs 5d Qc 8s]
Seat 1: s70n3fac3 (big blind) collected (4130)
Seat 2: FDIBA2009 (button) (small blind) folded on the River



PokerStars Home Game Hand #225971971444: {Club #4781089}  Hold'em No Limit (50/100) - 2021/04/18 23:04:31 EET [2021/04/18 16:04:31 ET]
Table 'Session 3' 2-max (Play Money) Seat #1 is the button
Seat 1: s70n3fac3 (22070 in chips) 
Seat 2: FDIBA2009 (10777 in chips) 
s70n3fac3: posts small blind 50
FDIBA2009: posts big blind 100
*** HOLE CARDS ***
s70n3fac3: folds 
Uncalled bet (50) returned to FDIBA2009
FDIBA2009 collected 100 from pot
*** SUMMARY ***
Total pot 100 | Rake 0 
Seat 1: s70n3fac3 (button) (small blind) folded before Flop
Seat 2: FDIBA2009 (big blind) collected (100)



PokerStars Home Game Hand #225971974640: {Club #4781089}  Hold'em No Limit (50/100) - 2021/04/18 23:04:35 EET [2021/04/18 16:04:35 ET]
Table 'Session 3' 2-max (Play Money) Seat #2 is the button
Seat 1: s70n3fac3 (22020 in chips) 
Seat 2: FDIBA2009 (10827 in chips) 
FDIBA2009: posts small blind 50
s70n3fac3: posts big blind 100
*** HOLE CARDS ***
FDIBA2009: folds 
Uncalled bet (50) returned to s70n3fac3
s70n3fac3 collected 100 from pot
s70n3fac3: doesn't show hand 
*** SUMMARY ***
Total pot 100 | Rake 0 
Seat 1: s70n3fac3 (big blind) collected (100)
Seat 2: FDIBA2009 (button) (small blind) folded before Flop



PokerStars Home Game Hand #225971977893: {Club #4781089}  Hold'em No Limit (50/100) - 2021/04/18 23:04:40 EET [2021/04/18 16:04:40 ET]
Table 'Session 3' 2-max (Play Money) Seat #1 is the button
Seat 1: s70n3fac3 (22070 in chips) 
Seat 2: FDIBA2009 (10777 in chips) 
s70n3fac3: posts small blind 50
FDIBA2009: posts big blind 100
*** HOLE CARDS ***
s70n3fac3: raises 100 to 200
FDIBA2009: calls 100
*** FLOP *** [Js 6d 6s]
FDIBA2009: checks 
s70n3fac3: checks 
*** TURN *** [Js 6d 6s] [5s]
FDIBA2009: checks 
s70n3fac3: checks 
*** RIVER *** [Js 6d 6s 5s] [Kc]
FDIBA2009: checks 
s70n3fac3: checks 
*** SHOW DOWN ***
FDIBA2009: shows [8d Ac] (a pair of Sixes)
s70n3fac3: mucks hand 
FDIBA2009 collected 378 from pot
*** SUMMARY ***
Total pot 400 | Rake 22 
Board [Js 6d 6s 5s Kc]
Seat 1: s70n3fac3 (button) (small blind) mucked [Td 7d]
Seat 2: FDIBA2009 (big blind) showed [8d Ac] and won (378) with a pair of Sixes



PokerStars Home Game Hand #225971990463: {Club #4781089}  Hold'em No Limit (50/100) - 2021/04/18 23:04:56 EET [2021/04/18 16:04:56 ET]
Table 'Session 3' 2-max (Play Money) Seat #2 is the button
Seat 1: s70n3fac3 (21870 in chips) 
Seat 2: FDIBA2009 (10955 in chips) 
FDIBA2009: posts small blind 50
s70n3fac3: posts big blind 100
*** HOLE CARDS ***
FDIBA2009: raises 200 to 300
s70n3fac3: folds 
Uncalled bet (200) returned to FDIBA2009
FDIBA2009 collected 200 from pot
*** SUMMARY ***
Total pot 200 | Rake 0 
Seat 1: s70n3fac3 (big blind) folded before Flop
Seat 2: FDIBA2009 (button) (small blind) collected (200)



PokerStars Home Game Hand #225971995485: {Club #4781089}  Hold'em No Limit (50/100) - 2021/04/18 23:05:02 EET [2021/04/18 16:05:02 ET]
Table 'Session 3' 2-max (Play Money) Seat #1 is the button
Seat 1: s70n3fac3 (21770 in chips) 
Seat 2: FDIBA2009 (11055 in chips) 
s70n3fac3: posts small blind 50
FDIBA2009: posts big blind 100
*** HOLE CARDS ***
s70n3fac3: calls 50
FDIBA2009: checks 
*** FLOP *** [5h 5d Kc]
FDIBA2009: checks 
s70n3fac3: checks 
*** TURN *** [5h 5d Kc] [3h]
FDIBA2009: checks 
s70n3fac3: checks 
*** RIVER *** [5h 5d Kc 3h] [Td]
FDIBA2009: checks 
s70n3fac3: checks 
*** SHOW DOWN ***
FDIBA2009: shows [Js 8c] (a pair of Fives)
s70n3fac3: mucks hand 
FDIBA2009 collected 189 from pot
*** SUMMARY ***
Total pot 200 | Rake 11 
Board [5h 5d Kc 3h Td]
Seat 1: s70n3fac3 (button) (small blind) mucked [7h 9c]
Seat 2: FDIBA2009 (big blind) showed [Js 8c] and won (189) with a pair of Fives



PokerStars Home Game Hand #225972007685: {Club #4781089}  Hold'em No Limit (50/100) - 2021/04/18 23:05:18 EET [2021/04/18 16:05:18 ET]
Table 'Session 3' 2-max (Play Money) Seat #2 is the button
Seat 1: s70n3fac3 (21670 in chips) 
Seat 2: FDIBA2009 (11144 in chips) 
FDIBA2009: posts small blind 50
s70n3fac3: posts big blind 100
*** HOLE CARDS ***
FDIBA2009: raises 200 to 300
s70n3fac3: folds 
Uncalled bet (200) returned to FDIBA2009
FDIBA2009 collected 200 from pot
*** SUMMARY ***
Total pot 200 | Rake 0 
Seat 1: s70n3fac3 (big blind) folded before Flop
Seat 2: FDIBA2009 (button) (small blind) collected (200)



PokerStars Home Game Hand #225972012534: {Club #4781089}  Hold'em No Limit (50/100) - 2021/04/18 23:05:24 EET [2021/04/18 16:05:24 ET]
Table 'Session 3' 2-max (Play Money) Seat #1 is the button
Seat 1: s70n3fac3 (21570 in chips) 
Seat 2: FDIBA2009 (11244 in chips) 
s70n3fac3: posts small blind 50
FDIBA2009: posts big blind 100
*** HOLE CARDS ***
s70n3fac3: raises 100 to 200
FDIBA2009: calls 100
*** FLOP *** [7d 6c 5s]
FDIBA2009: checks 
s70n3fac3: bets 200
FDIBA2009: folds 
Uncalled bet (200) returned to s70n3fac3
s70n3fac3 collected 378 from pot
s70n3fac3: doesn't show hand 
*** SUMMARY ***
Total pot 400 | Rake 22 
Board [7d 6c 5s]
Seat 1: s70n3fac3 (button) (small blind) collected (378)
Seat 2: FDIBA2009 (big blind) folded on the Flop



PokerStars Home Game Hand #225972030995: {Club #4781089}  Hold'em No Limit (50/100) - 2021/04/18 23:05:36 EET [2021/04/18 16:05:36 ET]
Table 'Session 3' 2-max (Play Money) Seat #2 is the button
Seat 1: s70n3fac3 (21748 in chips) 
Seat 2: FDIBA2009 (11044 in chips) 
FDIBA2009: posts small blind 50
s70n3fac3: posts big blind 100
*** HOLE CARDS ***
FDIBA2009: raises 200 to 300
s70n3fac3: calls 200
*** FLOP *** [8s 5c 4s]
s70n3fac3: checks 
FDIBA2009: checks 
*** TURN *** [8s 5c 4s] [Qh]
s70n3fac3: checks 
FDIBA2009: checks 
*** RIVER *** [8s 5c 4s Qh] [2h]
s70n3fac3: checks 
FDIBA2009: bets 283
s70n3fac3: folds 
Uncalled bet (283) returned to FDIBA2009
FDIBA2009 collected 567 from pot
*** SUMMARY ***
Total pot 600 | Rake 33 
Board [8s 5c 4s Qh 2h]
Seat 1: s70n3fac3 (big blind) folded on the River
Seat 2: FDIBA2009 (button) (small blind) collected (567)



PokerStars Home Game Hand #225972047515: {Club #4781089}  Hold'em No Limit (50/100) - 2021/04/18 23:05:58 EET [2021/04/18 16:05:58 ET]
Table 'Session 3' 2-max (Play Money) Seat #1 is the button
Seat 1: s70n3fac3 (21448 in chips) 
Seat 2: FDIBA2009 (11311 in chips) 
s70n3fac3: posts small blind 50
FDIBA2009: posts big blind 100
*** HOLE CARDS ***
s70n3fac3: folds 
Uncalled bet (50) returned to FDIBA2009
FDIBA2009 collected 100 from pot
*** SUMMARY ***
Total pot 100 | Rake 0 
Seat 1: s70n3fac3 (button) (small blind) folded before Flop
Seat 2: FDIBA2009 (big blind) collected (100)



PokerStars Home Game Hand #225972050366: {Club #4781089}  Hold'em No Limit (50/100) - 2021/04/18 23:06:02 EET [2021/04/18 16:06:02 ET]
Table 'Session 3' 2-max (Play Money) Seat #2 is the button
Seat 1: s70n3fac3 (21398 in chips) 
Seat 2: FDIBA2009 (11361 in chips) 
FDIBA2009: posts small blind 50
s70n3fac3: posts big blind 100
*** HOLE CARDS ***
FDIBA2009: raises 100 to 200
s70n3fac3: raises 300 to 500
FDIBA2009: calls 300
*** FLOP *** [9s 8d Td]
s70n3fac3: checks 
FDIBA2009: bets 472
s70n3fac3: calls 472
*** TURN *** [9s 8d Td] [Jd]
s70n3fac3: checks 
FDIBA2009: checks 
*** RIVER *** [9s 8d Td Jd] [Th]
s70n3fac3: bets 1230
FDIBA2009: calls 1230
*** SHOW DOWN ***
s70n3fac3: shows [Ah Ks] (a pair of Tens)
FDIBA2009: shows [5c 9h] (two pair, Tens and Nines)
FDIBA2009 collected 4162 from pot
*** SUMMARY ***
Total pot 4404 | Rake 242 
Board [9s 8d Td Jd Th]
Seat 1: s70n3fac3 (big blind) showed [Ah Ks] and lost with a pair of Tens
Seat 2: FDIBA2009 (button) (small blind) showed [5c 9h] and won (4162) with two pair, Tens and Nines



PokerStars Home Game Hand #225972071057: {Club #4781089}  Hold'em No Limit (50/100) - 2021/04/18 23:06:28 EET [2021/04/18 16:06:28 ET]
Table 'Session 3' 2-max (Play Money) Seat #1 is the button
Seat 1: s70n3fac3 (19196 in chips) 
Seat 2: FDIBA2009 (13321 in chips) 
s70n3fac3: posts small blind 50
FDIBA2009: posts big blind 100
*** HOLE CARDS ***
s70n3fac3: calls 50
FDIBA2009: raises 200 to 300
s70n3fac3: folds 
Uncalled bet (200) returned to FDIBA2009
FDIBA2009 collected 200 from pot
*** SUMMARY ***
Total pot 200 | Rake 0 
Seat 1: s70n3fac3 (button) (small blind) folded before Flop
Seat 2: FDIBA2009 (big blind) collected (200)



PokerStars Home Game Hand #225972078875: {Club #4781089}  Hold'em No Limit (50/100) - 2021/04/18 23:06:38 EET [2021/04/18 16:06:38 ET]
Table 'Session 3' 2-max (Play Money) Seat #2 is the button
Seat 1: s70n3fac3 (19096 in chips) 
Seat 2: FDIBA2009 (13421 in chips) 
FDIBA2009: posts small blind 50
s70n3fac3: posts big blind 100
*** HOLE CARDS ***
FDIBA2009: raises 100 to 200
s70n3fac3: calls 100
*** FLOP *** [3s As 6s]
s70n3fac3: checks 
FDIBA2009: checks 
*** TURN *** [3s As 6s] [Qh]
s70n3fac3: checks 
FDIBA2009: checks 
*** RIVER *** [3s As 6s Qh] [7c]
s70n3fac3: checks 
FDIBA2009: bets 378
s70n3fac3: folds 
Uncalled bet (378) returned to FDIBA2009
FDIBA2009 collected 378 from pot
*** SUMMARY ***
Total pot 400 | Rake 22 
Board [3s As 6s Qh 7c]
Seat 1: s70n3fac3 (big blind) folded on the River
Seat 2: FDIBA2009 (button) (small blind) collected (378)



PokerStars Home Game Hand #225972095298: {Club #4781089}  Hold'em No Limit (50/100) - 2021/04/18 23:07:00 EET [2021/04/18 16:07:00 ET]
Table 'Session 3' 2-max (Play Money) Seat #1 is the button
Seat 1: s70n3fac3 (18896 in chips) 
Seat 2: FDIBA2009 (13599 in chips) 
s70n3fac3: posts small blind 50
FDIBA2009: posts big blind 100
*** HOLE CARDS ***
s70n3fac3: folds 
Uncalled bet (50) returned to FDIBA2009
FDIBA2009 collected 100 from pot
*** SUMMARY ***
Total pot 100 | Rake 0 
Seat 1: s70n3fac3 (button) (small blind) folded before Flop
Seat 2: FDIBA2009 (big blind) collected (100)



PokerStars Home Game Hand #225972098186: {Club #4781089}  Hold'em No Limit (50/100) - 2021/04/18 23:07:03 EET [2021/04/18 16:07:03 ET]
Table 'Session 3' 2-max (Play Money) Seat #2 is the button
Seat 1: s70n3fac3 (18846 in chips) 
Seat 2: FDIBA2009 (13649 in chips) 
FDIBA2009: posts small blind 50
s70n3fac3: posts big blind 100
*** HOLE CARDS ***
FDIBA2009: raises 100 to 200
s70n3fac3: folds 
Uncalled bet (100) returned to FDIBA2009
FDIBA2009 collected 200 from pot
*** SUMMARY ***
Total pot 200 | Rake 0 
Seat 1: s70n3fac3 (big blind) folded before Flop
Seat 2: FDIBA2009 (button) (small blind) collected (200)



PokerStars Home Game Hand #225972103218: {Club #4781089}  Hold'em No Limit (50/100) - 2021/04/18 23:07:10 EET [2021/04/18 16:07:10 ET]
Table 'Session 3' 2-max (Play Money) Seat #1 is the button
Seat 1: s70n3fac3 (18746 in chips) 
Seat 2: FDIBA2009 (13749 in chips) 
s70n3fac3: posts small blind 50
FDIBA2009: posts big blind 100
*** HOLE CARDS ***
s70n3fac3: folds 
Uncalled bet (50) returned to FDIBA2009
FDIBA2009 collected 100 from pot
*** SUMMARY ***
Total pot 100 | Rake 0 
Seat 1: s70n3fac3 (button) (small blind) folded before Flop
Seat 2: FDIBA2009 (big blind) collected (100)



PokerStars Home Game Hand #225972106283: {Club #4781089}  Hold'em No Limit (50/100) - 2021/04/18 23:07:14 EET [2021/04/18 16:07:14 ET]
Table 'Session 3' 2-max (Play Money) Seat #2 is the button
Seat 1: s70n3fac3 (18696 in chips) 
Seat 2: FDIBA2009 (13799 in chips) 
FDIBA2009: posts small blind 50
s70n3fac3: posts big blind 100
*** HOLE CARDS ***
FDIBA2009: raises 200 to 300
s70n3fac3: calls 200
*** FLOP *** [9c 9d 9s]
s70n3fac3: checks 
FDIBA2009: checks 
*** TURN *** [9c 9d 9s] [7d]
s70n3fac3: checks 
FDIBA2009: checks 
*** RIVER *** [9c 9d 9s 7d] [3c]
s70n3fac3: checks 
FDIBA2009: checks 
*** SHOW DOWN ***
s70n3fac3: shows [Qd 8h] (three of a kind, Nines)
FDIBA2009: shows [Ah 5s] (three of a kind, Nines - Ace kicker)
FDIBA2009 collected 567 from pot
*** SUMMARY ***
Total pot 600 | Rake 33 
Board [9c 9d 9s 7d 3c]
Seat 1: s70n3fac3 (big blind) showed [Qd 8h] and lost with three of a kind, Nines
Seat 2: FDIBA2009 (button) (small blind) showed [Ah 5s] and won (567) with three of a kind, Nines



PokerStars Home Game Hand #225972117948: {Club #4781089}  Hold'em No Limit (50/100) - 2021/04/18 23:07:29 EET [2021/04/18 16:07:29 ET]
Table 'Session 3' 2-max (Play Money) Seat #1 is the button
Seat 1: s70n3fac3 (18396 in chips) 
Seat 2: FDIBA2009 (14066 in chips) 
s70n3fac3: posts small blind 50
FDIBA2009: posts big blind 100
*** HOLE CARDS ***
s70n3fac3: raises 100 to 200
FDIBA2009: raises 400 to 600
s70n3fac3: folds 
Uncalled bet (400) returned to FDIBA2009
FDIBA2009 collected 400 from pot
*** SUMMARY ***
Total pot 400 | Rake 0 
Seat 1: s70n3fac3 (button) (small blind) folded before Flop
Seat 2: FDIBA2009 (big blind) collected (400)



PokerStars Home Game Hand #225972123496: {Club #4781089}  Hold'em No Limit (50/100) - 2021/04/18 23:07:36 EET [2021/04/18 16:07:36 ET]
Table 'Session 3' 2-max (Play Money) Seat #2 is the button
Seat 1: s70n3fac3 (18196 in chips) 
Seat 2: FDIBA2009 (14266 in chips) 
FDIBA2009: posts small blind 50
s70n3fac3: posts big blind 100
*** HOLE CARDS ***
FDIBA2009: raises 100 to 200
s70n3fac3: calls 100
*** FLOP *** [3s 8s 4c]
s70n3fac3: checks 
FDIBA2009: checks 
*** TURN *** [3s 8s 4c] [7h]
s70n3fac3: bets 200
FDIBA2009: calls 200
*** RIVER *** [3s 8s 4c 7h] [Jc]
s70n3fac3: bets 400
FDIBA2009: folds 
Uncalled bet (400) returned to s70n3fac3
s70n3fac3 collected 756 from pot
s70n3fac3: doesn't show hand 
*** SUMMARY ***
Total pot 800 | Rake 44 
Board [3s 8s 4c 7h Jc]
Seat 1: s70n3fac3 (big blind) collected (756)
Seat 2: FDIBA2009 (button) (small blind) folded on the River



PokerStars Home Game Hand #225972135463: {Club #4781089}  Hold'em No Limit (50/100) - 2021/04/18 23:07:52 EET [2021/04/18 16:07:52 ET]
Table 'Session 3' 2-max (Play Money) Seat #1 is the button
Seat 1: s70n3fac3 (18552 in chips) 
Seat 2: FDIBA2009 (13866 in chips) 
s70n3fac3: posts small blind 50
FDIBA2009: posts big blind 100
*** HOLE CARDS ***
s70n3fac3: raises 100 to 200
FDIBA2009: raises 400 to 600
s70n3fac3: calls 400
*** FLOP *** [Js 2s Ah]
FDIBA2009: checks 
s70n3fac3: bets 300
FDIBA2009: calls 300
*** TURN *** [Js 2s Ah] [4h]
FDIBA2009: checks 
s70n3fac3: bets 500
FDIBA2009: calls 500
*** RIVER *** [Js 2s Ah 4h] [Qd]
FDIBA2009: checks 
s70n3fac3: bets 900
FDIBA2009: calls 900
*** SHOW DOWN ***
s70n3fac3: shows [8s Ts] (high card Ace)
FDIBA2009: shows [6d Ad] (a pair of Aces)
FDIBA2009 collected 4347 from pot
*** SUMMARY ***
Total pot 4600 | Rake 253 
Board [Js 2s Ah 4h Qd]
Seat 1: s70n3fac3 (button) (small blind) showed [8s Ts] and lost with high card Ace
Seat 2: FDIBA2009 (big blind) showed [6d Ad] and won (4347) with a pair of Aces



PokerStars Home Game Hand #225972159613: {Club #4781089}  Hold'em No Limit (50/100) - 2021/04/18 23:08:23 EET [2021/04/18 16:08:23 ET]
Table 'Session 3' 2-max (Play Money) Seat #2 is the button
Seat 1: s70n3fac3 (16252 in chips) 
Seat 2: FDIBA2009 (15913 in chips) 
FDIBA2009: posts small blind 50
s70n3fac3: posts big blind 100
*** HOLE CARDS ***
FDIBA2009: raises 200 to 300
s70n3fac3: folds 
Uncalled bet (200) returned to FDIBA2009
FDIBA2009 collected 200 from pot
*** SUMMARY ***
Total pot 200 | Rake 0 
Seat 1: s70n3fac3 (big blind) folded before Flop
Seat 2: FDIBA2009 (button) (small blind) collected (200)



PokerStars Home Game Hand #225972165938: {Club #4781089}  Hold'em No Limit (50/100) - 2021/04/18 23:08:32 EET [2021/04/18 16:08:32 ET]
Table 'Session 3' 2-max (Play Money) Seat #1 is the button
Seat 1: s70n3fac3 (16152 in chips) 
Seat 2: FDIBA2009 (16013 in chips) 
s70n3fac3: posts small blind 50
FDIBA2009: posts big blind 100
*** HOLE CARDS ***
s70n3fac3: folds 
Uncalled bet (50) returned to FDIBA2009
FDIBA2009 collected 100 from pot
*** SUMMARY ***
Total pot 100 | Rake 0 
Seat 1: s70n3fac3 (button) (small blind) folded before Flop
Seat 2: FDIBA2009 (big blind) collected (100)



PokerStars Home Game Hand #225972168924: {Club #4781089}  Hold'em No Limit (50/100) - 2021/04/18 23:08:35 EET [2021/04/18 16:08:35 ET]
Table 'Session 3' 2-max (Play Money) Seat #2 is the button
Seat 1: s70n3fac3 (16102 in chips) 
Seat 2: FDIBA2009 (16063 in chips) 
FDIBA2009: posts small blind 50
s70n3fac3: posts big blind 100
*** HOLE CARDS ***
FDIBA2009: raises 100 to 200
s70n3fac3: calls 100
*** FLOP *** [9d 7h Ad]
s70n3fac3: checks 
FDIBA2009: bets 378
s70n3fac3: folds 
Uncalled bet (378) returned to FDIBA2009
FDIBA2009 collected 378 from pot
*** SUMMARY ***
Total pot 400 | Rake 22 
Board [9d 7h Ad]
Seat 1: s70n3fac3 (big blind) folded on the Flop
Seat 2: FDIBA2009 (button) (small blind) collected (378)



PokerStars Home Game Hand #225972185118: {Club #4781089}  Hold'em No Limit (50/100) - 2021/04/18 23:08:47 EET [2021/04/18 16:08:47 ET]
Table 'Session 3' 2-max (Play Money) Seat #1 is the button
Seat 1: s70n3fac3 (15902 in chips) 
Seat 2: FDIBA2009 (16241 in chips) 
s70n3fac3: posts small blind 50
FDIBA2009: posts big blind 100
*** HOLE CARDS ***
s70n3fac3: raises 100 to 200
FDIBA2009: calls 100
*** FLOP *** [Jd 4c Ts]
FDIBA2009: checks 
s70n3fac3: bets 200
FDIBA2009: calls 200
*** TURN *** [Jd 4c Ts] [Qd]
FDIBA2009: checks 
s70n3fac3: bets 400
FDIBA2009: calls 400
*** RIVER *** [Jd 4c Ts Qd] [8d]
FDIBA2009: bets 756
s70n3fac3: raises 1474 to 2230
FDIBA2009: folds 
Uncalled bet (1474) returned to s70n3fac3
s70n3fac3 collected 2941 from pot
s70n3fac3: doesn't show hand 
*** SUMMARY ***
Total pot 3112 | Rake 171 
Board [Jd 4c Ts Qd 8d]
Seat 1: s70n3fac3 (button) (small blind) collected (2941)
Seat 2: FDIBA2009 (big blind) folded on the River



PokerStars Home Game Hand #225972220600: {Club #4781089}  Hold'em No Limit (50/100) - 2021/04/18 23:09:33 EET [2021/04/18 16:09:33 ET]
Table 'Session 3' 2-max (Play Money) Seat #2 is the button
Seat 1: s70n3fac3 (17287 in chips) 
Seat 2: FDIBA2009 (14685 in chips) 
FDIBA2009: posts small blind 50
s70n3fac3: posts big blind 100
*** HOLE CARDS ***
FDIBA2009: raises 200 to 300
s70n3fac3: folds 
Uncalled bet (200) returned to FDIBA2009
FDIBA2009 collected 200 from pot
*** SUMMARY ***
Total pot 200 | Rake 0 
Seat 1: s70n3fac3 (big blind) folded before Flop
Seat 2: FDIBA2009 (button) (small blind) collected (200)



PokerStars Home Game Hand #225972225026: {Club #4781089}  Hold'em No Limit (50/100) - 2021/04/18 23:09:39 EET [2021/04/18 16:09:39 ET]
Table 'Session 3' 2-max (Play Money) Seat #1 is the button
Seat 1: s70n3fac3 (17187 in chips) 
Seat 2: FDIBA2009 (14785 in chips) 
s70n3fac3: posts small blind 50
FDIBA2009: posts big blind 100
*** HOLE CARDS ***
s70n3fac3: folds 
Uncalled bet (50) returned to FDIBA2009
FDIBA2009 collected 100 from pot
*** SUMMARY ***
Total pot 100 | Rake 0 
Seat 1: s70n3fac3 (button) (small blind) folded before Flop
Seat 2: FDIBA2009 (big blind) collected (100)



PokerStars Home Game Hand #225972227972: {Club #4781089}  Hold'em No Limit (50/100) - 2021/04/18 23:09:43 EET [2021/04/18 16:09:43 ET]
Table 'Session 3' 2-max (Play Money) Seat #2 is the button
Seat 1: s70n3fac3 (17137 in chips) 
Seat 2: FDIBA2009 (14835 in chips) 
FDIBA2009: posts small blind 50
s70n3fac3: posts big blind 100
*** HOLE CARDS ***
FDIBA2009: raises 200 to 300
s70n3fac3: folds 
Uncalled bet (200) returned to FDIBA2009
FDIBA2009 collected 200 from pot
*** SUMMARY ***
Total pot 200 | Rake 0 
Seat 1: s70n3fac3 (big blind) folded before Flop
Seat 2: FDIBA2009 (button) (small blind) collected (200)



PokerStars Home Game Hand #225972232603: {Club #4781089}  Hold'em No Limit (50/100) - 2021/04/18 23:09:49 EET [2021/04/18 16:09:49 ET]
Table 'Session 3' 2-max (Play Money) Seat #1 is the button
Seat 1: s70n3fac3 (17037 in chips) 
Seat 2: FDIBA2009 (14935 in chips) 
s70n3fac3: posts small blind 50
FDIBA2009: posts big blind 100
*** HOLE CARDS ***
s70n3fac3: raises 100 to 200
FDIBA2009: raises 400 to 600
s70n3fac3: calls 400
*** FLOP *** [7s 6c As]
FDIBA2009: bets 567
s70n3fac3: calls 567
*** TURN *** [7s 6c As] [4h]
FDIBA2009: checks 
s70n3fac3: bets 900
FDIBA2009: folds 
Uncalled bet (900) returned to s70n3fac3
s70n3fac3 collected 2206 from pot
s70n3fac3: doesn't show hand 
*** SUMMARY ***
Total pot 2334 | Rake 128 
Board [7s 6c As 4h]
Seat 1: s70n3fac3 (button) (small blind) collected (2206)
Seat 2: FDIBA2009 (big blind) folded on the Turn



PokerStars Home Game Hand #225972247680: {Club #4781089}  Hold'em No Limit (50/100) - 2021/04/18 23:10:09 EET [2021/04/18 16:10:09 ET]
Table 'Session 3' 2-max (Play Money) Seat #2 is the button
Seat 1: s70n3fac3 (18076 in chips) 
Seat 2: FDIBA2009 (13768 in chips) 
FDIBA2009: posts small blind 50
s70n3fac3: posts big blind 100
*** HOLE CARDS ***
FDIBA2009: raises 200 to 300
s70n3fac3: calls 200
*** FLOP *** [2s Qd 5d]
s70n3fac3: checks 
FDIBA2009: checks 
*** TURN *** [2s Qd 5d] [6c]
s70n3fac3: checks 
FDIBA2009: checks 
*** RIVER *** [2s Qd 5d 6c] [4h]
s70n3fac3: checks 
FDIBA2009: bets 567
s70n3fac3: folds 
Uncalled bet (567) returned to FDIBA2009
FDIBA2009 collected 567 from pot
*** SUMMARY ***
Total pot 600 | Rake 33 
Board [2s Qd 5d 6c 4h]
Seat 1: s70n3fac3 (big blind) folded on the River
Seat 2: FDIBA2009 (button) (small blind) collected (567)



PokerStars Home Game Hand #225972261114: {Club #4781089}  Hold'em No Limit (50/100) - 2021/04/18 23:10:26 EET [2021/04/18 16:10:26 ET]
Table 'Session 3' 2-max (Play Money) Seat #1 is the button
Seat 1: s70n3fac3 (17776 in chips) 
Seat 2: FDIBA2009 (14035 in chips) 
s70n3fac3: posts small blind 50
FDIBA2009: posts big blind 100
*** HOLE CARDS ***
s70n3fac3: folds 
Uncalled bet (50) returned to FDIBA2009
FDIBA2009 collected 100 from pot
*** SUMMARY ***
Total pot 100 | Rake 0 
Seat 1: s70n3fac3 (button) (small blind) folded before Flop
Seat 2: FDIBA2009 (big blind) collected (100)



PokerStars Home Game Hand #225972264134: {Club #4781089}  Hold'em No Limit (50/100) - 2021/04/18 23:10:30 EET [2021/04/18 16:10:30 ET]
Table 'Session 3' 2-max (Play Money) Seat #2 is the button
Seat 1: s70n3fac3 (17726 in chips) 
Seat 2: FDIBA2009 (14085 in chips) 
FDIBA2009: posts small blind 50
s70n3fac3: posts big blind 100
*** HOLE CARDS ***
FDIBA2009: raises 100 to 200
s70n3fac3: calls 100
*** FLOP *** [3c Qc 2h]
s70n3fac3: checks 
FDIBA2009: bets 189
s70n3fac3: folds 
Uncalled bet (189) returned to FDIBA2009
FDIBA2009 collected 378 from pot
*** SUMMARY ***
Total pot 400 | Rake 22 
Board [3c Qc 2h]
Seat 1: s70n3fac3 (big blind) folded on the Flop
Seat 2: FDIBA2009 (button) (small blind) collected (378)



PokerStars Home Game Hand #225972273778: {Club #4781089}  Hold'em No Limit (50/100) - 2021/04/18 23:10:43 EET [2021/04/18 16:10:43 ET]
Table 'Session 3' 2-max (Play Money) Seat #1 is the button
Seat 1: s70n3fac3 (17526 in chips) 
Seat 2: FDIBA2009 (14263 in chips) 
s70n3fac3: posts small blind 50
FDIBA2009: posts big blind 100
*** HOLE CARDS ***
s70n3fac3: raises 100 to 200
FDIBA2009: calls 100
*** FLOP *** [Jh 9s Tc]
FDIBA2009: checks 
s70n3fac3: bets 200
FDIBA2009: calls 200
*** TURN *** [Jh 9s Tc] [6c]
FDIBA2009: checks 
s70n3fac3: bets 400
FDIBA2009: folds 
Uncalled bet (400) returned to s70n3fac3
s70n3fac3 collected 756 from pot
s70n3fac3: doesn't show hand 
*** SUMMARY ***
Total pot 800 | Rake 44 
Board [Jh 9s Tc 6c]
Seat 1: s70n3fac3 (button) (small blind) collected (756)
Seat 2: FDIBA2009 (big blind) folded on the Turn



PokerStars Home Game Hand #225972288811: {Club #4781089}  Hold'em No Limit (50/100) - 2021/04/18 23:11:02 EET [2021/04/18 16:11:02 ET]
Table 'Session 3' 2-max (Play Money) Seat #2 is the button
Seat 1: s70n3fac3 (17882 in chips) 
Seat 2: FDIBA2009 (13863 in chips) 
FDIBA2009: posts small blind 50
s70n3fac3: posts big blind 100
*** HOLE CARDS ***
FDIBA2009: raises 200 to 300
s70n3fac3: calls 200
*** FLOP *** [3h 7h Kc]
s70n3fac3: checks 
FDIBA2009: bets 283
s70n3fac3: calls 283
*** TURN *** [3h 7h Kc] [3s]
s70n3fac3: checks 
FDIBA2009: checks 
*** RIVER *** [3h 7h Kc 3s] [7c]
s70n3fac3: bets 850
FDIBA2009: calls 850
*** SHOW DOWN ***
s70n3fac3: shows [Ac Qh] (two pair, Sevens and Threes)
FDIBA2009: shows [Th Ts] (two pair, Tens and Sevens)
FDIBA2009 collected 2708 from pot
*** SUMMARY ***
Total pot 2866 | Rake 158 
Board [3h 7h Kc 3s 7c]
Seat 1: s70n3fac3 (big blind) showed [Ac Qh] and lost with two pair, Sevens and Threes
Seat 2: FDIBA2009 (button) (small blind) showed [Th Ts] and won (2708) with two pair, Tens and Sevens



PokerStars Home Game Hand #225972308562: {Club #4781089}  Hold'em No Limit (50/100) - 2021/04/18 23:11:28 EET [2021/04/18 16:11:28 ET]
Table 'Session 3' 2-max (Play Money) Seat #1 is the button
Seat 1: s70n3fac3 (16449 in chips) 
Seat 2: FDIBA2009 (15138 in chips) 
s70n3fac3: posts small blind 50
FDIBA2009: posts big blind 100
*** HOLE CARDS ***
s70n3fac3: raises 100 to 200
FDIBA2009: folds 
Uncalled bet (100) returned to s70n3fac3
s70n3fac3 collected 200 from pot
s70n3fac3: doesn't show hand 
*** SUMMARY ***
Total pot 200 | Rake 0 
Seat 1: s70n3fac3 (button) (small blind) collected (200)
Seat 2: FDIBA2009 (big blind) folded before Flop



PokerStars Home Game Hand #225972313267: {Club #4781089}  Hold'em No Limit (50/100) - 2021/04/18 23:11:34 EET [2021/04/18 16:11:34 ET]
Table 'Session 3' 2-max (Play Money) Seat #2 is the button
Seat 1: s70n3fac3 (16549 in chips) 
Seat 2: FDIBA2009 (15038 in chips) 
FDIBA2009: posts small blind 50
s70n3fac3: posts big blind 100
*** HOLE CARDS ***
FDIBA2009: raises 100 to 200
s70n3fac3: calls 100
*** FLOP *** [4h Kh Js]
s70n3fac3: checks 
FDIBA2009: bets 189
s70n3fac3: raises 461 to 650
FDIBA2009: folds 
Uncalled bet (461) returned to s70n3fac3
s70n3fac3 collected 735 from pot
s70n3fac3: doesn't show hand 
*** SUMMARY ***
Total pot 778 | Rake 43 
Board [4h Kh Js]
Seat 1: s70n3fac3 (big blind) collected (735)
Seat 2: FDIBA2009 (button) (small blind) folded on the Flop



PokerStars Home Game Hand #225972324281: {Club #4781089}  Hold'em No Limit (50/100) - 2021/04/18 23:11:49 EET [2021/04/18 16:11:49 ET]
Table 'Session 3' 2-max (Play Money) Seat #1 is the button
Seat 1: s70n3fac3 (16895 in chips) 
Seat 2: FDIBA2009 (14649 in chips) 
s70n3fac3: posts small blind 50
FDIBA2009: posts big blind 100
*** HOLE CARDS ***
s70n3fac3: folds 
Uncalled bet (50) returned to FDIBA2009
FDIBA2009 collected 100 from pot
*** SUMMARY ***
Total pot 100 | Rake 0 
Seat 1: s70n3fac3 (button) (small blind) folded before Flop
Seat 2: FDIBA2009 (big blind) collected (100)



PokerStars Home Game Hand #225972327104: {Club #4781089}  Hold'em No Limit (50/100) - 2021/04/18 23:11:53 EET [2021/04/18 16:11:53 ET]
Table 'Session 3' 2-max (Play Money) Seat #2 is the button
Seat 1: s70n3fac3 (16845 in chips) 
Seat 2: FDIBA2009 (14699 in chips) 
FDIBA2009: posts small blind 50
s70n3fac3: posts big blind 100
*** HOLE CARDS ***
FDIBA2009: raises 100 to 200
s70n3fac3: folds 
Uncalled bet (100) returned to FDIBA2009
FDIBA2009 collected 200 from pot
*** SUMMARY ***
Total pot 200 | Rake 0 
Seat 1: s70n3fac3 (big blind) folded before Flop
Seat 2: FDIBA2009 (button) (small blind) collected (200)



PokerStars Home Game Hand #225972331802: {Club #4781089}  Hold'em No Limit (50/100) - 2021/04/18 23:11:59 EET [2021/04/18 16:11:59 ET]
Table 'Session 3' 2-max (Play Money) Seat #1 is the button
Seat 1: s70n3fac3 (16745 in chips) 
Seat 2: FDIBA2009 (14799 in chips) 
s70n3fac3: posts small blind 50
FDIBA2009: posts big blind 100
*** HOLE CARDS ***
s70n3fac3: raises 100 to 200
FDIBA2009: calls 100
*** FLOP *** [2h 9s Ts]
FDIBA2009: checks 
s70n3fac3: bets 200
FDIBA2009: folds 
Uncalled bet (200) returned to s70n3fac3
s70n3fac3 collected 378 from pot
s70n3fac3: doesn't show hand 
*** SUMMARY ***
Total pot 400 | Rake 22 
Board [2h 9s Ts]
Seat 1: s70n3fac3 (button) (small blind) collected (378)
Seat 2: FDIBA2009 (big blind) folded on the Flop



PokerStars Home Game Hand #225972339433: {Club #4781089}  Hold'em No Limit (50/100) - 2021/04/18 23:12:09 EET [2021/04/18 16:12:09 ET]
Table 'Session 3' 2-max (Play Money) Seat #2 is the button
Seat 1: s70n3fac3 (16923 in chips) 
Seat 2: FDIBA2009 (14599 in chips) 
FDIBA2009: posts small blind 50
s70n3fac3: posts big blind 100
*** HOLE CARDS ***
FDIBA2009: raises 100 to 200
s70n3fac3: calls 100
*** FLOP *** [Ac 6s 9s]
s70n3fac3: checks 
FDIBA2009: checks 
*** TURN *** [Ac 6s 9s] [Ad]
s70n3fac3: bets 200
FDIBA2009: folds 
Uncalled bet (200) returned to s70n3fac3
s70n3fac3 collected 378 from pot
s70n3fac3: doesn't show hand 
*** SUMMARY ***
Total pot 400 | Rake 22 
Board [Ac 6s 9s Ad]
Seat 1: s70n3fac3 (big blind) collected (378)
Seat 2: FDIBA2009 (button) (small blind) folded on the Turn



PokerStars Home Game Hand #225972348674: {Club #4781089}  Hold'em No Limit (50/100) - 2021/04/18 23:12:21 EET [2021/04/18 16:12:21 ET]
Table 'Session 3' 2-max (Play Money) Seat #1 is the button
Seat 1: s70n3fac3 (17101 in chips) 
Seat 2: FDIBA2009 (14399 in chips) 
s70n3fac3: posts small blind 50
FDIBA2009: posts big blind 100
*** HOLE CARDS ***
s70n3fac3: folds 
Uncalled bet (50) returned to FDIBA2009
FDIBA2009 collected 100 from pot
*** SUMMARY ***
Total pot 100 | Rake 0 
Seat 1: s70n3fac3 (button) (small blind) folded before Flop
Seat 2: FDIBA2009 (big blind) collected (100)



PokerStars Home Game Hand #225972351872: {Club #4781089}  Hold'em No Limit (50/100) - 2021/04/18 23:12:25 EET [2021/04/18 16:12:25 ET]
Table 'Session 3' 2-max (Play Money) Seat #2 is the button
Seat 1: s70n3fac3 (17051 in chips) 
Seat 2: FDIBA2009 (14449 in chips) 
FDIBA2009: posts small blind 50
s70n3fac3: posts big blind 100
*** HOLE CARDS ***
FDIBA2009: raises 100 to 200
s70n3fac3: folds 
Uncalled bet (100) returned to FDIBA2009
FDIBA2009 collected 200 from pot
*** SUMMARY ***
Total pot 200 | Rake 0 
Seat 1: s70n3fac3 (big blind) folded before Flop
Seat 2: FDIBA2009 (button) (small blind) collected (200)



PokerStars Home Game Hand #225972356189: {Club #4781089}  Hold'em No Limit (50/100) - 2021/04/18 23:12:31 EET [2021/04/18 16:12:31 ET]
Table 'Session 3' 2-max (Play Money) Seat #1 is the button
Seat 1: s70n3fac3 (16951 in chips) 
Seat 2: FDIBA2009 (14549 in chips) 
s70n3fac3: posts small blind 50
FDIBA2009: posts big blind 100
*** HOLE CARDS ***
s70n3fac3: raises 100 to 200
FDIBA2009: folds 
Uncalled bet (100) returned to s70n3fac3
s70n3fac3 collected 200 from pot
s70n3fac3: doesn't show hand 
*** SUMMARY ***
Total pot 200 | Rake 0 
Seat 1: s70n3fac3 (button) (small blind) collected (200)
Seat 2: FDIBA2009 (big blind) folded before Flop



PokerStars Home Game Hand #225972360562: {Club #4781089}  Hold'em No Limit (50/100) - 2021/04/18 23:12:37 EET [2021/04/18 16:12:37 ET]
Table 'Session 3' 2-max (Play Money) Seat #2 is the button
Seat 1: s70n3fac3 (17051 in chips) 
Seat 2: FDIBA2009 (14449 in chips) 
FDIBA2009: posts small blind 50
s70n3fac3: posts big blind 100
*** HOLE CARDS ***
FDIBA2009: raises 100 to 200
s70n3fac3: raises 300 to 500
FDIBA2009: folds 
Uncalled bet (300) returned to s70n3fac3
s70n3fac3 collected 400 from pot
s70n3fac3: doesn't show hand 
*** SUMMARY ***
Total pot 400 | Rake 0 
Seat 1: s70n3fac3 (big blind) collected (400)
Seat 2: FDIBA2009 (button) (small blind) folded before Flop



PokerStars Home Game Hand #225972369107: {Club #4781089}  Hold'em No Limit (50/100) - 2021/04/18 23:12:48 EET [2021/04/18 16:12:48 ET]
Table 'Session 3' 2-max (Play Money) Seat #1 is the button
Seat 1: s70n3fac3 (17251 in chips) 
Seat 2: FDIBA2009 (14249 in chips) 
s70n3fac3: posts small blind 50
FDIBA2009: posts big blind 100
*** HOLE CARDS ***
s70n3fac3: raises 100 to 200
FDIBA2009: raises 400 to 600
s70n3fac3: folds 
Uncalled bet (400) returned to FDIBA2009
FDIBA2009 collected 400 from pot
*** SUMMARY ***
Total pot 400 | Rake 0 
Seat 1: s70n3fac3 (button) (small blind) folded before Flop
Seat 2: FDIBA2009 (big blind) collected (400)



PokerStars Home Game Hand #225972374259: {Club #4781089}  Hold'em No Limit (50/100) - 2021/04/18 23:12:55 EET [2021/04/18 16:12:55 ET]
Table 'Session 3' 2-max (Play Money) Seat #2 is the button
Seat 1: s70n3fac3 (17051 in chips) 
Seat 2: FDIBA2009 (14449 in chips) 
FDIBA2009: posts small blind 50
s70n3fac3: posts big blind 100
*** HOLE CARDS ***
FDIBA2009: raises 100 to 200
s70n3fac3: folds 
Uncalled bet (100) returned to FDIBA2009
FDIBA2009 collected 200 from pot
*** SUMMARY ***
Total pot 200 | Rake 0 
Seat 1: s70n3fac3 (big blind) folded before Flop
Seat 2: FDIBA2009 (button) (small blind) collected (200)



PokerStars Home Game Hand #225972378316: {Club #4781089}  Hold'em No Limit (50/100) - 2021/04/18 23:13:00 EET [2021/04/18 16:13:00 ET]
Table 'Session 3' 2-max (Play Money) Seat #1 is the button
Seat 1: s70n3fac3 (16951 in chips) 
Seat 2: FDIBA2009 (14549 in chips) 
s70n3fac3: posts small blind 50
FDIBA2009: posts big blind 100
*** HOLE CARDS ***
s70n3fac3: raises 100 to 200
FDIBA2009: calls 100
*** FLOP *** [7d 2s Jd]
FDIBA2009: checks 
s70n3fac3: checks 
*** TURN *** [7d 2s Jd] [9s]
FDIBA2009: checks 
s70n3fac3: bets 300
FDIBA2009: folds 
Uncalled bet (300) returned to s70n3fac3
s70n3fac3 collected 378 from pot
s70n3fac3: doesn't show hand 
*** SUMMARY ***
Total pot 400 | Rake 22 
Board [7d 2s Jd 9s]
Seat 1: s70n3fac3 (button) (small blind) collected (378)
Seat 2: FDIBA2009 (big blind) folded on the Turn



PokerStars Home Game Hand #225972389138: {Club #4781089}  Hold'em No Limit (50/100) - 2021/04/18 23:13:15 EET [2021/04/18 16:13:15 ET]
Table 'Session 3' 2-max (Play Money) Seat #2 is the button
Seat 1: s70n3fac3 (17129 in chips) 
Seat 2: FDIBA2009 (14349 in chips) 
FDIBA2009: posts small blind 50
s70n3fac3: posts big blind 100
*** HOLE CARDS ***
FDIBA2009: raises 200 to 300
s70n3fac3: folds 
Uncalled bet (200) returned to FDIBA2009
FDIBA2009 collected 200 from pot
*** SUMMARY ***
Total pot 200 | Rake 0 
Seat 1: s70n3fac3 (big blind) folded before Flop
Seat 2: FDIBA2009 (button) (small blind) collected (200)



PokerStars Home Game Hand #225972393308: {Club #4781089}  Hold'em No Limit (50/100) - 2021/04/18 23:13:20 EET [2021/04/18 16:13:20 ET]
Table 'Session 3' 2-max (Play Money) Seat #1 is the button
Seat 1: s70n3fac3 (17029 in chips) 
Seat 2: FDIBA2009 (14449 in chips) 
s70n3fac3: posts small blind 50
FDIBA2009: posts big blind 100
*** HOLE CARDS ***
s70n3fac3: folds 
Uncalled bet (50) returned to FDIBA2009
FDIBA2009 collected 100 from pot
*** SUMMARY ***
Total pot 100 | Rake 0 
Seat 1: s70n3fac3 (button) (small blind) folded before Flop
Seat 2: FDIBA2009 (big blind) collected (100)



PokerStars Home Game Hand #225972396493: {Club #4781089}  Hold'em No Limit (50/100) - 2021/04/18 23:13:24 EET [2021/04/18 16:13:24 ET]
Table 'Session 3' 2-max (Play Money) Seat #2 is the button
Seat 1: s70n3fac3 (16979 in chips) 
Seat 2: FDIBA2009 (14499 in chips) 
FDIBA2009: posts small blind 50
s70n3fac3: posts big blind 100
*** HOLE CARDS ***
FDIBA2009: calls 50
s70n3fac3: checks 
*** FLOP *** [5s Qc 3c]
s70n3fac3: checks 
FDIBA2009: bets 189
s70n3fac3: calls 189
*** TURN *** [5s Qc 3c] [8c]
s70n3fac3: checks 
FDIBA2009: checks 
*** RIVER *** [5s Qc 3c 8c] [As]
s70n3fac3: checks 
FDIBA2009: bets 546
s70n3fac3: folds 
Uncalled bet (546) returned to FDIBA2009
FDIBA2009 collected 546 from pot
*** SUMMARY ***
Total pot 578 | Rake 32 
Board [5s Qc 3c 8c As]
Seat 1: s70n3fac3 (big blind) folded on the River
Seat 2: FDIBA2009 (button) (small blind) collected (546)



PokerStars Home Game Hand #225972414988: {Club #4781089}  Hold'em No Limit (50/100) - 2021/04/18 23:13:49 EET [2021/04/18 16:13:49 ET]
Table 'Session 3' 2-max (Play Money) Seat #1 is the button
Seat 1: s70n3fac3 (16690 in chips) 
Seat 2: FDIBA2009 (14756 in chips) 
s70n3fac3: posts small blind 50
FDIBA2009: posts big blind 100
*** HOLE CARDS ***
s70n3fac3: raises 100 to 200
FDIBA2009: folds 
Uncalled bet (100) returned to s70n3fac3
s70n3fac3 collected 200 from pot
s70n3fac3: doesn't show hand 
*** SUMMARY ***
Total pot 200 | Rake 0 
Seat 1: s70n3fac3 (button) (small blind) collected (200)
Seat 2: FDIBA2009 (big blind) folded before Flop



PokerStars Home Game Hand #225972418891: {Club #4781089}  Hold'em No Limit (50/100) - 2021/04/18 23:13:54 EET [2021/04/18 16:13:54 ET]
Table 'Session 3' 2-max (Play Money) Seat #2 is the button
Seat 1: s70n3fac3 (16790 in chips) 
Seat 2: FDIBA2009 (14656 in chips) 
FDIBA2009: posts small blind 50
s70n3fac3: posts big blind 100
*** HOLE CARDS ***
FDIBA2009: raises 100 to 200
s70n3fac3: calls 100
*** FLOP *** [7h 9h Kh]
s70n3fac3: checks 
FDIBA2009: bets 378
s70n3fac3: folds 
Uncalled bet (378) returned to FDIBA2009
FDIBA2009 collected 378 from pot
*** SUMMARY ***
Total pot 400 | Rake 22 
Board [7h 9h Kh]
Seat 1: s70n3fac3 (big blind) folded on the Flop
Seat 2: FDIBA2009 (button) (small blind) collected (378)



PokerStars Home Game Hand #225972427169: {Club #4781089}  Hold'em No Limit (50/100) - 2021/04/18 23:14:05 EET [2021/04/18 16:14:05 ET]
Table 'Session 3' 2-max (Play Money) Seat #1 is the button
Seat 1: s70n3fac3 (16590 in chips) 
Seat 2: FDIBA2009 (14834 in chips) 
s70n3fac3: posts small blind 50
FDIBA2009: posts big blind 100
*** HOLE CARDS ***
s70n3fac3: folds 
Uncalled bet (50) returned to FDIBA2009
FDIBA2009 collected 100 from pot
*** SUMMARY ***
Total pot 100 | Rake 0 
Seat 1: s70n3fac3 (button) (small blind) folded before Flop
Seat 2: FDIBA2009 (big blind) collected (100)



PokerStars Home Game Hand #225972430228: {Club #4781089}  Hold'em No Limit (50/100) - 2021/04/18 23:14:09 EET [2021/04/18 16:14:09 ET]
Table 'Session 3' 2-max (Play Money) Seat #2 is the button
Seat 1: s70n3fac3 (16540 in chips) 
Seat 2: FDIBA2009 (14884 in chips) 
FDIBA2009: posts small blind 50
s70n3fac3: posts big blind 100
*** HOLE CARDS ***
FDIBA2009: folds 
Uncalled bet (50) returned to s70n3fac3
s70n3fac3 collected 100 from pot
s70n3fac3: doesn't show hand 
*** SUMMARY ***
Total pot 100 | Rake 0 
Seat 1: s70n3fac3 (big blind) collected (100)
Seat 2: FDIBA2009 (button) (small blind) folded before Flop



PokerStars Home Game Hand #225972434506: {Club #4781089}  Hold'em No Limit (50/100) - 2021/04/18 23:14:15 EET [2021/04/18 16:14:15 ET]
Table 'Session 3' 2-max (Play Money) Seat #1 is the button
Seat 1: s70n3fac3 (16590 in chips) 
Seat 2: FDIBA2009 (14834 in chips) 
s70n3fac3: posts small blind 50
FDIBA2009: posts big blind 100
*** HOLE CARDS ***
s70n3fac3: folds 
Uncalled bet (50) returned to FDIBA2009
FDIBA2009 collected 100 from pot
*** SUMMARY ***
Total pot 100 | Rake 0 
Seat 1: s70n3fac3 (button) (small blind) folded before Flop
Seat 2: FDIBA2009 (big blind) collected (100)



PokerStars Home Game Hand #225972437239: {Club #4781089}  Hold'em No Limit (50/100) - 2021/04/18 23:14:18 EET [2021/04/18 16:14:18 ET]
Table 'Session 3' 2-max (Play Money) Seat #2 is the button
Seat 1: s70n3fac3 (16540 in chips) 
Seat 2: FDIBA2009 (14884 in chips) 
FDIBA2009: posts small blind 50
s70n3fac3: posts big blind 100
*** HOLE CARDS ***
FDIBA2009: raises 100 to 200
s70n3fac3: calls 100
*** FLOP *** [9c 6h 8c]
s70n3fac3: checks 
FDIBA2009: checks 
*** TURN *** [9c 6h 8c] [3c]
s70n3fac3: bets 200
FDIBA2009: calls 200
*** RIVER *** [9c 6h 8c 3c] [As]
s70n3fac3: checks 
FDIBA2009: checks 
*** SHOW DOWN ***
s70n3fac3: shows [8s Jc] (a pair of Eights)
FDIBA2009: mucks hand 
s70n3fac3 collected 756 from pot
*** SUMMARY ***
Total pot 800 | Rake 44 
Board [9c 6h 8c 3c As]
Seat 1: s70n3fac3 (big blind) showed [8s Jc] and won (756) with a pair of Eights
Seat 2: FDIBA2009 (button) (small blind) mucked [Qc 4s]



PokerStars Home Game Hand #225972454350: {Club #4781089}  Hold'em No Limit (50/100) - 2021/04/18 23:14:42 EET [2021/04/18 16:14:42 ET]
Table 'Session 3' 2-max (Play Money) Seat #1 is the button
Seat 1: s70n3fac3 (16896 in chips) 
Seat 2: FDIBA2009 (14484 in chips) 
s70n3fac3: posts small blind 50
FDIBA2009: posts big blind 100
*** HOLE CARDS ***
s70n3fac3: raises 100 to 200
FDIBA2009: raises 400 to 600
s70n3fac3: calls 400
*** FLOP *** [Ah 6h Kh]
FDIBA2009: bets 567
s70n3fac3: raises 567 to 1134
FDIBA2009: folds 
Uncalled bet (567) returned to s70n3fac3
s70n3fac3 collected 2206 from pot
s70n3fac3: doesn't show hand 
*** SUMMARY ***
Total pot 2334 | Rake 128 
Board [Ah 6h Kh]
Seat 1: s70n3fac3 (button) (small blind) collected (2206)
Seat 2: FDIBA2009 (big blind) folded on the Flop



PokerStars Home Game Hand #225972468724: {Club #4781089}  Hold'em No Limit (50/100) - 2021/04/18 23:15:01 EET [2021/04/18 16:15:01 ET]
Table 'Session 3' 2-max (Play Money) Seat #2 is the button
Seat 1: s70n3fac3 (17935 in chips) 
Seat 2: FDIBA2009 (13317 in chips) 
FDIBA2009: posts small blind 50
s70n3fac3: posts big blind 100
*** HOLE CARDS ***
FDIBA2009: raises 200 to 300
s70n3fac3: calls 200
*** FLOP *** [5s 9d Jh]
s70n3fac3: checks 
FDIBA2009: bets 283
s70n3fac3: calls 283
*** TURN *** [5s 9d Jh] [7s]
s70n3fac3: checks 
FDIBA2009: checks 
*** RIVER *** [5s 9d Jh 7s] [7h]
s70n3fac3: bets 500
FDIBA2009: folds 
Uncalled bet (500) returned to s70n3fac3
s70n3fac3 collected 1102 from pot
s70n3fac3: doesn't show hand 
*** SUMMARY ***
Total pot 1166 | Rake 64 
Board [5s 9d Jh 7s 7h]
Seat 1: s70n3fac3 (big blind) collected (1102)
Seat 2: FDIBA2009 (button) (small blind) folded on the River



PokerStars Home Game Hand #225972489333: {Club #4781089}  Hold'em No Limit (50/100) - 2021/04/18 23:15:28 EET [2021/04/18 16:15:28 ET]
Table 'Session 3' 2-max (Play Money) Seat #1 is the button
Seat 1: s70n3fac3 (18454 in chips) 
Seat 2: FDIBA2009 (12734 in chips) 
s70n3fac3: posts small blind 50
FDIBA2009: posts big blind 100
*** HOLE CARDS ***
s70n3fac3: folds 
Uncalled bet (50) returned to FDIBA2009
FDIBA2009 collected 100 from pot
*** SUMMARY ***
Total pot 100 | Rake 0 
Seat 1: s70n3fac3 (button) (small blind) folded before Flop
Seat 2: FDIBA2009 (big blind) collected (100)



PokerStars Home Game Hand #225972492376: {Club #4781089}  Hold'em No Limit (50/100) - 2021/04/18 23:15:32 EET [2021/04/18 16:15:32 ET]
Table 'Session 3' 2-max (Play Money) Seat #2 is the button
Seat 1: s70n3fac3 (18404 in chips) 
Seat 2: FDIBA2009 (12784 in chips) 
FDIBA2009: posts small blind 50
s70n3fac3: posts big blind 100
*** HOLE CARDS ***
FDIBA2009: raises 200 to 300
s70n3fac3: calls 200
*** FLOP *** [Jh 3d Qs]
s70n3fac3: checks 
FDIBA2009: bets 567
s70n3fac3: folds 
Uncalled bet (567) returned to FDIBA2009
FDIBA2009 collected 567 from pot
*** SUMMARY ***
Total pot 600 | Rake 33 
Board [Jh 3d Qs]
Seat 1: s70n3fac3 (big blind) folded on the Flop
Seat 2: FDIBA2009 (button) (small blind) collected (567)



PokerStars Home Game Hand #225972501901: {Club #4781089}  Hold'em No Limit (50/100) - 2021/04/18 23:15:44 EET [2021/04/18 16:15:44 ET]
Table 'Session 3' 2-max (Play Money) Seat #1 is the button
Seat 1: s70n3fac3 (18104 in chips) 
Seat 2: FDIBA2009 (13051 in chips) 
s70n3fac3: posts small blind 50
FDIBA2009: posts big blind 100
*** HOLE CARDS ***
s70n3fac3: calls 50
FDIBA2009: checks 
*** FLOP *** [9c 4h 3s]
FDIBA2009: checks 
s70n3fac3: checks 
*** TURN *** [9c 4h 3s] [8c]
FDIBA2009: bets 189
s70n3fac3: calls 189
*** RIVER *** [9c 4h 3s 8c] [8h]
FDIBA2009: checks 
s70n3fac3: checks 
*** SHOW DOWN ***
FDIBA2009: shows [3d Jc] (two pair, Eights and Threes)
s70n3fac3: mucks hand 
FDIBA2009 collected 546 from pot
*** SUMMARY ***
Total pot 578 | Rake 32 
Board [9c 4h 3s 8c 8h]
Seat 1: s70n3fac3 (button) (small blind) mucked [6s 7h]
Seat 2: FDIBA2009 (big blind) showed [3d Jc] and won (546) with two pair, Eights and Threes



PokerStars Home Game Hand #225972515522: {Club #4781089}  Hold'em No Limit (50/100) - 2021/04/18 23:16:02 EET [2021/04/18 16:16:02 ET]
Table 'Session 3' 2-max (Play Money) Seat #2 is the button
Seat 1: s70n3fac3 (17815 in chips) 
Seat 2: FDIBA2009 (13308 in chips) 
FDIBA2009: posts small blind 50
s70n3fac3: posts big blind 100
*** HOLE CARDS ***
FDIBA2009: raises 100 to 200
s70n3fac3: folds 
Uncalled bet (100) returned to FDIBA2009
FDIBA2009 collected 200 from pot
*** SUMMARY ***
Total pot 200 | Rake 0 
Seat 1: s70n3fac3 (big blind) folded before Flop
Seat 2: FDIBA2009 (button) (small blind) collected (200)



PokerStars Home Game Hand #225972519711: {Club #4781089}  Hold'em No Limit (50/100) - 2021/04/18 23:16:07 EET [2021/04/18 16:16:07 ET]
Table 'Session 3' 2-max (Play Money) Seat #1 is the button
Seat 1: s70n3fac3 (17715 in chips) 
Seat 2: FDIBA2009 (13408 in chips) 
s70n3fac3: posts small blind 50
FDIBA2009: posts big blind 100
*** HOLE CARDS ***
s70n3fac3: folds 
Uncalled bet (50) returned to FDIBA2009
FDIBA2009 collected 100 from pot
*** SUMMARY ***
Total pot 100 | Rake 0 
Seat 1: s70n3fac3 (button) (small blind) folded before Flop
Seat 2: FDIBA2009 (big blind) collected (100)



PokerStars Home Game Hand #225972522805: {Club #4781089}  Hold'em No Limit (50/100) - 2021/04/18 23:16:11 EET [2021/04/18 16:16:11 ET]
Table 'Session 3' 2-max (Play Money) Seat #2 is the button
Seat 1: s70n3fac3 (17665 in chips) 
Seat 2: FDIBA2009 (13458 in chips) 
FDIBA2009: posts small blind 50
s70n3fac3: posts big blind 100
*** HOLE CARDS ***
FDIBA2009: raises 100 to 200
s70n3fac3: raises 300 to 500
FDIBA2009: folds 
Uncalled bet (300) returned to s70n3fac3
s70n3fac3 collected 400 from pot
s70n3fac3: doesn't show hand 
*** SUMMARY ***
Total pot 400 | Rake 0 
Seat 1: s70n3fac3 (big blind) collected (400)
Seat 2: FDIBA2009 (button) (small blind) folded before Flop



PokerStars Home Game Hand #225972530728: {Club #4781089}  Hold'em No Limit (50/100) - 2021/04/18 23:16:21 EET [2021/04/18 16:16:21 ET]
Table 'Session 3' 2-max (Play Money) Seat #1 is the button
Seat 1: s70n3fac3 (17865 in chips) 
Seat 2: FDIBA2009 (13258 in chips) 
s70n3fac3: posts small blind 50
FDIBA2009: posts big blind 100
*** HOLE CARDS ***
s70n3fac3: raises 100 to 200
FDIBA2009: calls 100
*** FLOP *** [Jd Ks 8d]
FDIBA2009: checks 
s70n3fac3: bets 200
FDIBA2009: folds 
Uncalled bet (200) returned to s70n3fac3
s70n3fac3 collected 378 from pot
s70n3fac3: doesn't show hand 
*** SUMMARY ***
Total pot 400 | Rake 22 
Board [Jd Ks 8d]
Seat 1: s70n3fac3 (button) (small blind) collected (378)
Seat 2: FDIBA2009 (big blind) folded on the Flop



PokerStars Home Game Hand #225972538857: {Club #4781089}  Hold'em No Limit (50/100) - 2021/04/18 23:16:32 EET [2021/04/18 16:16:32 ET]
Table 'Session 3' 2-max (Play Money) Seat #2 is the button
Seat 1: s70n3fac3 (18043 in chips) 
Seat 2: FDIBA2009 (13058 in chips) 
FDIBA2009: posts small blind 50
s70n3fac3: posts big blind 100
*** HOLE CARDS ***
FDIBA2009: raises 100 to 200
s70n3fac3: raises 300 to 500
FDIBA2009: calls 300
*** FLOP *** [Qh 7c Ad]
s70n3fac3: bets 500
FDIBA2009: folds 
Uncalled bet (500) returned to s70n3fac3
s70n3fac3 collected 945 from pot
s70n3fac3: doesn't show hand 
*** SUMMARY ***
Total pot 1000 | Rake 55 
Board [Qh 7c Ad]
Seat 1: s70n3fac3 (big blind) collected (945)
Seat 2: FDIBA2009 (button) (small blind) folded on the Flop



PokerStars Home Game Hand #225972548936: {Club #4781089}  Hold'em No Limit (50/100) - 2021/04/18 23:16:45 EET [2021/04/18 16:16:45 ET]
Table 'Session 3' 2-max (Play Money) Seat #1 is the button
Seat 1: s70n3fac3 (18488 in chips) 
Seat 2: FDIBA2009 (12558 in chips) 
s70n3fac3: posts small blind 50
FDIBA2009: posts big blind 100
*** HOLE CARDS ***
s70n3fac3: raises 200 to 300
FDIBA2009: folds 
Uncalled bet (200) returned to s70n3fac3
s70n3fac3 collected 200 from pot
s70n3fac3: doesn't show hand 
*** SUMMARY ***
Total pot 200 | Rake 0 
Seat 1: s70n3fac3 (button) (small blind) collected (200)
Seat 2: FDIBA2009 (big blind) folded before Flop



PokerStars Home Game Hand #225972552971: {Club #4781089}  Hold'em No Limit (50/100) - 2021/04/18 23:16:50 EET [2021/04/18 16:16:50 ET]
Table 'Session 3' 2-max (Play Money) Seat #2 is the button
Seat 1: s70n3fac3 (18588 in chips) 
Seat 2: FDIBA2009 (12458 in chips) 
FDIBA2009: posts small blind 50
s70n3fac3: posts big blind 100
*** HOLE CARDS ***
FDIBA2009: raises 200 to 300
s70n3fac3: raises 500 to 800
FDIBA2009: calls 500
*** FLOP *** [8c Qs 6d]
s70n3fac3: checks 
FDIBA2009: bets 1512
s70n3fac3: calls 1512
*** TURN *** [8c Qs 6d] [5h]
s70n3fac3: checks 
FDIBA2009: checks 
*** RIVER *** [8c Qs 6d 5h] [Ad]
s70n3fac3: checks 
FDIBA2009: bets 4370
s70n3fac3: folds 
Uncalled bet (4370) returned to FDIBA2009
FDIBA2009 collected 4370 from pot
*** SUMMARY ***
Total pot 4624 | Rake 254 
Board [8c Qs 6d 5h Ad]
Seat 1: s70n3fac3 (big blind) folded on the River
Seat 2: FDIBA2009 (button) (small blind) collected (4370)



PokerStars Home Game Hand #225972591843: {Club #4781089}  Hold'em No Limit (50/100) - 2021/04/18 23:17:41 EET [2021/04/18 16:17:41 ET]
Table 'Session 3' 2-max (Play Money) Seat #1 is the button
Seat 1: s70n3fac3 (16276 in chips) 
Seat 2: FDIBA2009 (14516 in chips) 
s70n3fac3: posts small blind 50
FDIBA2009: posts big blind 100
*** HOLE CARDS ***
s70n3fac3: calls 50
FDIBA2009: checks 
*** FLOP *** [8d 5d Ks]
FDIBA2009: checks 
s70n3fac3: bets 200
FDIBA2009: folds 
Uncalled bet (200) returned to s70n3fac3
s70n3fac3 collected 189 from pot
s70n3fac3: doesn't show hand 
*** SUMMARY ***
Total pot 200 | Rake 11 
Board [8d 5d Ks]
Seat 1: s70n3fac3 (button) (small blind) collected (189)
Seat 2: FDIBA2009 (big blind) folded on the Flop



PokerStars Home Game Hand #225972599137: {Club #4781089}  Hold'em No Limit (50/100) - 2021/04/18 23:17:51 EET [2021/04/18 16:17:51 ET]
Table 'Session 3' 2-max (Play Money) Seat #2 is the button
Seat 1: s70n3fac3 (16365 in chips) 
Seat 2: FDIBA2009 (14416 in chips) 
FDIBA2009: posts small blind 50
s70n3fac3: posts big blind 100
*** HOLE CARDS ***
FDIBA2009: raises 200 to 300
s70n3fac3: calls 200
*** FLOP *** [5c 3d 8h]
s70n3fac3: checks 
FDIBA2009: bets 283
s70n3fac3: calls 283
*** TURN *** [5c 3d 8h] [Ah]
s70n3fac3: checks 
FDIBA2009: checks 
*** RIVER *** [5c 3d 8h Ah] [Ts]
s70n3fac3: bets 300
FDIBA2009: calls 300
*** SHOW DOWN ***
s70n3fac3: shows [Js Qc] (high card Ace)
FDIBA2009: shows [6h 6s] (a pair of Sixes)
FDIBA2009 collected 1669 from pot
*** SUMMARY ***
Total pot 1766 | Rake 97 
Board [5c 3d 8h Ah Ts]
Seat 1: s70n3fac3 (big blind) showed [Js Qc] and lost with high card Ace
Seat 2: FDIBA2009 (button) (small blind) showed [6h 6s] and won (1669) with a pair of Sixes



PokerStars Home Game Hand #225972612597: {Club #4781089}  Hold'em No Limit (50/100) - 2021/04/18 23:18:08 EET [2021/04/18 16:18:08 ET]
Table 'Session 3' 2-max (Play Money) Seat #1 is the button
Seat 1: s70n3fac3 (15482 in chips) 
Seat 2: FDIBA2009 (15202 in chips) 
s70n3fac3: posts small blind 50
FDIBA2009: posts big blind 100
*** HOLE CARDS ***
s70n3fac3: calls 50
FDIBA2009: raises 200 to 300
s70n3fac3: calls 200
*** FLOP *** [Qh Ac As]
FDIBA2009: bets 283
s70n3fac3: raises 417 to 700
FDIBA2009: folds 
Uncalled bet (417) returned to s70n3fac3
s70n3fac3 collected 1102 from pot
s70n3fac3: doesn't show hand 
*** SUMMARY ***
Total pot 1166 | Rake 64 
Board [Qh Ac As]
Seat 1: s70n3fac3 (button) (small blind) collected (1102)
Seat 2: FDIBA2009 (big blind) folded on the Flop



PokerStars Home Game Hand #225972623764: {Club #4781089}  Hold'em No Limit (50/100) - 2021/04/18 23:18:23 EET [2021/04/18 16:18:23 ET]
Table 'Session 3' 2-max (Play Money) Seat #2 is the button
Seat 1: s70n3fac3 (16001 in chips) 
Seat 2: FDIBA2009 (14619 in chips) 
FDIBA2009: posts small blind 50
s70n3fac3: posts big blind 100
*** HOLE CARDS ***
FDIBA2009: raises 100 to 200
s70n3fac3: calls 100
*** FLOP *** [8s 7c 3d]
s70n3fac3: checks 
FDIBA2009: bets 189
s70n3fac3: folds 
Uncalled bet (189) returned to FDIBA2009
FDIBA2009 collected 378 from pot
*** SUMMARY ***
Total pot 400 | Rake 22 
Board [8s 7c 3d]
Seat 1: s70n3fac3 (big blind) folded on the Flop
Seat 2: FDIBA2009 (button) (small blind) collected (378)



PokerStars Home Game Hand #225972632926: {Club #4781089}  Hold'em No Limit (50/100) - 2021/04/18 23:18:35 EET [2021/04/18 16:18:35 ET]
Table 'Session 3' 2-max (Play Money) Seat #1 is the button
Seat 1: s70n3fac3 (15801 in chips) 
Seat 2: FDIBA2009 (14797 in chips) 
s70n3fac3: posts small blind 50
FDIBA2009: posts big blind 100
*** HOLE CARDS ***
s70n3fac3: raises 100 to 200
FDIBA2009: calls 100
*** FLOP *** [7h 8d 2s]
FDIBA2009: bets 189
s70n3fac3: folds 
Uncalled bet (189) returned to FDIBA2009
FDIBA2009 collected 378 from pot
*** SUMMARY ***
Total pot 400 | Rake 22 
Board [7h 8d 2s]
Seat 1: s70n3fac3 (button) (small blind) folded on the Flop
Seat 2: FDIBA2009 (big blind) collected (378)



PokerStars Home Game Hand #225972642281: {Club #4781089}  Hold'em No Limit (50/100) - 2021/04/18 23:18:47 EET [2021/04/18 16:18:47 ET]
Table 'Session 3' 2-max (Play Money) Seat #2 is the button
Seat 1: s70n3fac3 (15601 in chips) 
Seat 2: FDIBA2009 (14975 in chips) 
FDIBA2009: posts small blind 50
s70n3fac3: posts big blind 100
*** HOLE CARDS ***
FDIBA2009: raises 200 to 300
s70n3fac3: calls 200
*** FLOP *** [9h As 4s]
s70n3fac3: checks 
FDIBA2009: checks 
*** TURN *** [9h As 4s] [Qh]
s70n3fac3: bets 200
FDIBA2009: folds 
Uncalled bet (200) returned to s70n3fac3
s70n3fac3 collected 567 from pot
s70n3fac3: doesn't show hand 
*** SUMMARY ***
Total pot 600 | Rake 33 
Board [9h As 4s Qh]
Seat 1: s70n3fac3 (big blind) collected (567)
Seat 2: FDIBA2009 (button) (small blind) folded on the Turn



PokerStars Home Game Hand #225972652834: {Club #4781089}  Hold'em No Limit (50/100) - 2021/04/18 23:19:01 EET [2021/04/18 16:19:01 ET]
Table 'Session 3' 2-max (Play Money) Seat #1 is the button
Seat 1: s70n3fac3 (15868 in chips) 
Seat 2: FDIBA2009 (14675 in chips) 
s70n3fac3: posts small blind 50
FDIBA2009: posts big blind 100
*** HOLE CARDS ***
s70n3fac3: folds 
Uncalled bet (50) returned to FDIBA2009
FDIBA2009 collected 100 from pot
*** SUMMARY ***
Total pot 100 | Rake 0 
Seat 1: s70n3fac3 (button) (small blind) folded before Flop
Seat 2: FDIBA2009 (big blind) collected (100)



PokerStars Home Game Hand #225972656058: {Club #4781089}  Hold'em No Limit (50/100) - 2021/04/18 23:19:05 EET [2021/04/18 16:19:05 ET]
Table 'Session 3' 2-max (Play Money) Seat #2 is the button
Seat 1: s70n3fac3 (15818 in chips) 
Seat 2: FDIBA2009 (14725 in chips) 
FDIBA2009: posts small blind 50
s70n3fac3: posts big blind 100
*** HOLE CARDS ***
FDIBA2009: raises 200 to 300
s70n3fac3: folds 
Uncalled bet (200) returned to FDIBA2009
FDIBA2009 collected 200 from pot
*** SUMMARY ***
Total pot 200 | Rake 0 
Seat 1: s70n3fac3 (big blind) folded before Flop
Seat 2: FDIBA2009 (button) (small blind) collected (200)



PokerStars Home Game Hand #225972662035: {Club #4781089}  Hold'em No Limit (50/100) - 2021/04/18 23:19:12 EET [2021/04/18 16:19:12 ET]
Table 'Session 3' 2-max (Play Money) Seat #1 is the button
Seat 1: s70n3fac3 (15718 in chips) 
Seat 2: FDIBA2009 (14825 in chips) 
s70n3fac3: posts small blind 50
FDIBA2009: posts big blind 100
*** HOLE CARDS ***
s70n3fac3: raises 100 to 200
FDIBA2009: calls 100
*** FLOP *** [6d Jh 4c]
FDIBA2009: checks 
s70n3fac3: bets 200
FDIBA2009: folds 
Uncalled bet (200) returned to s70n3fac3
s70n3fac3 collected 378 from pot
s70n3fac3: doesn't show hand 
*** SUMMARY ***
Total pot 400 | Rake 22 
Board [6d Jh 4c]
Seat 1: s70n3fac3 (button) (small blind) collected (378)
Seat 2: FDIBA2009 (big blind) folded on the Flop



PokerStars Home Game Hand #225972670809: {Club #4781089}  Hold'em No Limit (50/100) - 2021/04/18 23:19:24 EET [2021/04/18 16:19:24 ET]
Table 'Session 3' 2-max (Play Money) Seat #2 is the button
Seat 1: s70n3fac3 (15896 in chips) 
Seat 2: FDIBA2009 (14625 in chips) 
FDIBA2009: posts small blind 50
s70n3fac3: posts big blind 100
*** HOLE CARDS ***
FDIBA2009: raises 200 to 300
s70n3fac3: calls 200
*** FLOP *** [5s Jd 3s]
s70n3fac3: checks 
FDIBA2009: bets 567
s70n3fac3: folds 
Uncalled bet (567) returned to FDIBA2009
FDIBA2009 collected 567 from pot
*** SUMMARY ***
Total pot 600 | Rake 33 
Board [5s Jd 3s]
Seat 1: s70n3fac3 (big blind) folded on the Flop
Seat 2: FDIBA2009 (button) (small blind) collected (567)



PokerStars Home Game Hand #225972681052: {Club #4781089}  Hold'em No Limit (50/100) - 2021/04/18 23:19:37 EET [2021/04/18 16:19:37 ET]
Table 'Session 3' 2-max (Play Money) Seat #1 is the button
Seat 1: s70n3fac3 (15596 in chips) 
Seat 2: FDIBA2009 (14892 in chips) 
s70n3fac3: posts small blind 50
FDIBA2009: posts big blind 100
*** HOLE CARDS ***
s70n3fac3: folds 
Uncalled bet (50) returned to FDIBA2009
FDIBA2009 collected 100 from pot
*** SUMMARY ***
Total pot 100 | Rake 0 
Seat 1: s70n3fac3 (button) (small blind) folded before Flop
Seat 2: FDIBA2009 (big blind) collected (100)



PokerStars Home Game Hand #225972685406: {Club #4781089}  Hold'em No Limit (50/100) - 2021/04/18 23:19:43 EET [2021/04/18 16:19:43 ET]
Table 'Session 3' 2-max (Play Money) Seat #2 is the button
Seat 1: s70n3fac3 (15546 in chips) 
Seat 2: FDIBA2009 (14942 in chips) 
FDIBA2009: posts small blind 50
s70n3fac3: posts big blind 100
*** HOLE CARDS ***
FDIBA2009: raises 200 to 300
s70n3fac3: folds 
Uncalled bet (200) returned to FDIBA2009
FDIBA2009 collected 200 from pot
*** SUMMARY ***
Total pot 200 | Rake 0 
Seat 1: s70n3fac3 (big blind) folded before Flop
Seat 2: FDIBA2009 (button) (small blind) collected (200)



PokerStars Home Game Hand #225972690642: {Club #4781089}  Hold'em No Limit (50/100) - 2021/04/18 23:19:50 EET [2021/04/18 16:19:50 ET]
Table 'Session 3' 2-max (Play Money) Seat #1 is the button
Seat 1: s70n3fac3 (15446 in chips) 
Seat 2: FDIBA2009 (15042 in chips) 
s70n3fac3: posts small blind 50
FDIBA2009: posts big blind 100
*** HOLE CARDS ***
s70n3fac3: raises 100 to 200
FDIBA2009: calls 100
*** FLOP *** [Jh 9s 3c]
FDIBA2009: checks 
s70n3fac3: bets 200
FDIBA2009: calls 200
*** TURN *** [Jh 9s 3c] [5s]
FDIBA2009: checks 
s70n3fac3: bets 380
FDIBA2009: folds 
Uncalled bet (380) returned to s70n3fac3
s70n3fac3 collected 756 from pot
s70n3fac3: doesn't show hand 
*** SUMMARY ***
Total pot 800 | Rake 44 
Board [Jh 9s 3c 5s]
Seat 1: s70n3fac3 (button) (small blind) collected (756)
Seat 2: FDIBA2009 (big blind) folded on the Turn



PokerStars Home Game Hand #225972704279: {Club #4781089}  Hold'em No Limit (50/100) - 2021/04/18 23:20:07 EET [2021/04/18 16:20:07 ET]
Table 'Session 3' 2-max (Play Money) Seat #2 is the button
Seat 1: s70n3fac3 (15802 in chips) 
Seat 2: FDIBA2009 (14642 in chips) 
FDIBA2009: posts small blind 50
s70n3fac3: posts big blind 100
*** HOLE CARDS ***
FDIBA2009: raises 200 to 300
s70n3fac3: calls 200
*** FLOP *** [Qd 5s Ks]
s70n3fac3: checks 
FDIBA2009: bets 567
s70n3fac3: folds 
Uncalled bet (567) returned to FDIBA2009
FDIBA2009 collected 567 from pot
*** SUMMARY ***
Total pot 600 | Rake 33 
Board [Qd 5s Ks]
Seat 1: s70n3fac3 (big blind) folded on the Flop
Seat 2: FDIBA2009 (button) (small blind) collected (567)



PokerStars Home Game Hand #225972713459: {Club #4781089}  Hold'em No Limit (50/100) - 2021/04/18 23:20:19 EET [2021/04/18 16:20:19 ET]
Table 'Session 3' 2-max (Play Money) Seat #1 is the button
Seat 1: s70n3fac3 (15502 in chips) 
Seat 2: FDIBA2009 (14909 in chips) 
s70n3fac3: posts small blind 50
FDIBA2009: posts big blind 100
*** HOLE CARDS ***
s70n3fac3: folds 
Uncalled bet (50) returned to FDIBA2009
FDIBA2009 collected 100 from pot
*** SUMMARY ***
Total pot 100 | Rake 0 
Seat 1: s70n3fac3 (button) (small blind) folded before Flop
Seat 2: FDIBA2009 (big blind) collected (100)



PokerStars Home Game Hand #225972716375: {Club #4781089}  Hold'em No Limit (50/100) - 2021/04/18 23:20:23 EET [2021/04/18 16:20:23 ET]
Table 'Session 3' 2-max (Play Money) Seat #2 is the button
Seat 1: s70n3fac3 (15452 in chips) 
Seat 2: FDIBA2009 (14959 in chips) 
FDIBA2009: posts small blind 50
s70n3fac3: posts big blind 100
*** HOLE CARDS ***
FDIBA2009: raises 200 to 300
s70n3fac3: calls 200
*** FLOP *** [2h 3d 4c]
s70n3fac3: checks 
FDIBA2009: checks 
*** TURN *** [2h 3d 4c] [3h]
s70n3fac3: checks 
FDIBA2009: checks 
*** RIVER *** [2h 3d 4c 3h] [Js]
s70n3fac3: checks 
FDIBA2009: checks 
*** SHOW DOWN ***
s70n3fac3: shows [5d Kc] (a pair of Threes)
FDIBA2009: shows [Th As] (a pair of Threes - Ace kicker)
FDIBA2009 collected 567 from pot
*** SUMMARY ***
Total pot 600 | Rake 33 
Board [2h 3d 4c 3h Js]
Seat 1: s70n3fac3 (big blind) showed [5d Kc] and lost with a pair of Threes
Seat 2: FDIBA2009 (button) (small blind) showed [Th As] and won (567) with a pair of Threes



PokerStars Home Game Hand #225972731608: {Club #4781089}  Hold'em No Limit (50/100) - 2021/04/18 23:20:43 EET [2021/04/18 16:20:43 ET]
Table 'Session 3' 2-max (Play Money) Seat #1 is the button
Seat 1: s70n3fac3 (15152 in chips) 
Seat 2: FDIBA2009 (15226 in chips) 
s70n3fac3: posts small blind 50
FDIBA2009: posts big blind 100
*** HOLE CARDS ***
s70n3fac3: raises 100 to 200
FDIBA2009: raises 400 to 600
s70n3fac3: calls 400
*** FLOP *** [8d 6d Qc]
FDIBA2009: checks 
s70n3fac3: bets 500
FDIBA2009: calls 500
*** TURN *** [8d 6d Qc] [5s]
FDIBA2009: checks 
s70n3fac3: bets 900
FDIBA2009: calls 900
*** RIVER *** [8d 6d Qc 5s] [Jc]
FDIBA2009: bets 1890
s70n3fac3: folds 
Uncalled bet (1890) returned to FDIBA2009
FDIBA2009 collected 3780 from pot
*** SUMMARY ***
Total pot 4000 | Rake 220 
Board [8d 6d Qc 5s Jc]
Seat 1: s70n3fac3 (button) (small blind) folded on the River
Seat 2: FDIBA2009 (big blind) collected (3780)



PokerStars Home Game Hand #225972763311: {Club #4781089}  Hold'em No Limit (50/100) - 2021/04/18 23:21:24 EET [2021/04/18 16:21:24 ET]
Table 'Session 3' 2-max (Play Money) Seat #2 is the button
Seat 1: s70n3fac3 (13152 in chips) 
Seat 2: FDIBA2009 (17006 in chips) 
FDIBA2009: posts small blind 50
s70n3fac3: posts big blind 100
*** HOLE CARDS ***
FDIBA2009: raises 100 to 200
s70n3fac3: calls 100
*** FLOP *** [8s 9c Ks]
s70n3fac3: checks 
FDIBA2009: checks 
*** TURN *** [8s 9c Ks] [Qc]
s70n3fac3: checks 
FDIBA2009: bets 189
s70n3fac3: calls 189
*** RIVER *** [8s 9c Ks Qc] [2s]
s70n3fac3: checks 
FDIBA2009: bets 367
s70n3fac3: calls 367
*** SHOW DOWN ***
FDIBA2009: shows [7c Qs] (a pair of Queens)
s70n3fac3: mucks hand 
FDIBA2009 collected 1429 from pot
*** SUMMARY ***
Total pot 1512 | Rake 83 
Board [8s 9c Ks Qc 2s]
Seat 1: s70n3fac3 (big blind) mucked [8c 6h]
Seat 2: FDIBA2009 (button) (small blind) showed [7c Qs] and won (1429) with a pair of Queens



PokerStars Home Game Hand #225972784419: {Club #4781089}  Hold'em No Limit (50/100) - 2021/04/18 23:21:52 EET [2021/04/18 16:21:52 ET]
Table 'Session 3' 2-max (Play Money) Seat #1 is the button
Seat 1: s70n3fac3 (12396 in chips) 
Seat 2: FDIBA2009 (17679 in chips) 
s70n3fac3: posts small blind 50
FDIBA2009: posts big blind 100
*** HOLE CARDS ***
s70n3fac3: calls 50
FDIBA2009: checks 
*** FLOP *** [5c Jc Qs]
FDIBA2009: checks 
s70n3fac3: checks 
*** TURN *** [5c Jc Qs] [9s]
FDIBA2009: checks 
s70n3fac3: bets 200
FDIBA2009: folds 
Uncalled bet (200) returned to s70n3fac3
s70n3fac3 collected 189 from pot
s70n3fac3: doesn't show hand 
*** SUMMARY ***
Total pot 200 | Rake 11 
Board [5c Jc Qs 9s]
Seat 1: s70n3fac3 (button) (small blind) collected (189)
Seat 2: FDIBA2009 (big blind) folded on the Turn



PokerStars Home Game Hand #225972795361: {Club #4781089}  Hold'em No Limit (50/100) - 2021/04/18 23:22:06 EET [2021/04/18 16:22:06 ET]
Table 'Session 3' 2-max (Play Money) Seat #2 is the button
Seat 1: s70n3fac3 (12485 in chips) 
Seat 2: FDIBA2009 (17579 in chips) 
FDIBA2009: posts small blind 50
s70n3fac3: posts big blind 100
*** HOLE CARDS ***
FDIBA2009: raises 100 to 200
s70n3fac3: folds 
Uncalled bet (100) returned to FDIBA2009
FDIBA2009 collected 200 from pot
*** SUMMARY ***
Total pot 200 | Rake 0 
Seat 1: s70n3fac3 (big blind) folded before Flop
Seat 2: FDIBA2009 (button) (small blind) collected (200)



PokerStars Home Game Hand #225972799255: {Club #4781089}  Hold'em No Limit (50/100) - 2021/04/18 23:22:11 EET [2021/04/18 16:22:11 ET]
Table 'Session 3' 2-max (Play Money) Seat #1 is the button
Seat 1: s70n3fac3 (12385 in chips) 
Seat 2: FDIBA2009 (17679 in chips) 
s70n3fac3: posts small blind 50
FDIBA2009: posts big blind 100
*** HOLE CARDS ***
s70n3fac3: folds 
Uncalled bet (50) returned to FDIBA2009
FDIBA2009 collected 100 from pot
*** SUMMARY ***
Total pot 100 | Rake 0 
Seat 1: s70n3fac3 (button) (small blind) folded before Flop
Seat 2: FDIBA2009 (big blind) collected (100)



PokerStars Home Game Hand #225972802662: {Club #4781089}  Hold'em No Limit (50/100) - 2021/04/18 23:22:15 EET [2021/04/18 16:22:15 ET]
Table 'Session 3' 2-max (Play Money) Seat #2 is the button
Seat 1: s70n3fac3 (12335 in chips) 
Seat 2: FDIBA2009 (17729 in chips) 
FDIBA2009: posts small blind 50
s70n3fac3: posts big blind 100
*** HOLE CARDS ***
FDIBA2009: raises 100 to 200
s70n3fac3: calls 100
*** FLOP *** [Qd 7h 3c]
s70n3fac3: checks 
FDIBA2009: bets 189
s70n3fac3: folds 
Uncalled bet (189) returned to FDIBA2009
FDIBA2009 collected 378 from pot
*** SUMMARY ***
Total pot 400 | Rake 22 
Board [Qd 7h 3c]
Seat 1: s70n3fac3 (big blind) folded on the Flop
Seat 2: FDIBA2009 (button) (small blind) collected (378)



PokerStars Home Game Hand #225972811040: {Club #4781089}  Hold'em No Limit (50/100) - 2021/04/18 23:22:26 EET [2021/04/18 16:22:26 ET]
Table 'Session 3' 2-max (Play Money) Seat #1 is the button
Seat 1: s70n3fac3 (12135 in chips) 
Seat 2: FDIBA2009 (17907 in chips) 
s70n3fac3: posts small blind 50
FDIBA2009: posts big blind 100
*** HOLE CARDS ***
s70n3fac3: calls 50
FDIBA2009: raises 200 to 300
s70n3fac3: calls 200
*** FLOP *** [Ad Qd 6c]
FDIBA2009: checks 
s70n3fac3: checks 
*** TURN *** [Ad Qd 6c] [Tc]
FDIBA2009: bets 283
s70n3fac3: calls 283
*** RIVER *** [Ad Qd 6c Tc] [2d]
FDIBA2009: checks 
s70n3fac3: bets 1200
FDIBA2009: calls 1200
*** SHOW DOWN ***
s70n3fac3: shows [7s 9d] (high card Ace)
FDIBA2009: shows [Kc Ks] (a pair of Kings)
FDIBA2009 collected 3370 from pot
*** SUMMARY ***
Total pot 3566 | Rake 196 
Board [Ad Qd 6c Tc 2d]
Seat 1: s70n3fac3 (button) (small blind) showed [7s 9d] and lost with high card Ace
Seat 2: FDIBA2009 (big blind) showed [Kc Ks] and won (3370) with a pair of Kings



PokerStars Home Game Hand #225972829610: {Club #4781089}  Hold'em No Limit (50/100) - 2021/04/18 23:22:50 EET [2021/04/18 16:22:50 ET]
Table 'Session 3' 2-max (Play Money) Seat #2 is the button
Seat 1: s70n3fac3 (10352 in chips) 
Seat 2: FDIBA2009 (19494 in chips) 
FDIBA2009: posts small blind 50
s70n3fac3: posts big blind 100
*** HOLE CARDS ***
FDIBA2009: raises 100 to 200
s70n3fac3: calls 100
*** FLOP *** [Tc 3s 5h]
s70n3fac3: checks 
FDIBA2009: checks 
*** TURN *** [Tc 3s 5h] [Jd]
s70n3fac3: checks 
FDIBA2009: bets 189
s70n3fac3: calls 189
*** RIVER *** [Tc 3s 5h Jd] [8d]
s70n3fac3: checks 
FDIBA2009: checks 
*** SHOW DOWN ***
s70n3fac3: shows [8c 9s] (a pair of Eights)
FDIBA2009: shows [9c 8s] (a pair of Eights)
s70n3fac3 collected 368 from pot
FDIBA2009 collected 367 from pot
*** SUMMARY ***
Total pot 778 | Rake 43 
Board [Tc 3s 5h Jd 8d]
Seat 1: s70n3fac3 (big blind) showed [8c 9s] and won (368) with a pair of Eights
Seat 2: FDIBA2009 (button) (small blind) showed [9c 8s] and won (367) with a pair of Eights



PokerStars Home Game Hand #225972844592: {Club #4781089}  Hold'em No Limit (50/100) - 2021/04/18 23:23:10 EET [2021/04/18 16:23:10 ET]
Table 'Session 3' 2-max (Play Money) Seat #1 is the button
Seat 1: s70n3fac3 (10331 in chips) 
Seat 2: FDIBA2009 (19472 in chips) 
s70n3fac3: posts small blind 50
FDIBA2009: posts big blind 100
*** HOLE CARDS ***
s70n3fac3: folds 
Uncalled bet (50) returned to FDIBA2009
FDIBA2009 collected 100 from pot
*** SUMMARY ***
Total pot 100 | Rake 0 
Seat 1: s70n3fac3 (button) (small blind) folded before Flop
Seat 2: FDIBA2009 (big blind) collected (100)



PokerStars Home Game Hand #225972847597: {Club #4781089}  Hold'em No Limit (50/100) - 2021/04/18 23:23:14 EET [2021/04/18 16:23:14 ET]
Table 'Session 3' 2-max (Play Money) Seat #2 is the button
Seat 1: s70n3fac3 (10281 in chips) 
Seat 2: FDIBA2009 (19522 in chips) 
FDIBA2009: posts small blind 50
s70n3fac3: posts big blind 100
*** HOLE CARDS ***
FDIBA2009: raises 100 to 200
s70n3fac3: calls 100
*** FLOP *** [4h As 2s]
s70n3fac3: checks 
FDIBA2009: bets 378
s70n3fac3: calls 378
*** TURN *** [4h As 2s] [8d]
s70n3fac3: checks 
FDIBA2009: checks 
*** RIVER *** [4h As 2s 8d] [Jh]
s70n3fac3: checks 
FDIBA2009: checks 
*** SHOW DOWN ***
s70n3fac3: shows [4c Qc] (a pair of Fours)
FDIBA2009: shows [5s 5d] (a pair of Fives)
FDIBA2009 collected 1092 from pot
*** SUMMARY ***
Total pot 1156 | Rake 64 
Board [4h As 2s 8d Jh]
Seat 1: s70n3fac3 (big blind) showed [4c Qc] and lost with a pair of Fours
Seat 2: FDIBA2009 (button) (small blind) showed [5s 5d] and won (1092) with a pair of Fives



PokerStars Home Game Hand #225972861209: {Club #4781089}  Hold'em No Limit (50/100) - 2021/04/18 23:23:32 EET [2021/04/18 16:23:32 ET]
Table 'Session 3' 2-max (Play Money) Seat #1 is the button
Seat 1: s70n3fac3 (9703 in chips) 
Seat 2: FDIBA2009 (20036 in chips) 
s70n3fac3: posts small blind 50
FDIBA2009: posts big blind 100
*** HOLE CARDS ***
s70n3fac3: calls 50
FDIBA2009: raises 100 to 200
s70n3fac3: calls 100
*** FLOP *** [Qh 7d 5h]
FDIBA2009: bets 189
s70n3fac3: raises 211 to 400
FDIBA2009: calls 211
*** TURN *** [Qh 7d 5h] [Tc]
FDIBA2009: checks 
s70n3fac3: bets 650
FDIBA2009: calls 650
*** RIVER *** [Qh 7d 5h Tc] [6c]
FDIBA2009: checks 
s70n3fac3: bets 1600
FDIBA2009 has timed out
FDIBA2009: folds 
Uncalled bet (1600) returned to s70n3fac3
s70n3fac3 collected 2362 from pot
s70n3fac3: doesn't show hand 
*** SUMMARY ***
Total pot 2500 | Rake 138 
Board [Qh 7d 5h Tc 6c]
Seat 1: s70n3fac3 (button) (small blind) collected (2362)
Seat 2: FDIBA2009 (big blind) folded on the River



PokerStars Home Game Hand #225972907890: {Club #4781089}  Hold'em No Limit (50/100) - 2021/04/18 23:24:33 EET [2021/04/18 16:24:33 ET]
Table 'Session 3' 2-max (Play Money) Seat #2 is the button
Seat 1: s70n3fac3 (10815 in chips) 
Seat 2: FDIBA2009 (18786 in chips) 
FDIBA2009: posts small blind 50
s70n3fac3: posts big blind 100
*** HOLE CARDS ***
FDIBA2009: raises 100 to 200
s70n3fac3: calls 100
*** FLOP *** [Qc 3h 2c]
s70n3fac3: checks 
FDIBA2009: checks 
*** TURN *** [Qc 3h 2c] [Th]
s70n3fac3: checks 
FDIBA2009: checks 
*** RIVER *** [Qc 3h 2c Th] [As]
s70n3fac3: checks 
FDIBA2009: bets 378
s70n3fac3: calls 378
*** SHOW DOWN ***
FDIBA2009: shows [7h 9c] (high card Ace)
s70n3fac3: shows [Kh 7d] (high card Ace - King kicker)
s70n3fac3 collected 1092 from pot
*** SUMMARY ***
Total pot 1156 | Rake 64 
Board [Qc 3h 2c Th As]
Seat 1: s70n3fac3 (big blind) showed [Kh 7d] and won (1092) with high card Ace
Seat 2: FDIBA2009 (button) (small blind) showed [7h 9c] and lost with high card Ace



PokerStars Home Game Hand #225972922031: {Club #4781089}  Hold'em No Limit (50/100) - 2021/04/18 23:24:51 EET [2021/04/18 16:24:51 ET]
Table 'Session 3' 2-max (Play Money) Seat #1 is the button
Seat 1: s70n3fac3 (11329 in chips) 
Seat 2: FDIBA2009 (18208 in chips) 
s70n3fac3: posts small blind 50
FDIBA2009: posts big blind 100
*** HOLE CARDS ***
s70n3fac3: folds 
Uncalled bet (50) returned to FDIBA2009
FDIBA2009 collected 100 from pot
*** SUMMARY ***
Total pot 100 | Rake 0 
Seat 1: s70n3fac3 (button) (small blind) folded before Flop
Seat 2: FDIBA2009 (big blind) collected (100)



PokerStars Home Game Hand #225972925047: {Club #4781089}  Hold'em No Limit (50/100) - 2021/04/18 23:24:55 EET [2021/04/18 16:24:55 ET]
Table 'Session 3' 2-max (Play Money) Seat #2 is the button
Seat 1: s70n3fac3 (11279 in chips) 
Seat 2: FDIBA2009 (18258 in chips) 
FDIBA2009: posts small blind 50
s70n3fac3: posts big blind 100
*** HOLE CARDS ***
FDIBA2009: raises 100 to 200
s70n3fac3: folds 
Uncalled bet (100) returned to FDIBA2009
FDIBA2009 collected 200 from pot
*** SUMMARY ***
Total pot 200 | Rake 0 
Seat 1: s70n3fac3 (big blind) folded before Flop
Seat 2: FDIBA2009 (button) (small blind) collected (200)



PokerStars Home Game Hand #225972929111: {Club #4781089}  Hold'em No Limit (50/100) - 2021/04/18 23:25:01 EET [2021/04/18 16:25:01 ET]
Table 'Session 3' 2-max (Play Money) Seat #1 is the button
Seat 1: s70n3fac3 (11179 in chips) 
Seat 2: FDIBA2009 (18358 in chips) 
s70n3fac3: posts small blind 50
FDIBA2009: posts big blind 100
*** HOLE CARDS ***
s70n3fac3: folds 
Uncalled bet (50) returned to FDIBA2009
FDIBA2009 collected 100 from pot
*** SUMMARY ***
Total pot 100 | Rake 0 
Seat 1: s70n3fac3 (button) (small blind) folded before Flop
Seat 2: FDIBA2009 (big blind) collected (100)



PokerStars Home Game Hand #225972932222: {Club #4781089}  Hold'em No Limit (50/100) - 2021/04/18 23:25:05 EET [2021/04/18 16:25:05 ET]
Table 'Session 3' 2-max (Play Money) Seat #2 is the button
Seat 1: s70n3fac3 (11129 in chips) 
Seat 2: FDIBA2009 (18408 in chips) 
FDIBA2009: posts small blind 50
s70n3fac3: posts big blind 100
*** HOLE CARDS ***
FDIBA2009: raises 100 to 200
s70n3fac3: folds 
Uncalled bet (100) returned to FDIBA2009
FDIBA2009 collected 200 from pot
*** SUMMARY ***
Total pot 200 | Rake 0 
Seat 1: s70n3fac3 (big blind) folded before Flop
Seat 2: FDIBA2009 (button) (small blind) collected (200)



PokerStars Home Game Hand #225972936540: {Club #4781089}  Hold'em No Limit (50/100) - 2021/04/18 23:25:11 EET [2021/04/18 16:25:11 ET]
Table 'Session 3' 2-max (Play Money) Seat #1 is the button
Seat 1: s70n3fac3 (11029 in chips) 
Seat 2: FDIBA2009 (18508 in chips) 
s70n3fac3: posts small blind 50
FDIBA2009: posts big blind 100
*** HOLE CARDS ***
s70n3fac3: folds 
Uncalled bet (50) returned to FDIBA2009
FDIBA2009 collected 100 from pot
*** SUMMARY ***
Total pot 100 | Rake 0 
Seat 1: s70n3fac3 (button) (small blind) folded before Flop
Seat 2: FDIBA2009 (big blind) collected (100)



PokerStars Home Game Hand #225972939717: {Club #4781089}  Hold'em No Limit (50/100) - 2021/04/18 23:25:15 EET [2021/04/18 16:25:15 ET]
Table 'Session 3' 2-max (Play Money) Seat #2 is the button
Seat 1: s70n3fac3 (10979 in chips) 
Seat 2: FDIBA2009 (18558 in chips) 
FDIBA2009: posts small blind 50
s70n3fac3: posts big blind 100
*** HOLE CARDS ***
FDIBA2009: raises 200 to 300
s70n3fac3: calls 200
*** FLOP *** [Kc 9d 8d]
s70n3fac3: checks 
FDIBA2009: checks 
*** TURN *** [Kc 9d 8d] [Jc]
s70n3fac3: checks 
FDIBA2009: bets 283
s70n3fac3: folds 
Uncalled bet (283) returned to FDIBA2009
FDIBA2009 collected 567 from pot
*** SUMMARY ***
Total pot 600 | Rake 33 
Board [Kc 9d 8d Jc]
Seat 1: s70n3fac3 (big blind) folded on the Turn
Seat 2: FDIBA2009 (button) (small blind) collected (567)



PokerStars Home Game Hand #225972949157: {Club #4781089}  Hold'em No Limit (50/100) - 2021/04/18 23:25:27 EET [2021/04/18 16:25:27 ET]
Table 'Session 3' 2-max (Play Money) Seat #1 is the button
Seat 1: s70n3fac3 (10679 in chips) 
Seat 2: FDIBA2009 (18825 in chips) 
s70n3fac3: posts small blind 50
FDIBA2009: posts big blind 100
*** HOLE CARDS ***
s70n3fac3: raises 100 to 200
FDIBA2009: calls 100
*** FLOP *** [6h 5s 5c]
FDIBA2009: checks 
s70n3fac3: bets 200
FDIBA2009: calls 200
*** TURN *** [6h 5s 5c] [Tc]
FDIBA2009: checks 
s70n3fac3: bets 400
FDIBA2009: folds 
Uncalled bet (400) returned to s70n3fac3
s70n3fac3 collected 756 from pot
s70n3fac3: doesn't show hand 
*** SUMMARY ***
Total pot 800 | Rake 44 
Board [6h 5s 5c Tc]
Seat 1: s70n3fac3 (button) (small blind) collected (756)
Seat 2: FDIBA2009 (big blind) folded on the Turn



PokerStars Home Game Hand #225972961621: {Club #4781089}  Hold'em No Limit (50/100) - 2021/04/18 23:25:44 EET [2021/04/18 16:25:44 ET]
Table 'Session 3' 2-max (Play Money) Seat #2 is the button
Seat 1: s70n3fac3 (11035 in chips) 
Seat 2: FDIBA2009 (18425 in chips) 
FDIBA2009: posts small blind 50
s70n3fac3: posts big blind 100
*** HOLE CARDS ***
FDIBA2009: raises 100 to 200
s70n3fac3: calls 100
*** FLOP *** [Jc 6d 4h]
s70n3fac3: checks 
FDIBA2009: checks 
*** TURN *** [Jc 6d 4h] [8d]
s70n3fac3: bets 200
FDIBA2009: folds 
Uncalled bet (200) returned to s70n3fac3
s70n3fac3 collected 378 from pot
s70n3fac3: doesn't show hand 
*** SUMMARY ***
Total pot 400 | Rake 22 
Board [Jc 6d 4h 8d]
Seat 1: s70n3fac3 (big blind) collected (378)
Seat 2: FDIBA2009 (button) (small blind) folded on the Turn



PokerStars Home Game Hand #225972970861: {Club #4781089}  Hold'em No Limit (50/100) - 2021/04/18 23:25:56 EET [2021/04/18 16:25:56 ET]
Table 'Session 3' 2-max (Play Money) Seat #1 is the button
Seat 1: s70n3fac3 (11213 in chips) 
Seat 2: FDIBA2009 (18225 in chips) 
s70n3fac3: posts small blind 50
FDIBA2009: posts big blind 100
*** HOLE CARDS ***
s70n3fac3: folds 
Uncalled bet (50) returned to FDIBA2009
FDIBA2009 collected 100 from pot
*** SUMMARY ***
Total pot 100 | Rake 0 
Seat 1: s70n3fac3 (button) (small blind) folded before Flop
Seat 2: FDIBA2009 (big blind) collected (100)



PokerStars Home Game Hand #225972974045: {Club #4781089}  Hold'em No Limit (50/100) - 2021/04/18 23:26:01 EET [2021/04/18 16:26:01 ET]
Table 'Session 3' 2-max (Play Money) Seat #2 is the button
Seat 1: s70n3fac3 (11163 in chips) 
Seat 2: FDIBA2009 (18275 in chips) 
FDIBA2009: posts small blind 50
s70n3fac3: posts big blind 100
*** HOLE CARDS ***
FDIBA2009: raises 100 to 200
s70n3fac3: calls 100
*** FLOP *** [Jc Jh Ac]
s70n3fac3: checks 
FDIBA2009: bets 189
s70n3fac3: calls 189
*** TURN *** [Jc Jh Ac] [4d]
s70n3fac3: checks 
FDIBA2009: checks 
*** RIVER *** [Jc Jh Ac 4d] [5h]
s70n3fac3: checks 
FDIBA2009: checks 
*** SHOW DOWN ***
s70n3fac3: shows [6c Tc] (a pair of Jacks)
FDIBA2009: mucks hand 
s70n3fac3 collected 735 from pot
*** SUMMARY ***
Total pot 778 | Rake 43 
Board [Jc Jh Ac 4d 5h]
Seat 1: s70n3fac3 (big blind) showed [6c Tc] and won (735) with a pair of Jacks
Seat 2: FDIBA2009 (button) (small blind) mucked [7h 9c]



PokerStars Home Game Hand #225972988966: {Club #4781089}  Hold'em No Limit (50/100) - 2021/04/18 23:26:20 EET [2021/04/18 16:26:20 ET]
Table 'Session 3' 2-max (Play Money) Seat #1 is the button
Seat 1: s70n3fac3 (11509 in chips) 
Seat 2: FDIBA2009 (17886 in chips) 
s70n3fac3: posts small blind 50
FDIBA2009: posts big blind 100
*** HOLE CARDS ***
s70n3fac3: calls 50
FDIBA2009: raises 200 to 300
s70n3fac3: folds 
Uncalled bet (200) returned to FDIBA2009
FDIBA2009 collected 200 from pot
*** SUMMARY ***
Total pot 200 | Rake 0 
Seat 1: s70n3fac3 (button) (small blind) folded before Flop
Seat 2: FDIBA2009 (big blind) collected (200)



PokerStars Home Game Hand #225972994508: {Club #4781089}  Hold'em No Limit (50/100) - 2021/04/18 23:26:27 EET [2021/04/18 16:26:27 ET]
Table 'Session 3' 2-max (Play Money) Seat #2 is the button
Seat 1: s70n3fac3 (11409 in chips) 
Seat 2: FDIBA2009 (17986 in chips) 
FDIBA2009: posts small blind 50
s70n3fac3: posts big blind 100
*** HOLE CARDS ***
FDIBA2009: raises 200 to 300
s70n3fac3: raises 400 to 700
FDIBA2009: calls 400
*** FLOP *** [Qc As 6h]
s70n3fac3: checks 
FDIBA2009: checks 
*** TURN *** [Qc As 6h] [4h]
s70n3fac3: checks 
FDIBA2009: bets 661
s70n3fac3: calls 661
*** RIVER *** [Qc As 6h 4h] [Ks]
s70n3fac3: bets 2600
FDIBA2009: folds 
Uncalled bet (2600) returned to s70n3fac3
s70n3fac3 collected 2572 from pot
s70n3fac3: doesn't show hand 
*** SUMMARY ***
Total pot 2722 | Rake 150 
Board [Qc As 6h 4h Ks]
Seat 1: s70n3fac3 (big blind) collected (2572)
Seat 2: FDIBA2009 (button) (small blind) folded on the River



PokerStars Home Game Hand #225973020419: {Club #4781089}  Hold'em No Limit (50/100) - 2021/04/18 23:27:02 EET [2021/04/18 16:27:02 ET]
Table 'Session 3' 2-max (Play Money) Seat #1 is the button
Seat 1: s70n3fac3 (12620 in chips) 
Seat 2: FDIBA2009 (16625 in chips) 
s70n3fac3: posts small blind 50
FDIBA2009: posts big blind 100
*** HOLE CARDS ***
s70n3fac3: raises 100 to 200
FDIBA2009: raises 400 to 600
s70n3fac3: folds 
Uncalled bet (400) returned to FDIBA2009
FDIBA2009 collected 400 from pot
*** SUMMARY ***
Total pot 400 | Rake 0 
Seat 1: s70n3fac3 (button) (small blind) folded before Flop
Seat 2: FDIBA2009 (big blind) collected (400)



PokerStars Home Game Hand #225973026634: {Club #4781089}  Hold'em No Limit (50/100) - 2021/04/18 23:27:10 EET [2021/04/18 16:27:10 ET]
Table 'Session 3' 2-max (Play Money) Seat #2 is the button
Seat 1: s70n3fac3 (12420 in chips) 
Seat 2: FDIBA2009 (16825 in chips) 
FDIBA2009: posts small blind 50
s70n3fac3: posts big blind 100
*** HOLE CARDS ***
FDIBA2009: raises 200 to 300
s70n3fac3: calls 200
*** FLOP *** [5h Qc Ks]
s70n3fac3: checks 
FDIBA2009: checks 
*** TURN *** [5h Qc Ks] [3h]
s70n3fac3: checks 
FDIBA2009: bets 283
s70n3fac3: calls 283
*** RIVER *** [5h Qc Ks 3h] [6s]
s70n3fac3: checks 
FDIBA2009: checks 
*** SHOW DOWN ***
s70n3fac3: shows [3c Ac] (a pair of Threes)
FDIBA2009: shows [5d Ah] (a pair of Fives)
FDIBA2009 collected 1102 from pot
*** SUMMARY ***
Total pot 1166 | Rake 64 
Board [5h Qc Ks 3h 6s]
Seat 1: s70n3fac3 (big blind) showed [3c Ac] and lost with a pair of Threes
Seat 2: FDIBA2009 (button) (small blind) showed [5d Ah] and won (1102) with a pair of Fives



PokerStars Home Game Hand #225973041199: {Club #4781089}  Hold'em No Limit (50/100) - 2021/04/18 23:27:29 EET [2021/04/18 16:27:29 ET]
Table 'Session 3' 2-max (Play Money) Seat #1 is the button
Seat 1: s70n3fac3 (11837 in chips) 
Seat 2: FDIBA2009 (17344 in chips) 
s70n3fac3: posts small blind 50
FDIBA2009: posts big blind 100
*** HOLE CARDS ***
s70n3fac3: folds 
Uncalled bet (50) returned to FDIBA2009
FDIBA2009 collected 100 from pot
*** SUMMARY ***
Total pot 100 | Rake 0 
Seat 1: s70n3fac3 (button) (small blind) folded before Flop
Seat 2: FDIBA2009 (big blind) collected (100)



PokerStars Home Game Hand #225973044152: {Club #4781089}  Hold'em No Limit (50/100) - 2021/04/18 23:27:33 EET [2021/04/18 16:27:33 ET]
Table 'Session 3' 2-max (Play Money) Seat #2 is the button
Seat 1: s70n3fac3 (11787 in chips) 
Seat 2: FDIBA2009 (17394 in chips) 
FDIBA2009: posts small blind 50
s70n3fac3: posts big blind 100
*** HOLE CARDS ***
FDIBA2009: raises 200 to 300
s70n3fac3: folds 
Uncalled bet (200) returned to FDIBA2009
FDIBA2009 collected 200 from pot
*** SUMMARY ***
Total pot 200 | Rake 0 
Seat 1: s70n3fac3 (big blind) folded before Flop
Seat 2: FDIBA2009 (button) (small blind) collected (200)



PokerStars Home Game Hand #225973053805: {Club #4781089}  Hold'em No Limit (50/100) - 2021/04/18 23:27:39 EET [2021/04/18 16:27:39 ET]
Table 'Session 3' 2-max (Play Money) Seat #1 is the button
Seat 1: s70n3fac3 (11687 in chips) 
Seat 2: FDIBA2009 (17494 in chips) 
s70n3fac3: posts small blind 50
FDIBA2009: posts big blind 100
*** HOLE CARDS ***
s70n3fac3: raises 100 to 200
FDIBA2009: raises 400 to 600
s70n3fac3: raises 800 to 1400
FDIBA2009: folds 
Uncalled bet (800) returned to s70n3fac3
s70n3fac3 collected 1200 from pot
s70n3fac3: doesn't show hand 
*** SUMMARY ***
Total pot 1200 | Rake 0 
Seat 1: s70n3fac3 (button) (small blind) collected (1200)
Seat 2: FDIBA2009 (big blind) folded before Flop



PokerStars Home Game Hand #225973062646: {Club #4781089}  Hold'em No Limit (50/100) - 2021/04/18 23:27:51 EET [2021/04/18 16:27:51 ET]
Table 'Session 3' 2-max (Play Money) Seat #2 is the button
Seat 1: s70n3fac3 (12287 in chips) 
Seat 2: FDIBA2009 (16894 in chips) 
FDIBA2009: posts small blind 50
s70n3fac3: posts big blind 100
*** HOLE CARDS ***
FDIBA2009: raises 200 to 300
s70n3fac3: folds 
Uncalled bet (200) returned to FDIBA2009
FDIBA2009 collected 200 from pot
*** SUMMARY ***
Total pot 200 | Rake 0 
Seat 1: s70n3fac3 (big blind) folded before Flop
Seat 2: FDIBA2009 (button) (small blind) collected (200)



PokerStars Home Game Hand #225973068001: {Club #4781089}  Hold'em No Limit (50/100) - 2021/04/18 23:27:58 EET [2021/04/18 16:27:58 ET]
Table 'Session 3' 2-max (Play Money) Seat #1 is the button
Seat 1: s70n3fac3 (12187 in chips) 
Seat 2: FDIBA2009 (16994 in chips) 
s70n3fac3: posts small blind 50
FDIBA2009: posts big blind 100
*** HOLE CARDS ***
s70n3fac3: folds 
Uncalled bet (50) returned to FDIBA2009
FDIBA2009 collected 100 from pot
*** SUMMARY ***
Total pot 100 | Rake 0 
Seat 1: s70n3fac3 (button) (small blind) folded before Flop
Seat 2: FDIBA2009 (big blind) collected (100)



PokerStars Home Game Hand #225973070941: {Club #4781089}  Hold'em No Limit (50/100) - 2021/04/18 23:28:02 EET [2021/04/18 16:28:02 ET]
Table 'Session 3' 2-max (Play Money) Seat #2 is the button
Seat 1: s70n3fac3 (12137 in chips) 
Seat 2: FDIBA2009 (17044 in chips) 
FDIBA2009: posts small blind 50
s70n3fac3: posts big blind 100
*** HOLE CARDS ***
FDIBA2009: raises 200 to 300
s70n3fac3: folds 
Uncalled bet (200) returned to FDIBA2009
FDIBA2009 collected 200 from pot
*** SUMMARY ***
Total pot 200 | Rake 0 
Seat 1: s70n3fac3 (big blind) folded before Flop
Seat 2: FDIBA2009 (button) (small blind) collected (200)



PokerStars Home Game Hand #225973075749: {Club #4781089}  Hold'em No Limit (50/100) - 2021/04/18 23:28:08 EET [2021/04/18 16:28:08 ET]
Table 'Session 3' 2-max (Play Money) Seat #1 is the button
Seat 1: s70n3fac3 (12037 in chips) 
Seat 2: FDIBA2009 (17144 in chips) 
s70n3fac3: posts small blind 50
FDIBA2009: posts big blind 100
*** HOLE CARDS ***
s70n3fac3: calls 50
FDIBA2009: checks 
*** FLOP *** [8c 9d Qc]
FDIBA2009: checks 
s70n3fac3: bets 200
FDIBA2009: folds 
Uncalled bet (200) returned to s70n3fac3
s70n3fac3 collected 189 from pot
s70n3fac3: doesn't show hand 
*** SUMMARY ***
Total pot 200 | Rake 11 
Board [8c 9d Qc]
Seat 1: s70n3fac3 (button) (small blind) collected (189)
Seat 2: FDIBA2009 (big blind) folded on the Flop



PokerStars Home Game Hand #225973083149: {Club #4781089}  Hold'em No Limit (50/100) - 2021/04/18 23:28:18 EET [2021/04/18 16:28:18 ET]
Table 'Session 3' 2-max (Play Money) Seat #2 is the button
Seat 1: s70n3fac3 (12126 in chips) 
Seat 2: FDIBA2009 (17044 in chips) 
FDIBA2009: posts small blind 50
s70n3fac3: posts big blind 100
*** HOLE CARDS ***
FDIBA2009: raises 200 to 300
s70n3fac3: folds 
Uncalled bet (200) returned to FDIBA2009
FDIBA2009 collected 200 from pot
*** SUMMARY ***
Total pot 200 | Rake 0 
Seat 1: s70n3fac3 (big blind) folded before Flop
Seat 2: FDIBA2009 (button) (small blind) collected (200)



PokerStars Home Game Hand #225973087328: {Club #4781089}  Hold'em No Limit (50/100) - 2021/04/18 23:28:24 EET [2021/04/18 16:28:24 ET]
Table 'Session 3' 2-max (Play Money) Seat #1 is the button
Seat 1: s70n3fac3 (12026 in chips) 
Seat 2: FDIBA2009 (17144 in chips) 
s70n3fac3: posts small blind 50
FDIBA2009: posts big blind 100
*** HOLE CARDS ***
s70n3fac3: folds 
Uncalled bet (50) returned to FDIBA2009
FDIBA2009 collected 100 from pot
*** SUMMARY ***
Total pot 100 | Rake 0 
Seat 1: s70n3fac3 (button) (small blind) folded before Flop
Seat 2: FDIBA2009 (big blind) collected (100)



PokerStars Home Game Hand #225973090191: {Club #4781089}  Hold'em No Limit (50/100) - 2021/04/18 23:28:28 EET [2021/04/18 16:28:28 ET]
Table 'Session 3' 2-max (Play Money) Seat #2 is the button
Seat 1: s70n3fac3 (11976 in chips) 
Seat 2: FDIBA2009 (17194 in chips) 
FDIBA2009: posts small blind 50
s70n3fac3: posts big blind 100
*** HOLE CARDS ***
FDIBA2009: raises 200 to 300
s70n3fac3: folds 
Uncalled bet (200) returned to FDIBA2009
FDIBA2009 collected 200 from pot
*** SUMMARY ***
Total pot 200 | Rake 0 
Seat 1: s70n3fac3 (big blind) folded before Flop
Seat 2: FDIBA2009 (button) (small blind) collected (200)



PokerStars Home Game Hand #225973094560: {Club #4781089}  Hold'em No Limit (50/100) - 2021/04/18 23:28:33 EET [2021/04/18 16:28:33 ET]
Table 'Session 3' 2-max (Play Money) Seat #1 is the button
Seat 1: s70n3fac3 (11876 in chips) 
Seat 2: FDIBA2009 (17294 in chips) 
s70n3fac3: posts small blind 50
FDIBA2009: posts big blind 100
*** HOLE CARDS ***
s70n3fac3: calls 50
FDIBA2009: checks 
*** FLOP *** [7s 2c Td]
FDIBA2009: checks 
s70n3fac3: bets 200
FDIBA2009: folds 
Uncalled bet (200) returned to s70n3fac3
s70n3fac3 collected 189 from pot
s70n3fac3: doesn't show hand 
*** SUMMARY ***
Total pot 200 | Rake 11 
Board [7s 2c Td]
Seat 1: s70n3fac3 (button) (small blind) collected (189)
Seat 2: FDIBA2009 (big blind) folded on the Flop



PokerStars Home Game Hand #225973101465: {Club #4781089}  Hold'em No Limit (50/100) - 2021/04/18 23:28:43 EET [2021/04/18 16:28:43 ET]
Table 'Session 3' 2-max (Play Money) Seat #2 is the button
Seat 1: s70n3fac3 (11965 in chips) 
Seat 2: FDIBA2009 (17194 in chips) 
FDIBA2009: posts small blind 50
s70n3fac3: posts big blind 100
*** HOLE CARDS ***
FDIBA2009: raises 200 to 300
s70n3fac3: folds 
Uncalled bet (200) returned to FDIBA2009
FDIBA2009 collected 200 from pot
*** SUMMARY ***
Total pot 200 | Rake 0 
Seat 1: s70n3fac3 (big blind) folded before Flop
Seat 2: FDIBA2009 (button) (small blind) collected (200)



PokerStars Home Game Hand #225973105420: {Club #4781089}  Hold'em No Limit (50/100) - 2021/04/18 23:28:48 EET [2021/04/18 16:28:48 ET]
Table 'Session 3' 2-max (Play Money) Seat #1 is the button
Seat 1: s70n3fac3 (11865 in chips) 
Seat 2: FDIBA2009 (17294 in chips) 
s70n3fac3: posts small blind 50
FDIBA2009: posts big blind 100
*** HOLE CARDS ***
s70n3fac3: raises 150 to 250
FDIBA2009: calls 150
*** FLOP *** [5h 3c 2c]
FDIBA2009: checks 
s70n3fac3: checks 
*** TURN *** [5h 3c 2c] [4c]
FDIBA2009: checks 
s70n3fac3: bets 250
FDIBA2009: calls 250
*** RIVER *** [5h 3c 2c 4c] [3d]
FDIBA2009: checks 
s70n3fac3: checks 
*** SHOW DOWN ***
FDIBA2009: shows [Qh 4h] (two pair, Fours and Threes)
s70n3fac3: mucks hand 
FDIBA2009 collected 945 from pot
*** SUMMARY ***
Total pot 1000 | Rake 55 
Board [5h 3c 2c 4c 3d]
Seat 1: s70n3fac3 (button) (small blind) mucked [Td Kh]
Seat 2: FDIBA2009 (big blind) showed [Qh 4h] and won (945) with two pair, Fours and Threes



PokerStars Home Game Hand #225973121672: {Club #4781089}  Hold'em No Limit (50/100) - 2021/04/18 23:29:10 EET [2021/04/18 16:29:10 ET]
Table 'Session 3' 2-max (Play Money) Seat #2 is the button
Seat 1: s70n3fac3 (11365 in chips) 
Seat 2: FDIBA2009 (17739 in chips) 
FDIBA2009: posts small blind 50
s70n3fac3: posts big blind 100
*** HOLE CARDS ***
FDIBA2009: raises 200 to 300
s70n3fac3: calls 200
*** FLOP *** [Ks 7s 2h]
s70n3fac3: checks 
FDIBA2009: bets 283
s70n3fac3: calls 283
*** TURN *** [Ks 7s 2h] [Js]
s70n3fac3: checks 
FDIBA2009: checks 
*** RIVER *** [Ks 7s 2h Js] [3c]
s70n3fac3: bets 551
FDIBA2009: calls 551
*** SHOW DOWN ***
s70n3fac3: shows [2c 2d] (three of a kind, Deuces)
FDIBA2009: mucks hand 
s70n3fac3 collected 2143 from pot
*** SUMMARY ***
Total pot 2268 | Rake 125 
Board [Ks 7s 2h Js 3c]
Seat 1: s70n3fac3 (big blind) showed [2c 2d] and won (2143) with three of a kind, Deuces
Seat 2: FDIBA2009 (button) (small blind) mucked [9c 7h]



PokerStars Home Game Hand #225973140728: {Club #4781089}  Hold'em No Limit (50/100) - 2021/04/18 23:29:35 EET [2021/04/18 16:29:35 ET]
Table 'Session 3' 2-max (Play Money) Seat #1 is the button
Seat 1: s70n3fac3 (12374 in chips) 
Seat 2: FDIBA2009 (16605 in chips) 
s70n3fac3: posts small blind 50
FDIBA2009: posts big blind 100
*** HOLE CARDS ***
s70n3fac3: raises 100 to 200
FDIBA2009: calls 100
*** FLOP *** [Jh 2d Kc]
FDIBA2009: checks 
s70n3fac3: bets 200
FDIBA2009: folds 
Uncalled bet (200) returned to s70n3fac3
s70n3fac3 collected 378 from pot
s70n3fac3: doesn't show hand 
*** SUMMARY ***
Total pot 400 | Rake 22 
Board [Jh 2d Kc]
Seat 1: s70n3fac3 (button) (small blind) collected (378)
Seat 2: FDIBA2009 (big blind) folded on the Flop



PokerStars Home Game Hand #225973148098: {Club #4781089}  Hold'em No Limit (50/100) - 2021/04/18 23:29:45 EET [2021/04/18 16:29:45 ET]
Table 'Session 3' 2-max (Play Money) Seat #2 is the button
Seat 1: s70n3fac3 (12552 in chips) 
Seat 2: FDIBA2009 (16405 in chips) 
FDIBA2009: posts small blind 50
s70n3fac3: posts big blind 100
*** HOLE CARDS ***
FDIBA2009: raises 200 to 300
s70n3fac3: folds 
Uncalled bet (200) returned to FDIBA2009
FDIBA2009 collected 200 from pot
*** SUMMARY ***
Total pot 200 | Rake 0 
Seat 1: s70n3fac3 (big blind) folded before Flop
Seat 2: FDIBA2009 (button) (small blind) collected (200)



PokerStars Home Game Hand #225973152782: {Club #4781089}  Hold'em No Limit (50/100) - 2021/04/18 23:29:51 EET [2021/04/18 16:29:51 ET]
Table 'Session 3' 2-max (Play Money) Seat #1 is the button
Seat 1: s70n3fac3 (12452 in chips) 
Seat 2: FDIBA2009 (16505 in chips) 
s70n3fac3: posts small blind 50
FDIBA2009: posts big blind 100
*** HOLE CARDS ***
s70n3fac3: raises 100 to 200
FDIBA2009: raises 400 to 600
s70n3fac3: raises 700 to 1300
FDIBA2009: calls 700
*** FLOP *** [Qh Ac 6d]
FDIBA2009: checks 
s70n3fac3: bets 1300
FDIBA2009: raises 2528 to 3828
s70n3fac3: raises 3072 to 6900
FDIBA2009: raises 8305 to 15205 and is all-in
s70n3fac3: calls 4252 and is all-in
Uncalled bet (4053) returned to FDIBA2009
*** TURN *** [Qh Ac 6d] [Qc]
*** RIVER *** [Qh Ac 6d Qc] [5s]
*** SHOW DOWN ***
FDIBA2009: shows [6s As] (two pair, Aces and Queens)
s70n3fac3: shows [Kd Ah] (two pair, Aces and Queens - King kicker)
s70n3fac3 collected 23534 from pot
*** SUMMARY ***
Total pot 24904 | Rake 1370 
Board [Qh Ac 6d Qc 5s]
Seat 1: s70n3fac3 (button) (small blind) showed [Kd Ah] and won (23534) with two pair, Aces and Queens
Seat 2: FDIBA2009 (big blind) showed [6s As] and lost with two pair, Aces and Queens



PokerStars Home Game Hand #225973190383: {Club #4781089}  Hold'em No Limit (50/100) - 2021/04/18 23:30:41 EET [2021/04/18 16:30:41 ET]
Table 'Session 3' 2-max (Play Money) Seat #2 is the button
Seat 1: s70n3fac3 (23534 in chips) 
Seat 2: FDIBA2009 (4053 in chips) 
FDIBA2009: posts small blind 50
s70n3fac3: posts big blind 100
*** HOLE CARDS ***
FDIBA2009: raises 100 to 200
s70n3fac3: calls 100
*** FLOP *** [Js 3s 4s]
s70n3fac3: checks 
FDIBA2009: checks 
*** TURN *** [Js 3s 4s] [Ts]
s70n3fac3: checks 
FDIBA2009: checks 
*** RIVER *** [Js 3s 4s Ts] [8c]
s70n3fac3: checks 
FDIBA2009: checks 
*** SHOW DOWN ***
s70n3fac3: shows [7c Tc] (a pair of Tens)
FDIBA2009: mucks hand 
s70n3fac3 collected 378 from pot
*** SUMMARY ***
Total pot 400 | Rake 22 
Board [Js 3s 4s Ts 8c]
Seat 1: s70n3fac3 (big blind) showed [7c Tc] and won (378) with a pair of Tens
Seat 2: FDIBA2009 (button) (small blind) mucked [Kd 6h]



PokerStars Home Game Hand #225973207002: {Club #4781089}  Hold'em No Limit (50/100) - 2021/04/18 23:31:04 EET [2021/04/18 16:31:04 ET]
Table 'Session 3' 2-max (Play Money) Seat #1 is the button
Seat 1: s70n3fac3 (23712 in chips) 
Seat 2: FDIBA2009 (3853 in chips) 
s70n3fac3: posts small blind 50
FDIBA2009: posts big blind 100
*** HOLE CARDS ***
s70n3fac3: folds 
Uncalled bet (50) returned to FDIBA2009
FDIBA2009 collected 100 from pot
*** SUMMARY ***
Total pot 100 | Rake 0 
Seat 1: s70n3fac3 (button) (small blind) folded before Flop
Seat 2: FDIBA2009 (big blind) collected (100)



PokerStars Home Game Hand #225973210012: {Club #4781089}  Hold'em No Limit (50/100) - 2021/04/18 23:31:08 EET [2021/04/18 16:31:08 ET]
Table 'Session 3' 2-max (Play Money) Seat #2 is the button
Seat 1: s70n3fac3 (23662 in chips) 
Seat 2: FDIBA2009 (3903 in chips) 
FDIBA2009: posts small blind 50
s70n3fac3: posts big blind 100
*** HOLE CARDS ***
FDIBA2009: raises 100 to 200
s70n3fac3: calls 100
*** FLOP *** [6h Th Kc]
s70n3fac3: checks 
FDIBA2009: checks 
*** TURN *** [6h Th Kc] [4s]
s70n3fac3: checks 
FDIBA2009: bets 189
s70n3fac3: calls 189
*** RIVER *** [6h Th Kc 4s] [2d]
s70n3fac3: checks 
FDIBA2009: bets 735
s70n3fac3: folds 
Uncalled bet (735) returned to FDIBA2009
FDIBA2009 collected 735 from pot
*** SUMMARY ***
Total pot 778 | Rake 43 
Board [6h Th Kc 4s 2d]
Seat 1: s70n3fac3 (big blind) folded on the River
Seat 2: FDIBA2009 (button) (small blind) collected (735)



PokerStars Home Game Hand #225973224120: {Club #4781089}  Hold'em No Limit (50/100) - 2021/04/18 23:31:26 EET [2021/04/18 16:31:26 ET]
Table 'Session 3' 2-max (Play Money) Seat #1 is the button
Seat 1: s70n3fac3 (23273 in chips) 
Seat 2: FDIBA2009 (4249 in chips) 
s70n3fac3: posts small blind 50
FDIBA2009: posts big blind 100
*** HOLE CARDS ***
s70n3fac3: raises 100 to 200
FDIBA2009: calls 100
*** FLOP *** [2s 9h Td]
FDIBA2009: checks 
s70n3fac3: bets 200
FDIBA2009: folds 
Uncalled bet (200) returned to s70n3fac3
s70n3fac3 collected 378 from pot
s70n3fac3: doesn't show hand 
*** SUMMARY ***
Total pot 400 | Rake 22 
Board [2s 9h Td]
Seat 1: s70n3fac3 (button) (small blind) collected (378)
Seat 2: FDIBA2009 (big blind) folded on the Flop



PokerStars Home Game Hand #225973232007: {Club #4781089}  Hold'em No Limit (50/100) - 2021/04/18 23:31:37 EET [2021/04/18 16:31:37 ET]
Table 'Session 3' 2-max (Play Money) Seat #2 is the button
Seat 1: s70n3fac3 (23451 in chips) 
Seat 2: FDIBA2009 (4049 in chips) 
FDIBA2009: posts small blind 50
s70n3fac3: posts big blind 100
*** HOLE CARDS ***
FDIBA2009: folds 
Uncalled bet (50) returned to s70n3fac3
s70n3fac3 collected 100 from pot
s70n3fac3: doesn't show hand 
*** SUMMARY ***
Total pot 100 | Rake 0 
Seat 1: s70n3fac3 (big blind) collected (100)
Seat 2: FDIBA2009 (button) (small blind) folded before Flop



PokerStars Home Game Hand #225973235283: {Club #4781089}  Hold'em No Limit (50/100) - 2021/04/18 23:31:41 EET [2021/04/18 16:31:41 ET]
Table 'Session 3' 2-max (Play Money) Seat #1 is the button
Seat 1: s70n3fac3 (23501 in chips) 
Seat 2: FDIBA2009 (3999 in chips) 
s70n3fac3: posts small blind 50
FDIBA2009: posts big blind 100
*** HOLE CARDS ***
s70n3fac3: raises 100 to 200
FDIBA2009: folds 
Uncalled bet (100) returned to s70n3fac3
s70n3fac3 collected 200 from pot
s70n3fac3: doesn't show hand 
*** SUMMARY ***
Total pot 200 | Rake 0 
Seat 1: s70n3fac3 (button) (small blind) collected (200)
Seat 2: FDIBA2009 (big blind) folded before Flop



PokerStars Home Game Hand #225973241642: {Club #4781089}  Hold'em No Limit (50/100) - 2021/04/18 23:31:50 EET [2021/04/18 16:31:50 ET]
Table 'Session 3' 2-max (Play Money) Seat #2 is the button
Seat 1: s70n3fac3 (23601 in chips) 
Seat 2: FDIBA2009 (3899 in chips) 
FDIBA2009: posts small blind 50
s70n3fac3: posts big blind 100
*** HOLE CARDS ***
FDIBA2009: raises 200 to 300
s70n3fac3: folds 
Uncalled bet (200) returned to FDIBA2009
FDIBA2009 collected 200 from pot
*** SUMMARY ***
Total pot 200 | Rake 0 
Seat 1: s70n3fac3 (big blind) folded before Flop
Seat 2: FDIBA2009 (button) (small blind) collected (200)



PokerStars Home Game Hand #225973246527: {Club #4781089}  Hold'em No Limit (50/100) - 2021/04/18 23:31:56 EET [2021/04/18 16:31:56 ET]
Table 'Session 3' 2-max (Play Money) Seat #1 is the button
Seat 1: s70n3fac3 (23501 in chips) 
Seat 2: FDIBA2009 (3999 in chips) 
s70n3fac3: posts small blind 50
FDIBA2009: posts big blind 100
*** HOLE CARDS ***
s70n3fac3: raises 100 to 200
FDIBA2009: folds 
Uncalled bet (100) returned to s70n3fac3
s70n3fac3 collected 200 from pot
s70n3fac3: doesn't show hand 
*** SUMMARY ***
Total pot 200 | Rake 0 
Seat 1: s70n3fac3 (button) (small blind) collected (200)
Seat 2: FDIBA2009 (big blind) folded before Flop



PokerStars Home Game Hand #225973251065: {Club #4781089}  Hold'em No Limit (50/100) - 2021/04/18 23:32:03 EET [2021/04/18 16:32:03 ET]
Table 'Session 3' 2-max (Play Money) Seat #2 is the button
Seat 1: s70n3fac3 (23601 in chips) 
Seat 2: FDIBA2009 (3899 in chips) 
FDIBA2009: posts small blind 50
s70n3fac3: posts big blind 100
*** HOLE CARDS ***
FDIBA2009: raises 200 to 300
s70n3fac3: folds 
Uncalled bet (200) returned to FDIBA2009
FDIBA2009 collected 200 from pot
*** SUMMARY ***
Total pot 200 | Rake 0 
Seat 1: s70n3fac3 (big blind) folded before Flop
Seat 2: FDIBA2009 (button) (small blind) collected (200)



PokerStars Home Game Hand #225973255771: {Club #4781089}  Hold'em No Limit (50/100) - 2021/04/18 23:32:09 EET [2021/04/18 16:32:09 ET]
Table 'Session 3' 2-max (Play Money) Seat #1 is the button
Seat 1: s70n3fac3 (23501 in chips) 
Seat 2: FDIBA2009 (3999 in chips) 
s70n3fac3: posts small blind 50
FDIBA2009: posts big blind 100
*** HOLE CARDS ***
s70n3fac3: folds 
Uncalled bet (50) returned to FDIBA2009
FDIBA2009 collected 100 from pot
*** SUMMARY ***
Total pot 100 | Rake 0 
Seat 1: s70n3fac3 (button) (small blind) folded before Flop
Seat 2: FDIBA2009 (big blind) collected (100)



PokerStars Home Game Hand #225973258692: {Club #4781089}  Hold'em No Limit (50/100) - 2021/04/18 23:32:13 EET [2021/04/18 16:32:13 ET]
Table 'Session 3' 2-max (Play Money) Seat #2 is the button
Seat 1: s70n3fac3 (23451 in chips) 
Seat 2: FDIBA2009 (4049 in chips) 
FDIBA2009: posts small blind 50
s70n3fac3: posts big blind 100
*** HOLE CARDS ***
FDIBA2009: raises 200 to 300
s70n3fac3: calls 200
*** FLOP *** [Ac 9d Td]
s70n3fac3: checks 
FDIBA2009: bets 283
s70n3fac3: calls 283
*** TURN *** [Ac 9d Td] [4s]
s70n3fac3: checks 
FDIBA2009: checks 
*** RIVER *** [Ac 9d Td 4s] [Th]
s70n3fac3: checks 
FDIBA2009: checks 
*** SHOW DOWN ***
s70n3fac3: shows [9s Js] (two pair, Tens and Nines)
FDIBA2009: shows [8d 9c] (two pair, Tens and Nines)
s70n3fac3 collected 551 from pot
FDIBA2009 collected 551 from pot
*** SUMMARY ***
Total pot 1166 | Rake 64 
Board [Ac 9d Td 4s Th]
Seat 1: s70n3fac3 (big blind) showed [9s Js] and won (551) with two pair, Tens and Nines
Seat 2: FDIBA2009 (button) (small blind) showed [8d 9c] and won (551) with two pair, Tens and Nines



PokerStars Home Game Hand #225973272057: {Club #4781089}  Hold'em No Limit (50/100) - 2021/04/18 23:32:31 EET [2021/04/18 16:32:31 ET]
Table 'Session 3' 2-max (Play Money) Seat #1 is the button
Seat 1: s70n3fac3 (23419 in chips) 
Seat 2: FDIBA2009 (4017 in chips) 
s70n3fac3: posts small blind 50
FDIBA2009: posts big blind 100
*** HOLE CARDS ***
s70n3fac3: calls 50
FDIBA2009: raises 200 to 300
s70n3fac3: calls 200
*** FLOP *** [Jd 6c 7d]
FDIBA2009: bets 283
s70n3fac3: folds 
Uncalled bet (283) returned to FDIBA2009
FDIBA2009 collected 567 from pot
*** SUMMARY ***
Total pot 600 | Rake 33 
Board [Jd 6c 7d]
Seat 1: s70n3fac3 (button) (small blind) folded on the Flop
Seat 2: FDIBA2009 (big blind) collected (567)



PokerStars Home Game Hand #225973284214: {Club #4781089}  Hold'em No Limit (50/100) - 2021/04/18 23:32:47 EET [2021/04/18 16:32:47 ET]
Table 'Session 3' 2-max (Play Money) Seat #2 is the button
Seat 1: s70n3fac3 (23119 in chips) 
Seat 2: FDIBA2009 (4284 in chips) 
FDIBA2009: posts small blind 50
s70n3fac3: posts big blind 100
*** HOLE CARDS ***
FDIBA2009: raises 100 to 200
s70n3fac3: calls 100
*** FLOP *** [4c Ah Ac]
s70n3fac3: checks 
FDIBA2009: checks 
*** TURN *** [4c Ah Ac] [4s]
s70n3fac3: checks 
FDIBA2009: checks 
*** RIVER *** [4c Ah Ac 4s] [Td]
s70n3fac3: bets 400
FDIBA2009: folds 
Uncalled bet (400) returned to s70n3fac3
s70n3fac3 collected 378 from pot
s70n3fac3: doesn't show hand 
*** SUMMARY ***
Total pot 400 | Rake 22 
Board [4c Ah Ac 4s Td]
Seat 1: s70n3fac3 (big blind) collected (378)
Seat 2: FDIBA2009 (button) (small blind) folded on the River



PokerStars Home Game Hand #225973295382: {Club #4781089}  Hold'em No Limit (50/100) - 2021/04/18 23:33:02 EET [2021/04/18 16:33:02 ET]
Table 'Session 3' 2-max (Play Money) Seat #1 is the button
Seat 1: s70n3fac3 (23297 in chips) 
Seat 2: FDIBA2009 (4084 in chips) 
s70n3fac3: posts small blind 50
FDIBA2009: posts big blind 100
*** HOLE CARDS ***
s70n3fac3: calls 50
FDIBA2009: raises 200 to 300
s70n3fac3: calls 200
*** FLOP *** [8c 9h 7d]
FDIBA2009: checks 
s70n3fac3: bets 260
FDIBA2009: folds 
Uncalled bet (260) returned to s70n3fac3
s70n3fac3 collected 567 from pot
s70n3fac3: doesn't show hand 
*** SUMMARY ***
Total pot 600 | Rake 33 
Board [8c 9h 7d]
Seat 1: s70n3fac3 (button) (small blind) collected (567)
Seat 2: FDIBA2009 (big blind) folded on the Flop



PokerStars Home Game Hand #225973306288: {Club #4781089}  Hold'em No Limit (50/100) - 2021/04/18 23:33:17 EET [2021/04/18 16:33:17 ET]
Table 'Session 3' 2-max (Play Money) Seat #2 is the button
Seat 1: s70n3fac3 (23564 in chips) 
Seat 2: FDIBA2009 (3784 in chips) 
FDIBA2009: posts small blind 50
s70n3fac3: posts big blind 100
*** HOLE CARDS ***
FDIBA2009: raises 200 to 300
s70n3fac3: folds 
Uncalled bet (200) returned to FDIBA2009
FDIBA2009 collected 200 from pot
*** SUMMARY ***
Total pot 200 | Rake 0 
Seat 1: s70n3fac3 (big blind) folded before Flop
Seat 2: FDIBA2009 (button) (small blind) collected (200)



PokerStars Home Game Hand #225973310536: {Club #4781089}  Hold'em No Limit (50/100) - 2021/04/18 23:33:23 EET [2021/04/18 16:33:23 ET]
Table 'Session 3' 2-max (Play Money) Seat #1 is the button
Seat 1: s70n3fac3 (23464 in chips) 
Seat 2: FDIBA2009 (3884 in chips) 
s70n3fac3: posts small blind 50
FDIBA2009: posts big blind 100
*** HOLE CARDS ***
s70n3fac3: calls 50
FDIBA2009: checks 
*** FLOP *** [Tc Js As]
FDIBA2009: checks 
s70n3fac3: bets 200
FDIBA2009: folds 
Uncalled bet (200) returned to s70n3fac3
s70n3fac3 collected 189 from pot
s70n3fac3: doesn't show hand 
*** SUMMARY ***
Total pot 200 | Rake 11 
Board [Tc Js As]
Seat 1: s70n3fac3 (button) (small blind) collected (189)
Seat 2: FDIBA2009 (big blind) folded on the Flop



PokerStars Home Game Hand #225973317443: {Club #4781089}  Hold'em No Limit (50/100) - 2021/04/18 23:33:32 EET [2021/04/18 16:33:32 ET]
Table 'Session 3' 2-max (Play Money) Seat #2 is the button
Seat 1: s70n3fac3 (23553 in chips) 
Seat 2: FDIBA2009 (3784 in chips) 
FDIBA2009: posts small blind 50
s70n3fac3: posts big blind 100
*** HOLE CARDS ***
FDIBA2009: raises 200 to 300
s70n3fac3: calls 200
*** FLOP *** [Ac 8s 2h]
s70n3fac3: checks 
FDIBA2009: bets 283
s70n3fac3: calls 283
*** TURN *** [Ac 8s 2h] [6h]
s70n3fac3: checks 
FDIBA2009: checks 
*** RIVER *** [Ac 8s 2h 6h] [Kh]
s70n3fac3: checks 
FDIBA2009: checks 
*** SHOW DOWN ***
s70n3fac3: shows [9c 9s] (a pair of Nines)
FDIBA2009: mucks hand 
s70n3fac3 collected 1102 from pot
*** SUMMARY ***
Total pot 1166 | Rake 64 
Board [Ac 8s 2h 6h Kh]
Seat 1: s70n3fac3 (big blind) showed [9c 9s] and won (1102) with a pair of Nines
Seat 2: FDIBA2009 (button) (small blind) mucked [Tc 4h]



PokerStars Home Game Hand #225973338683: {Club #4781089}  Hold'em No Limit (50/100) - 2021/04/18 23:33:51 EET [2021/04/18 16:33:51 ET]
Table 'Session 3' 2-max (Play Money) Seat #1 is the button
Seat 1: s70n3fac3 (24072 in chips) 
Seat 2: FDIBA2009 (3201 in chips) 
s70n3fac3: posts small blind 50
FDIBA2009: posts big blind 100
*** HOLE CARDS ***
s70n3fac3: calls 50
FDIBA2009: raises 200 to 300
s70n3fac3: folds 
Uncalled bet (200) returned to FDIBA2009
FDIBA2009 collected 200 from pot
*** SUMMARY ***
Total pot 200 | Rake 0 
Seat 1: s70n3fac3 (button) (small blind) folded before Flop
Seat 2: FDIBA2009 (big blind) collected (200)



PokerStars Home Game Hand #225973344402: {Club #4781089}  Hold'em No Limit (50/100) - 2021/04/18 23:33:59 EET [2021/04/18 16:33:59 ET]
Table 'Session 3' 2-max (Play Money) Seat #2 is the button
Seat 1: s70n3fac3 (23972 in chips) 
Seat 2: FDIBA2009 (3301 in chips) 
FDIBA2009: posts small blind 50
s70n3fac3: posts big blind 100
*** HOLE CARDS ***
FDIBA2009: raises 200 to 300
s70n3fac3: calls 200
*** FLOP *** [9c Kd Qh]
s70n3fac3: checks 
FDIBA2009: checks 
*** TURN *** [9c Kd Qh] [3s]
s70n3fac3: checks 
FDIBA2009: checks 
*** RIVER *** [9c Kd Qh 3s] [9d]
s70n3fac3: checks 
FDIBA2009: checks 
*** SHOW DOWN ***
s70n3fac3: shows [Js Ah] (a pair of Nines)
FDIBA2009: shows [Ac 5c] (a pair of Nines)
s70n3fac3 collected 284 from pot
FDIBA2009 collected 283 from pot
*** SUMMARY ***
Total pot 600 | Rake 33 
Board [9c Kd Qh 3s 9d]
Seat 1: s70n3fac3 (big blind) showed [Js Ah] and won (284) with a pair of Nines
Seat 2: FDIBA2009 (button) (small blind) showed [Ac 5c] and won (283) with a pair of Nines



PokerStars Home Game Hand #225973359306: {Club #4781089}  Hold'em No Limit (50/100) - 2021/04/18 23:34:19 EET [2021/04/18 16:34:19 ET]
Table 'Session 3' 2-max (Play Money) Seat #1 is the button
Seat 1: s70n3fac3 (23956 in chips) 
Seat 2: FDIBA2009 (3284 in chips) 
s70n3fac3: posts small blind 50
FDIBA2009: posts big blind 100
*** HOLE CARDS ***
s70n3fac3: calls 50
FDIBA2009: raises 200 to 300
s70n3fac3: calls 200
*** FLOP *** [8s Td 5h]
FDIBA2009: checks 
s70n3fac3: checks 
*** TURN *** [8s Td 5h] [4h]
FDIBA2009: checks 
s70n3fac3: bets 200
FDIBA2009: folds 
Uncalled bet (200) returned to s70n3fac3
s70n3fac3 collected 567 from pot
s70n3fac3: doesn't show hand 
*** SUMMARY ***
Total pot 600 | Rake 33 
Board [8s Td 5h 4h]
Seat 1: s70n3fac3 (button) (small blind) collected (567)
Seat 2: FDIBA2009 (big blind) folded on the Turn



PokerStars Home Game Hand #225973374393: {Club #4781089}  Hold'em No Limit (50/100) - 2021/04/18 23:34:39 EET [2021/04/18 16:34:39 ET]
Table 'Session 3' 2-max (Play Money) Seat #2 is the button
Seat 1: s70n3fac3 (24223 in chips) 
Seat 2: FDIBA2009 (2984 in chips) 
FDIBA2009: posts small blind 50
s70n3fac3: posts big blind 100
*** HOLE CARDS ***
FDIBA2009: folds 
Uncalled bet (50) returned to s70n3fac3
s70n3fac3 collected 100 from pot
s70n3fac3: doesn't show hand 
*** SUMMARY ***
Total pot 100 | Rake 0 
Seat 1: s70n3fac3 (big blind) collected (100)
Seat 2: FDIBA2009 (button) (small blind) folded before Flop



PokerStars Home Game Hand #225973378123: {Club #4781089}  Hold'em No Limit (50/100) - 2021/04/18 23:34:45 EET [2021/04/18 16:34:45 ET]
Table 'Session 3' 2-max (Play Money) Seat #1 is the button
Seat 1: s70n3fac3 (24273 in chips) 
Seat 2: FDIBA2009 (2934 in chips) 
s70n3fac3: posts small blind 50
FDIBA2009: posts big blind 100
*** HOLE CARDS ***
s70n3fac3: folds 
Uncalled bet (50) returned to FDIBA2009
FDIBA2009 collected 100 from pot
*** SUMMARY ***
Total pot 100 | Rake 0 
Seat 1: s70n3fac3 (button) (small blind) folded before Flop
Seat 2: FDIBA2009 (big blind) collected (100)



PokerStars Home Game Hand #225973380962: {Club #4781089}  Hold'em No Limit (50/100) - 2021/04/18 23:34:48 EET [2021/04/18 16:34:48 ET]
Table 'Session 3' 2-max (Play Money) Seat #2 is the button
Seat 1: s70n3fac3 (24223 in chips) 
Seat 2: FDIBA2009 (2984 in chips) 
FDIBA2009: posts small blind 50
s70n3fac3: posts big blind 100
*** HOLE CARDS ***
FDIBA2009: raises 200 to 300
s70n3fac3: raises 500 to 800
FDIBA2009: calls 500
*** FLOP *** [Th 6d 4h]
s70n3fac3: bets 800
FDIBA2009: raises 1384 to 2184 and is all-in
s70n3fac3: calls 1384
*** TURN *** [Th 6d 4h] [2c]
*** RIVER *** [Th 6d 4h 2c] [Qd]
*** SHOW DOWN ***
s70n3fac3: shows [Qs Qc] (three of a kind, Queens)
FDIBA2009: shows [8d 7h] (high card Queen)
s70n3fac3 collected 5640 from pot
*** SUMMARY ***
Total pot 5968 | Rake 328 
Board [Th 6d 4h 2c Qd]
Seat 1: s70n3fac3 (big blind) showed [Qs Qc] and won (5640) with three of a kind, Queens
Seat 2: FDIBA2009 (button) (small blind) showed [8d 7h] and lost with high card Queen



