PokerStars Home Game Hand #226819268682: {Club #4781089}  Hold'em No Limit (50/100) - 2021/05/16 23:50:34 EET [2021/05/16 16:50:34 ET]
Table 'VTPP NLHE 1605' 2-max (Play Money) Seat #2 is the button
Seat 1: s70n3fac3 (10000 in chips) 
Seat 2: FDIBA2009 (10000 in chips) 
FDIBA2009: posts small blind 50
s70n3fac3: posts big blind 100
*** HOLE CARDS ***
FDIBA2009: raises 100 to 200
s70n3fac3: raises 400 to 600
FDIBA2009: calls 400
*** FLOP *** [8h 9h Jh]
s70n3fac3: bets 750
FDIBA2009: calls 750
*** TURN *** [8h 9h Jh] [Th]
s70n3fac3: checks 
FDIBA2009: bets 1100
s70n3fac3: calls 1100
*** RIVER *** [8h 9h Jh Th] [2s]
s70n3fac3: checks 
FDIBA2009: checks 
*** SHOW DOWN ***
s70n3fac3: shows [8d 8s] (three of a kind, Eights)
FDIBA2009: mucks hand 
s70n3fac3 collected 4630 from pot
*** SUMMARY ***
Total pot 4900 | Rake 270 
Board [8h 9h Jh Th 2s]
Seat 1: s70n3fac3 (big blind) showed [8d 8s] and won (4630) with three of a kind, Eights
Seat 2: FDIBA2009 (button) (small blind) mucked [Ad 8c]



PokerStars Home Game Hand #226819312835: {Club #4781089}  Hold'em No Limit (50/100) - 2021/05/16 23:51:48 EET [2021/05/16 16:51:48 ET]
Table 'VTPP NLHE 1605' 2-max (Play Money) Seat #1 is the button
Seat 1: s70n3fac3 (12180 in chips) 
Seat 2: FDIBA2009 (7550 in chips) 
s70n3fac3: posts small blind 50
FDIBA2009: posts big blind 100
*** HOLE CARDS ***
s70n3fac3: raises 100 to 200
FDIBA2009: folds 
Uncalled bet (100) returned to s70n3fac3
s70n3fac3 collected 200 from pot
s70n3fac3: doesn't show hand 
*** SUMMARY ***
Total pot 200 | Rake 0 
Seat 1: s70n3fac3 (button) (small blind) collected (200)
Seat 2: FDIBA2009 (big blind) folded before Flop



PokerStars Home Game Hand #226819316574: {Club #4781089}  Hold'em No Limit (50/100) - 2021/05/16 23:51:54 EET [2021/05/16 16:51:54 ET]
Table 'VTPP NLHE 1605' 2-max (Play Money) Seat #2 is the button
Seat 1: s70n3fac3 (12280 in chips) 
Seat 2: FDIBA2009 (7450 in chips) 
FDIBA2009: posts small blind 50
s70n3fac3: posts big blind 100
*** HOLE CARDS ***
FDIBA2009: raises 100 to 200
s70n3fac3: calls 100
*** FLOP *** [3c Qs 2s]
s70n3fac3: bets 200
FDIBA2009: calls 200
*** TURN *** [3c Qs 2s] [Qd]
s70n3fac3: bets 400
FDIBA2009: calls 400
*** RIVER *** [3c Qs 2s Qd] [7s]
s70n3fac3: bets 800
FDIBA2009: raises 3200 to 4000
s70n3fac3: folds 
Uncalled bet (3200) returned to FDIBA2009
FDIBA2009 collected 3024 from pot
*** SUMMARY ***
Total pot 3200 | Rake 176 
Board [3c Qs 2s Qd 7s]
Seat 1: s70n3fac3 (big blind) folded on the River
Seat 2: FDIBA2009 (button) (small blind) collected (3024)



PokerStars Home Game Hand #226819345699: {Club #4781089}  Hold'em No Limit (50/100) - 2021/05/16 23:52:43 EET [2021/05/16 16:52:43 ET]
Table 'VTPP NLHE 1605' 2-max (Play Money) Seat #1 is the button
Seat 1: s70n3fac3 (10680 in chips) 
Seat 2: FDIBA2009 (8874 in chips) 
s70n3fac3: posts small blind 50
FDIBA2009: posts big blind 100
*** HOLE CARDS ***
s70n3fac3: calls 50
FDIBA2009: checks 
*** FLOP *** [4d Qh 5s]
FDIBA2009: checks 
s70n3fac3: bets 189
FDIBA2009: folds 
Uncalled bet (189) returned to s70n3fac3
s70n3fac3 collected 189 from pot
s70n3fac3: doesn't show hand 
*** SUMMARY ***
Total pot 200 | Rake 11 
Board [4d Qh 5s]
Seat 1: s70n3fac3 (button) (small blind) collected (189)
Seat 2: FDIBA2009 (big blind) folded on the Flop



PokerStars Home Game Hand #226819353357: {Club #4781089}  Hold'em No Limit (50/100) - 2021/05/16 23:52:56 EET [2021/05/16 16:52:56 ET]
Table 'VTPP NLHE 1605' 2-max (Play Money) Seat #2 is the button
Seat 1: s70n3fac3 (10769 in chips) 
Seat 2: FDIBA2009 (8774 in chips) 
FDIBA2009: posts small blind 50
s70n3fac3: posts big blind 100
*** HOLE CARDS ***
FDIBA2009: raises 100 to 200
s70n3fac3: calls 100
*** FLOP *** [6h Ks Jc]
s70n3fac3: checks 
FDIBA2009: checks 
*** TURN *** [6h Ks Jc] [7c]
s70n3fac3: bets 200
FDIBA2009: calls 200
*** RIVER *** [6h Ks Jc 7c] [7s]
s70n3fac3: bets 300
FDIBA2009: raises 1400 to 1700
s70n3fac3: calls 1400
*** SHOW DOWN ***
FDIBA2009: shows [6c 7h] (a full house, Sevens full of Sixes)
s70n3fac3: mucks hand 
FDIBA2009 collected 3969 from pot
*** SUMMARY ***
Total pot 4200 | Rake 231 
Board [6h Ks Jc 7c 7s]
Seat 1: s70n3fac3 (big blind) mucked [Js 2s]
Seat 2: FDIBA2009 (button) (small blind) showed [6c 7h] and won (3969) with a full house, Sevens full of Sixes



PokerStars Home Game Hand #226819372276: {Club #4781089}  Hold'em No Limit (50/100) - 2021/05/16 23:53:27 EET [2021/05/16 16:53:27 ET]
Table 'VTPP NLHE 1605' 2-max (Play Money) Seat #1 is the button
Seat 1: s70n3fac3 (8669 in chips) 
Seat 2: FDIBA2009 (10643 in chips) 
s70n3fac3: posts small blind 50
FDIBA2009: posts big blind 100
*** HOLE CARDS ***
s70n3fac3: calls 50
FDIBA2009: checks 
*** FLOP *** [6c 7s Qd]
FDIBA2009: checks 
s70n3fac3: bets 100
FDIBA2009: calls 100
*** TURN *** [6c 7s Qd] [8c]
FDIBA2009: checks 
s70n3fac3: bets 200
FDIBA2009: calls 200
*** RIVER *** [6c 7s Qd 8c] [Jd]
FDIBA2009: bets 756
s70n3fac3: calls 756
*** SHOW DOWN ***
FDIBA2009: shows [Tc Kc] (high card King)
s70n3fac3: shows [Qs 8h] (two pair, Queens and Eights)
s70n3fac3 collected 2185 from pot
*** SUMMARY ***
Total pot 2312 | Rake 127 
Board [6c 7s Qd 8c Jd]
Seat 1: s70n3fac3 (button) (small blind) showed [Qs 8h] and won (2185) with two pair, Queens and Eights
Seat 2: FDIBA2009 (big blind) showed [Tc Kc] and lost with high card King



PokerStars Home Game Hand #226819395746: {Club #4781089}  Hold'em No Limit (50/100) - 2021/05/16 23:54:07 EET [2021/05/16 16:54:07 ET]
Table 'VTPP NLHE 1605' 2-max (Play Money) Seat #2 is the button
Seat 1: s70n3fac3 (9698 in chips) 
Seat 2: FDIBA2009 (9487 in chips) 
FDIBA2009: posts small blind 50
s70n3fac3: posts big blind 100
*** HOLE CARDS ***
FDIBA2009: folds 
Uncalled bet (50) returned to s70n3fac3
s70n3fac3 collected 100 from pot
s70n3fac3: doesn't show hand 
*** SUMMARY ***
Total pot 100 | Rake 0 
Seat 1: s70n3fac3 (big blind) collected (100)
Seat 2: FDIBA2009 (button) (small blind) folded before Flop



PokerStars Home Game Hand #226819400578: {Club #4781089}  Hold'em No Limit (50/100) - 2021/05/16 23:54:12 EET [2021/05/16 16:54:12 ET]
Table 'VTPP NLHE 1605' 2-max (Play Money) Seat #1 is the button
Seat 1: s70n3fac3 (9748 in chips) 
Seat 2: FDIBA2009 (9437 in chips) 
s70n3fac3: posts small blind 50
FDIBA2009: posts big blind 100
*** HOLE CARDS ***
s70n3fac3: raises 100 to 200
FDIBA2009: calls 100
*** FLOP *** [5h 7d Th]
FDIBA2009: checks 
s70n3fac3: bets 200
FDIBA2009: calls 200
*** TURN *** [5h 7d Th] [As]
FDIBA2009: checks 
s70n3fac3: bets 400
FDIBA2009: calls 400
*** RIVER *** [5h 7d Th As] [Ac]
FDIBA2009: checks 
s70n3fac3: checks 
*** SHOW DOWN ***
FDIBA2009: shows [8h 2h] (a pair of Aces)
s70n3fac3: shows [Kh Js] (a pair of Aces - King kicker)
s70n3fac3 collected 1512 from pot
*** SUMMARY ***
Total pot 1600 | Rake 88 
Board [5h 7d Th As Ac]
Seat 1: s70n3fac3 (button) (small blind) showed [Kh Js] and won (1512) with a pair of Aces
Seat 2: FDIBA2009 (big blind) showed [8h 2h] and lost with a pair of Aces



PokerStars Home Game Hand #226819418546: {Club #4781089}  Hold'em No Limit (50/100) - 2021/05/16 23:54:42 EET [2021/05/16 16:54:42 ET]
Table 'VTPP NLHE 1605' 2-max (Play Money) Seat #2 is the button
Seat 1: s70n3fac3 (10460 in chips) 
Seat 2: FDIBA2009 (8637 in chips) 
FDIBA2009: posts small blind 50
s70n3fac3: posts big blind 100
*** HOLE CARDS ***
FDIBA2009: raises 200 to 300
s70n3fac3: calls 200
*** FLOP *** [2s 2d 4c]
s70n3fac3: checks 
FDIBA2009: bets 300
s70n3fac3: folds 
Uncalled bet (300) returned to FDIBA2009
FDIBA2009 collected 567 from pot
*** SUMMARY ***
Total pot 600 | Rake 33 
Board [2s 2d 4c]
Seat 1: s70n3fac3 (big blind) folded on the Flop
Seat 2: FDIBA2009 (button) (small blind) collected (567)



PokerStars Home Game Hand #226819428836: {Club #4781089}  Hold'em No Limit (50/100) - 2021/05/16 23:54:59 EET [2021/05/16 16:54:59 ET]
Table 'VTPP NLHE 1605' 2-max (Play Money) Seat #1 is the button
Seat 1: s70n3fac3 (10160 in chips) 
Seat 2: FDIBA2009 (8904 in chips) 
s70n3fac3: posts small blind 50
FDIBA2009: posts big blind 100
*** HOLE CARDS ***
s70n3fac3: folds 
Uncalled bet (50) returned to FDIBA2009
FDIBA2009 collected 100 from pot
*** SUMMARY ***
Total pot 100 | Rake 0 
Seat 1: s70n3fac3 (button) (small blind) folded before Flop
Seat 2: FDIBA2009 (big blind) collected (100)



PokerStars Home Game Hand #226819431272: {Club #4781089}  Hold'em No Limit (50/100) - 2021/05/16 23:55:04 EET [2021/05/16 16:55:04 ET]
Table 'VTPP NLHE 1605' 2-max (Play Money) Seat #2 is the button
Seat 1: s70n3fac3 (10110 in chips) 
Seat 2: FDIBA2009 (8954 in chips) 
FDIBA2009: posts small blind 50
s70n3fac3: posts big blind 100
*** HOLE CARDS ***
FDIBA2009: raises 100 to 200
s70n3fac3: raises 400 to 600
FDIBA2009: calls 400
*** FLOP *** [6c 8s Jc]
s70n3fac3: bets 600
FDIBA2009: folds 
Uncalled bet (600) returned to s70n3fac3
s70n3fac3 collected 1134 from pot
s70n3fac3: doesn't show hand 
*** SUMMARY ***
Total pot 1200 | Rake 66 
Board [6c 8s Jc]
Seat 1: s70n3fac3 (big blind) collected (1134)
Seat 2: FDIBA2009 (button) (small blind) folded on the Flop



PokerStars Home Game Hand #226819437881: {Club #4781089}  Hold'em No Limit (50/100) - 2021/05/16 23:55:18 EET [2021/05/16 16:55:18 ET]
Table 'VTPP NLHE 1605' 2-max (Play Money) Seat #1 is the button
Seat 1: s70n3fac3 (10644 in chips) 
Seat 2: FDIBA2009 (8354 in chips) 
s70n3fac3: posts small blind 50
FDIBA2009: posts big blind 100
*** HOLE CARDS ***
s70n3fac3: folds 
Uncalled bet (50) returned to FDIBA2009
FDIBA2009 collected 100 from pot
*** SUMMARY ***
Total pot 100 | Rake 0 
Seat 1: s70n3fac3 (button) (small blind) folded before Flop
Seat 2: FDIBA2009 (big blind) collected (100)



PokerStars Home Game Hand #226819439338: {Club #4781089}  Hold'em No Limit (50/100) - 2021/05/16 23:55:22 EET [2021/05/16 16:55:22 ET]
Table 'VTPP NLHE 1605' 2-max (Play Money) Seat #2 is the button
Seat 1: s70n3fac3 (10594 in chips) 
Seat 2: FDIBA2009 (8404 in chips) 
FDIBA2009: posts small blind 50
s70n3fac3: posts big blind 100
*** HOLE CARDS ***
FDIBA2009: raises 100 to 200
s70n3fac3: calls 100
*** FLOP *** [7d 2s Jd]
s70n3fac3: checks 
FDIBA2009: bets 200
s70n3fac3: calls 200
*** TURN *** [7d 2s Jd] [9h]
s70n3fac3: checks 
FDIBA2009: bets 400
s70n3fac3: calls 400
*** RIVER *** [7d 2s Jd 9h] [Kh]
s70n3fac3: checks 
FDIBA2009: checks 
*** SHOW DOWN ***
s70n3fac3: shows [9c Tc] (a pair of Nines)
FDIBA2009: mucks hand 
s70n3fac3 collected 1512 from pot
*** SUMMARY ***
Total pot 1600 | Rake 88 
Board [7d 2s Jd 9h Kh]
Seat 1: s70n3fac3 (big blind) showed [9c Tc] and won (1512) with a pair of Nines
Seat 2: FDIBA2009 (button) (small blind) mucked [7h 6h]



PokerStars Home Game Hand #226819449910: {Club #4781089}  Hold'em No Limit (50/100) - 2021/05/16 23:55:50 EET [2021/05/16 16:55:50 ET]
Table 'VTPP NLHE 1605' 2-max (Play Money) Seat #1 is the button
Seat 1: s70n3fac3 (11306 in chips) 
Seat 2: FDIBA2009 (7604 in chips) 
s70n3fac3: posts small blind 50
FDIBA2009: posts big blind 100
*** HOLE CARDS ***
s70n3fac3: raises 100 to 200
FDIBA2009: raises 400 to 600
s70n3fac3: calls 400
*** FLOP *** [Qd 5h Ah]
FDIBA2009: bets 1000
s70n3fac3: folds 
Uncalled bet (1000) returned to FDIBA2009
FDIBA2009 collected 1134 from pot
*** SUMMARY ***
Total pot 1200 | Rake 66 
Board [Qd 5h Ah]
Seat 1: s70n3fac3 (button) (small blind) folded on the Flop
Seat 2: FDIBA2009 (big blind) collected (1134)



PokerStars Home Game Hand #226819457443: {Club #4781089}  Hold'em No Limit (50/100) - 2021/05/16 23:56:09 EET [2021/05/16 16:56:09 ET]
Table 'VTPP NLHE 1605' 2-max (Play Money) Seat #2 is the button
Seat 1: s70n3fac3 (10706 in chips) 
Seat 2: FDIBA2009 (8138 in chips) 
FDIBA2009: posts small blind 50
s70n3fac3: posts big blind 100
*** HOLE CARDS ***
FDIBA2009: raises 100 to 200
s70n3fac3: calls 100
*** FLOP *** [8s Ts 6d]
s70n3fac3: checks 
FDIBA2009: bets 200
s70n3fac3: calls 200
*** TURN *** [8s Ts 6d] [3s]
s70n3fac3: checks 
FDIBA2009: checks 
*** RIVER *** [8s Ts 6d 3s] [2s]
s70n3fac3: checks 
FDIBA2009: bets 756
s70n3fac3: folds 
Uncalled bet (756) returned to FDIBA2009
FDIBA2009 collected 756 from pot
*** SUMMARY ***
Total pot 800 | Rake 44 
Board [8s Ts 6d 3s 2s]
Seat 1: s70n3fac3 (big blind) folded on the River
Seat 2: FDIBA2009 (button) (small blind) collected (756)



PokerStars Home Game Hand #226819468962: {Club #4781089}  Hold'em No Limit (50/100) - 2021/05/16 23:56:39 EET [2021/05/16 16:56:39 ET]
Table 'VTPP NLHE 1605' 2-max (Play Money) Seat #1 is the button
Seat 1: s70n3fac3 (10306 in chips) 
Seat 2: FDIBA2009 (8494 in chips) 
s70n3fac3: posts small blind 50
FDIBA2009: posts big blind 100
*** HOLE CARDS ***
s70n3fac3: raises 100 to 200
FDIBA2009: folds 
Uncalled bet (100) returned to s70n3fac3
s70n3fac3 collected 200 from pot
s70n3fac3: doesn't show hand 
*** SUMMARY ***
Total pot 200 | Rake 0 
Seat 1: s70n3fac3 (button) (small blind) collected (200)
Seat 2: FDIBA2009 (big blind) folded before Flop



PokerStars Home Game Hand #226819470884: {Club #4781089}  Hold'em No Limit (50/100) - 2021/05/16 23:56:44 EET [2021/05/16 16:56:44 ET]
Table 'VTPP NLHE 1605' 2-max (Play Money) Seat #2 is the button
Seat 1: s70n3fac3 (10406 in chips) 
Seat 2: FDIBA2009 (8394 in chips) 
FDIBA2009: posts small blind 50
s70n3fac3: posts big blind 100
*** HOLE CARDS ***
FDIBA2009: raises 100 to 200
s70n3fac3: calls 100
*** FLOP *** [9h 2c 6d]
s70n3fac3: checks 
FDIBA2009: bets 200
s70n3fac3: raises 400 to 600
FDIBA2009: calls 400
*** TURN *** [9h 2c 6d] [6c]
s70n3fac3: checks 
FDIBA2009: checks 
*** RIVER *** [9h 2c 6d 6c] [Ts]
s70n3fac3: bets 800
FDIBA2009: calls 800
*** SHOW DOWN ***
s70n3fac3: shows [Th 9c] (two pair, Tens and Nines)
FDIBA2009: mucks hand 
s70n3fac3 collected 3024 from pot
*** SUMMARY ***
Total pot 3200 | Rake 176 
Board [9h 2c 6d 6c Ts]
Seat 1: s70n3fac3 (big blind) showed [Th 9c] and won (3024) with two pair, Tens and Nines
Seat 2: FDIBA2009 (button) (small blind) mucked [Jc Tc]



PokerStars Home Game Hand #226819481710: {Club #4781089}  Hold'em No Limit (50/100) - 2021/05/16 23:57:13 EET [2021/05/16 16:57:13 ET]
Table 'VTPP NLHE 1605' 2-max (Play Money) Seat #1 is the button
Seat 1: s70n3fac3 (11830 in chips) 
Seat 2: FDIBA2009 (6794 in chips) 
s70n3fac3: posts small blind 50
FDIBA2009: posts big blind 100
*** HOLE CARDS ***
s70n3fac3: calls 50
FDIBA2009: checks 
*** FLOP *** [9h Jd Qc]
FDIBA2009: checks 
s70n3fac3: checks 
*** TURN *** [9h Jd Qc] [2h]
FDIBA2009: bets 100
s70n3fac3: calls 100
*** RIVER *** [9h Jd Qc 2h] [4d]
FDIBA2009: checks 
s70n3fac3: checks 
*** SHOW DOWN ***
FDIBA2009: shows [Kd 2c] (a pair of Deuces)
s70n3fac3: shows [2d Ac] (a pair of Deuces - Ace kicker)
s70n3fac3 collected 378 from pot
*** SUMMARY ***
Total pot 400 | Rake 22 
Board [9h Jd Qc 2h 4d]
Seat 1: s70n3fac3 (button) (small blind) showed [2d Ac] and won (378) with a pair of Deuces
Seat 2: FDIBA2009 (big blind) showed [Kd 2c] and lost with a pair of Deuces



PokerStars Home Game Hand #226819489032: {Club #4781089}  Hold'em No Limit (50/100) - 2021/05/16 23:57:31 EET [2021/05/16 16:57:31 ET]
Table 'VTPP NLHE 1605' 2-max (Play Money) Seat #2 is the button
Seat 1: s70n3fac3 (12008 in chips) 
Seat 2: FDIBA2009 (6594 in chips) 
FDIBA2009: posts small blind 50
s70n3fac3: posts big blind 100
*** HOLE CARDS ***
FDIBA2009: raises 100 to 200
s70n3fac3: calls 100
*** FLOP *** [9s 5c 2d]
s70n3fac3: checks 
FDIBA2009: bets 378
s70n3fac3: folds 
Uncalled bet (378) returned to FDIBA2009
FDIBA2009 collected 378 from pot
*** SUMMARY ***
Total pot 400 | Rake 22 
Board [9s 5c 2d]
Seat 1: s70n3fac3 (big blind) folded on the Flop
Seat 2: FDIBA2009 (button) (small blind) collected (378)



PokerStars Home Game Hand #226819493698: {Club #4781089}  Hold'em No Limit (50/100) - 2021/05/16 23:57:44 EET [2021/05/16 16:57:44 ET]
Table 'VTPP NLHE 1605' 2-max (Play Money) Seat #1 is the button
Seat 1: s70n3fac3 (11808 in chips) 
Seat 2: FDIBA2009 (6772 in chips) 
s70n3fac3: posts small blind 50
FDIBA2009: posts big blind 100
*** HOLE CARDS ***
s70n3fac3: folds 
Uncalled bet (50) returned to FDIBA2009
FDIBA2009 collected 100 from pot
*** SUMMARY ***
Total pot 100 | Rake 0 
Seat 1: s70n3fac3 (button) (small blind) folded before Flop
Seat 2: FDIBA2009 (big blind) collected (100)



PokerStars Home Game Hand #226819495447: {Club #4781089}  Hold'em No Limit (50/100) - 2021/05/16 23:57:48 EET [2021/05/16 16:57:48 ET]
Table 'VTPP NLHE 1605' 2-max (Play Money) Seat #2 is the button
Seat 1: s70n3fac3 (11758 in chips) 
Seat 2: FDIBA2009 (6822 in chips) 
FDIBA2009: posts small blind 50
s70n3fac3: posts big blind 100
*** HOLE CARDS ***
FDIBA2009: raises 100 to 200
s70n3fac3: calls 100
*** FLOP *** [Ah 5s As]
s70n3fac3: checks 
FDIBA2009: bets 378
s70n3fac3: folds 
Uncalled bet (378) returned to FDIBA2009
FDIBA2009 collected 378 from pot
*** SUMMARY ***
Total pot 400 | Rake 22 
Board [Ah 5s As]
Seat 1: s70n3fac3 (big blind) folded on the Flop
Seat 2: FDIBA2009 (button) (small blind) collected (378)



PokerStars Home Game Hand #226819500432: {Club #4781089}  Hold'em No Limit (50/100) - 2021/05/16 23:58:01 EET [2021/05/16 16:58:01 ET]
Table 'VTPP NLHE 1605' 2-max (Play Money) Seat #1 is the button
Seat 1: s70n3fac3 (11558 in chips) 
Seat 2: FDIBA2009 (7000 in chips) 
s70n3fac3: posts small blind 50
FDIBA2009: posts big blind 100
*** HOLE CARDS ***
s70n3fac3: raises 100 to 200
FDIBA2009: folds 
Uncalled bet (100) returned to s70n3fac3
s70n3fac3 collected 200 from pot
s70n3fac3: doesn't show hand 
*** SUMMARY ***
Total pot 200 | Rake 0 
Seat 1: s70n3fac3 (button) (small blind) collected (200)
Seat 2: FDIBA2009 (big blind) folded before Flop



PokerStars Home Game Hand #226819502497: {Club #4781089}  Hold'em No Limit (50/100) - 2021/05/16 23:58:06 EET [2021/05/16 16:58:06 ET]
Table 'VTPP NLHE 1605' 2-max (Play Money) Seat #2 is the button
Seat 1: s70n3fac3 (11658 in chips) 
Seat 2: FDIBA2009 (6900 in chips) 
FDIBA2009: posts small blind 50
s70n3fac3: posts big blind 100
*** HOLE CARDS ***
FDIBA2009: raises 100 to 200
s70n3fac3: folds 
Uncalled bet (100) returned to FDIBA2009
FDIBA2009 collected 200 from pot
*** SUMMARY ***
Total pot 200 | Rake 0 
Seat 1: s70n3fac3 (big blind) folded before Flop
Seat 2: FDIBA2009 (button) (small blind) collected (200)



PokerStars Home Game Hand #226819504561: {Club #4781089}  Hold'em No Limit (50/100) - 2021/05/16 23:58:12 EET [2021/05/16 16:58:12 ET]
Table 'VTPP NLHE 1605' 2-max (Play Money) Seat #1 is the button
Seat 1: s70n3fac3 (11558 in chips) 
Seat 2: FDIBA2009 (7000 in chips) 
s70n3fac3: posts small blind 50
FDIBA2009: posts big blind 100
*** HOLE CARDS ***
s70n3fac3: folds 
Uncalled bet (50) returned to FDIBA2009
FDIBA2009 collected 100 from pot
*** SUMMARY ***
Total pot 100 | Rake 0 
Seat 1: s70n3fac3 (button) (small blind) folded before Flop
Seat 2: FDIBA2009 (big blind) collected (100)



PokerStars Home Game Hand #226819505946: {Club #4781089}  Hold'em No Limit (50/100) - 2021/05/16 23:58:15 EET [2021/05/16 16:58:15 ET]
Table 'VTPP NLHE 1605' 2-max (Play Money) Seat #2 is the button
Seat 1: s70n3fac3 (11508 in chips) 
Seat 2: FDIBA2009 (7050 in chips) 
FDIBA2009: posts small blind 50
s70n3fac3: posts big blind 100
*** HOLE CARDS ***
FDIBA2009: raises 100 to 200
s70n3fac3: calls 100
*** FLOP *** [7d 5h 7c]
s70n3fac3: checks 
FDIBA2009: checks 
*** TURN *** [7d 5h 7c] [5d]
s70n3fac3: checks 
FDIBA2009: bets 378
s70n3fac3: folds 
Uncalled bet (378) returned to FDIBA2009
FDIBA2009 collected 378 from pot
*** SUMMARY ***
Total pot 400 | Rake 22 
Board [7d 5h 7c 5d]
Seat 1: s70n3fac3 (big blind) folded on the Turn
Seat 2: FDIBA2009 (button) (small blind) collected (378)



PokerStars Home Game Hand #226819522611: {Club #4781089}  Hold'em No Limit (50/100) - 2021/05/16 23:58:38 EET [2021/05/16 16:58:38 ET]
Table 'VTPP NLHE 1605' 2-max (Play Money) Seat #1 is the button
Seat 1: s70n3fac3 (11308 in chips) 
Seat 2: FDIBA2009 (7228 in chips) 
s70n3fac3: posts small blind 50
FDIBA2009: posts big blind 100
*** HOLE CARDS ***
s70n3fac3: raises 100 to 200
FDIBA2009: folds 
Uncalled bet (100) returned to s70n3fac3
s70n3fac3 collected 200 from pot
s70n3fac3: doesn't show hand 
*** SUMMARY ***
Total pot 200 | Rake 0 
Seat 1: s70n3fac3 (button) (small blind) collected (200)
Seat 2: FDIBA2009 (big blind) folded before Flop



PokerStars Home Game Hand #226819525526: {Club #4781089}  Hold'em No Limit (50/100) - 2021/05/16 23:58:45 EET [2021/05/16 16:58:45 ET]
Table 'VTPP NLHE 1605' 2-max (Play Money) Seat #2 is the button
Seat 1: s70n3fac3 (11408 in chips) 
Seat 2: FDIBA2009 (7128 in chips) 
FDIBA2009: posts small blind 50
s70n3fac3: posts big blind 100
*** HOLE CARDS ***
FDIBA2009: raises 100 to 200
s70n3fac3: calls 100
*** FLOP *** [Qs 3h 5s]
s70n3fac3: checks 
FDIBA2009: bets 378
s70n3fac3: calls 378
*** TURN *** [Qs 3h 5s] [Qd]
s70n3fac3: checks 
FDIBA2009: checks 
*** RIVER *** [Qs 3h 5s Qd] [Jd]
s70n3fac3: checks 
FDIBA2009: bets 1092
s70n3fac3: calls 1092
*** SHOW DOWN ***
FDIBA2009: shows [9h 6s] (a pair of Queens)
s70n3fac3: shows [5c Ad] (two pair, Queens and Fives)
s70n3fac3 collected 3156 from pot
*** SUMMARY ***
Total pot 3340 | Rake 184 
Board [Qs 3h 5s Qd Jd]
Seat 1: s70n3fac3 (big blind) showed [5c Ad] and won (3156) with two pair, Queens and Fives
Seat 2: FDIBA2009 (button) (small blind) showed [9h 6s] and lost with a pair of Queens



PokerStars Home Game Hand #226819534247: {Club #4781089}  Hold'em No Limit (50/100) - 2021/05/16 23:59:08 EET [2021/05/16 16:59:08 ET]
Table 'VTPP NLHE 1605' 2-max (Play Money) Seat #1 is the button
Seat 1: s70n3fac3 (12894 in chips) 
Seat 2: FDIBA2009 (5458 in chips) 
s70n3fac3: posts small blind 50
FDIBA2009: posts big blind 100
*** HOLE CARDS ***
s70n3fac3: raises 100 to 200
FDIBA2009: folds 
Uncalled bet (100) returned to s70n3fac3
s70n3fac3 collected 200 from pot
s70n3fac3: doesn't show hand 
*** SUMMARY ***
Total pot 200 | Rake 0 
Seat 1: s70n3fac3 (button) (small blind) collected (200)
Seat 2: FDIBA2009 (big blind) folded before Flop



PokerStars Home Game Hand #226819536439: {Club #4781089}  Hold'em No Limit (50/100) - 2021/05/16 23:59:13 EET [2021/05/16 16:59:13 ET]
Table 'VTPP NLHE 1605' 2-max (Play Money) Seat #2 is the button
Seat 1: s70n3fac3 (12994 in chips) 
Seat 2: FDIBA2009 (5358 in chips) 
FDIBA2009: posts small blind 50
s70n3fac3: posts big blind 100
*** HOLE CARDS ***
FDIBA2009: raises 200 to 300
s70n3fac3: folds 
Uncalled bet (200) returned to FDIBA2009
FDIBA2009 collected 200 from pot
*** SUMMARY ***
Total pot 200 | Rake 0 
Seat 1: s70n3fac3 (big blind) folded before Flop
Seat 2: FDIBA2009 (button) (small blind) collected (200)



PokerStars Home Game Hand #226819540051: {Club #4781089}  Hold'em No Limit (50/100) - 2021/05/16 23:59:22 EET [2021/05/16 16:59:22 ET]
Table 'VTPP NLHE 1605' 2-max (Play Money) Seat #1 is the button
Seat 1: s70n3fac3 (12894 in chips) 
Seat 2: FDIBA2009 (5458 in chips) 
s70n3fac3: posts small blind 50
FDIBA2009: posts big blind 100
*** HOLE CARDS ***
s70n3fac3: raises 100 to 200
FDIBA2009: raises 400 to 600
s70n3fac3: calls 400
*** FLOP *** [Kd Jh 8s]
FDIBA2009: checks 
s70n3fac3: checks 
*** TURN *** [Kd Jh 8s] [9c]
FDIBA2009: bets 567
s70n3fac3: folds 
Uncalled bet (567) returned to FDIBA2009
FDIBA2009 collected 1134 from pot
*** SUMMARY ***
Total pot 1200 | Rake 66 
Board [Kd Jh 8s 9c]
Seat 1: s70n3fac3 (button) (small blind) folded on the Turn
Seat 2: FDIBA2009 (big blind) collected (1134)



PokerStars Home Game Hand #226819547178: {Club #4781089}  Hold'em No Limit (50/100) - 2021/05/16 23:59:41 EET [2021/05/16 16:59:41 ET]
Table 'VTPP NLHE 1605' 2-max (Play Money) Seat #2 is the button
Seat 1: s70n3fac3 (12294 in chips) 
Seat 2: FDIBA2009 (5992 in chips) 
FDIBA2009: posts small blind 50
s70n3fac3: posts big blind 100
*** HOLE CARDS ***
FDIBA2009: raises 100 to 200
s70n3fac3: calls 100
*** FLOP *** [9h 9c Kd]
s70n3fac3: checks 
FDIBA2009: bets 189
s70n3fac3: folds 
Uncalled bet (189) returned to FDIBA2009
FDIBA2009 collected 378 from pot
*** SUMMARY ***
Total pot 400 | Rake 22 
Board [9h 9c Kd]
Seat 1: s70n3fac3 (big blind) folded on the Flop
Seat 2: FDIBA2009 (button) (small blind) collected (378)



PokerStars Home Game Hand #226819551817: {Club #4781089}  Hold'em No Limit (50/100) - 2021/05/16 23:59:53 EET [2021/05/16 16:59:53 ET]
Table 'VTPP NLHE 1605' 2-max (Play Money) Seat #1 is the button
Seat 1: s70n3fac3 (12094 in chips) 
Seat 2: FDIBA2009 (6170 in chips) 
s70n3fac3: posts small blind 50
FDIBA2009: posts big blind 100
*** HOLE CARDS ***
s70n3fac3: raises 100 to 200
FDIBA2009: calls 100
*** FLOP *** [7d 4d 8h]
FDIBA2009: checks 
s70n3fac3: bets 200
FDIBA2009: calls 200
*** TURN *** [7d 4d 8h] [8c]
FDIBA2009: checks 
s70n3fac3: bets 400
FDIBA2009: calls 400
*** RIVER *** [7d 4d 8h 8c] [Qc]
FDIBA2009: bets 500
s70n3fac3: calls 500
*** SHOW DOWN ***
FDIBA2009: shows [4h Th] (two pair, Eights and Fours)
s70n3fac3: shows [Jd Jc] (two pair, Jacks and Eights)
s70n3fac3 collected 2457 from pot
*** SUMMARY ***
Total pot 2600 | Rake 143 
Board [7d 4d 8h 8c Qc]
Seat 1: s70n3fac3 (button) (small blind) showed [Jd Jc] and won (2457) with two pair, Jacks and Eights
Seat 2: FDIBA2009 (big blind) showed [4h Th] and lost with two pair, Eights and Fours



PokerStars Home Game Hand #226819562449: {Club #4781089}  Hold'em No Limit (50/100) - 2021/05/17 0:00:18 EET [2021/05/16 17:00:18 ET]
Table 'VTPP NLHE 1605' 2-max (Play Money) Seat #2 is the button
Seat 1: s70n3fac3 (13251 in chips) 
Seat 2: FDIBA2009 (4870 in chips) 
FDIBA2009: posts small blind 50
s70n3fac3: posts big blind 100
*** HOLE CARDS ***
FDIBA2009: raises 100 to 200
s70n3fac3: calls 100
*** FLOP *** [9s 8s Jd]
s70n3fac3: checks 
FDIBA2009: bets 378
s70n3fac3: folds 
Uncalled bet (378) returned to FDIBA2009
FDIBA2009 collected 378 from pot
*** SUMMARY ***
Total pot 400 | Rake 22 
Board [9s 8s Jd]
Seat 1: s70n3fac3 (big blind) folded on the Flop
Seat 2: FDIBA2009 (button) (small blind) collected (378)



PokerStars Home Game Hand #226819569132: {Club #4781089}  Hold'em No Limit (50/100) - 2021/05/17 0:00:34 EET [2021/05/16 17:00:34 ET]
Table 'VTPP NLHE 1605' 2-max (Play Money) Seat #1 is the button
Seat 1: s70n3fac3 (13051 in chips) 
Seat 2: FDIBA2009 (5048 in chips) 
s70n3fac3: posts small blind 50
FDIBA2009: posts big blind 100
*** HOLE CARDS ***
s70n3fac3: raises 100 to 200
FDIBA2009: raises 600 to 800
s70n3fac3: folds 
Uncalled bet (600) returned to FDIBA2009
FDIBA2009 collected 400 from pot
*** SUMMARY ***
Total pot 400 | Rake 0 
Seat 1: s70n3fac3 (button) (small blind) folded before Flop
Seat 2: FDIBA2009 (big blind) collected (400)



PokerStars Home Game Hand #226819572863: {Club #4781089}  Hold'em No Limit (50/100) - 2021/05/17 0:00:43 EET [2021/05/16 17:00:43 ET]
Table 'VTPP NLHE 1605' 2-max (Play Money) Seat #2 is the button
Seat 1: s70n3fac3 (12851 in chips) 
Seat 2: FDIBA2009 (5248 in chips) 
FDIBA2009: posts small blind 50
s70n3fac3: posts big blind 100
*** HOLE CARDS ***
FDIBA2009: raises 100 to 200
s70n3fac3: calls 100
*** FLOP *** [Qh 7h 5d]
s70n3fac3: checks 
FDIBA2009: checks 
*** TURN *** [Qh 7h 5d] [Qd]
s70n3fac3: checks 
FDIBA2009: checks 
*** RIVER *** [Qh 7h 5d Qd] [8d]
s70n3fac3: checks 
FDIBA2009: bets 500
s70n3fac3: folds 
Uncalled bet (500) returned to FDIBA2009
FDIBA2009 collected 378 from pot
*** SUMMARY ***
Total pot 400 | Rake 22 
Board [Qh 7h 5d Qd 8d]
Seat 1: s70n3fac3 (big blind) folded on the River
Seat 2: FDIBA2009 (button) (small blind) collected (378)



PokerStars Home Game Hand #226819581007: {Club #4781089}  Hold'em No Limit (50/100) - 2021/05/17 0:01:01 EET [2021/05/16 17:01:01 ET]
Table 'VTPP NLHE 1605' 2-max (Play Money) Seat #1 is the button
Seat 1: s70n3fac3 (12651 in chips) 
Seat 2: FDIBA2009 (5426 in chips) 
s70n3fac3: posts small blind 50
FDIBA2009: posts big blind 100
*** HOLE CARDS ***
s70n3fac3: raises 100 to 200
FDIBA2009: calls 100
*** FLOP *** [7s Ah 7h]
FDIBA2009: checks 
s70n3fac3: bets 200
FDIBA2009: folds 
Uncalled bet (200) returned to s70n3fac3
s70n3fac3 collected 378 from pot
s70n3fac3: doesn't show hand 
*** SUMMARY ***
Total pot 400 | Rake 22 
Board [7s Ah 7h]
Seat 1: s70n3fac3 (button) (small blind) collected (378)
Seat 2: FDIBA2009 (big blind) folded on the Flop



PokerStars Home Game Hand #226819586014: {Club #4781089}  Hold'em No Limit (50/100) - 2021/05/17 0:01:12 EET [2021/05/16 17:01:12 ET]
Table 'VTPP NLHE 1605' 2-max (Play Money) Seat #2 is the button
Seat 1: s70n3fac3 (12829 in chips) 
Seat 2: FDIBA2009 (5226 in chips) 
FDIBA2009: posts small blind 50
s70n3fac3: posts big blind 100
*** HOLE CARDS ***
FDIBA2009: raises 100 to 200
s70n3fac3: folds 
Uncalled bet (100) returned to FDIBA2009
FDIBA2009 collected 200 from pot
*** SUMMARY ***
Total pot 200 | Rake 0 
Seat 1: s70n3fac3 (big blind) folded before Flop
Seat 2: FDIBA2009 (button) (small blind) collected (200)



PokerStars Home Game Hand #226819588585: {Club #4781089}  Hold'em No Limit (50/100) - 2021/05/17 0:01:17 EET [2021/05/16 17:01:17 ET]
Table 'VTPP NLHE 1605' 2-max (Play Money) Seat #1 is the button
Seat 1: s70n3fac3 (12729 in chips) 
Seat 2: FDIBA2009 (5326 in chips) 
s70n3fac3: posts small blind 50
FDIBA2009: posts big blind 100
*** HOLE CARDS ***
s70n3fac3: raises 150 to 250
FDIBA2009: folds 
Uncalled bet (150) returned to s70n3fac3
s70n3fac3 collected 200 from pot
s70n3fac3: doesn't show hand 
*** SUMMARY ***
Total pot 200 | Rake 0 
Seat 1: s70n3fac3 (button) (small blind) collected (200)
Seat 2: FDIBA2009 (big blind) folded before Flop



PokerStars Home Game Hand #226819591419: {Club #4781089}  Hold'em No Limit (50/100) - 2021/05/17 0:01:23 EET [2021/05/16 17:01:23 ET]
Table 'VTPP NLHE 1605' 2-max (Play Money) Seat #2 is the button
Seat 1: s70n3fac3 (12829 in chips) 
Seat 2: FDIBA2009 (5226 in chips) 
FDIBA2009: posts small blind 50
s70n3fac3: posts big blind 100
*** HOLE CARDS ***
FDIBA2009: raises 100 to 200
s70n3fac3: calls 100
*** FLOP *** [6h Jd 6d]
s70n3fac3: checks 
FDIBA2009: checks 
*** TURN *** [6h Jd 6d] [Jh]
s70n3fac3: checks 
FDIBA2009: checks 
*** RIVER *** [6h Jd 6d Jh] [Js]
s70n3fac3: checks 
FDIBA2009: bets 378
s70n3fac3: calls 378
*** SHOW DOWN ***
FDIBA2009: shows [Qh 8s] (a full house, Jacks full of Sixes)
s70n3fac3: shows [Ts 8c] (a full house, Jacks full of Sixes)
s70n3fac3 collected 546 from pot
FDIBA2009 collected 546 from pot
*** SUMMARY ***
Total pot 1156 | Rake 64 
Board [6h Jd 6d Jh Js]
Seat 1: s70n3fac3 (big blind) showed [Ts 8c] and won (546) with a full house, Jacks full of Sixes
Seat 2: FDIBA2009 (button) (small blind) showed [Qh 8s] and won (546) with a full house, Jacks full of Sixes



PokerStars Home Game Hand #226819601008: {Club #4781089}  Hold'em No Limit (50/100) - 2021/05/17 0:01:41 EET [2021/05/16 17:01:41 ET]
Table 'VTPP NLHE 1605' 2-max (Play Money) Seat #1 is the button
Seat 1: s70n3fac3 (12797 in chips) 
Seat 2: FDIBA2009 (5194 in chips) 
s70n3fac3: posts small blind 50
FDIBA2009: posts big blind 100
*** HOLE CARDS ***
s70n3fac3: raises 100 to 200
FDIBA2009: raises 400 to 600
s70n3fac3: folds 
Uncalled bet (400) returned to FDIBA2009
FDIBA2009 collected 400 from pot
*** SUMMARY ***
Total pot 400 | Rake 0 
Seat 1: s70n3fac3 (button) (small blind) folded before Flop
Seat 2: FDIBA2009 (big blind) collected (400)



PokerStars Home Game Hand #226819605458: {Club #4781089}  Hold'em No Limit (50/100) - 2021/05/17 0:01:50 EET [2021/05/16 17:01:50 ET]
Table 'VTPP NLHE 1605' 2-max (Play Money) Seat #2 is the button
Seat 1: s70n3fac3 (12597 in chips) 
Seat 2: FDIBA2009 (5394 in chips) 
FDIBA2009: posts small blind 50
s70n3fac3: posts big blind 100
*** HOLE CARDS ***
FDIBA2009: raises 100 to 200
s70n3fac3: calls 100
*** FLOP *** [Td 7d Ac]
s70n3fac3: checks 
FDIBA2009: bets 378
s70n3fac3: folds 
Uncalled bet (378) returned to FDIBA2009
FDIBA2009 collected 378 from pot
*** SUMMARY ***
Total pot 400 | Rake 22 
Board [Td 7d Ac]
Seat 1: s70n3fac3 (big blind) folded on the Flop
Seat 2: FDIBA2009 (button) (small blind) collected (378)



PokerStars Home Game Hand #226819612158: {Club #4781089}  Hold'em No Limit (50/100) - 2021/05/17 0:02:03 EET [2021/05/16 17:02:03 ET]
Table 'VTPP NLHE 1605' 2-max (Play Money) Seat #1 is the button
Seat 1: s70n3fac3 (12397 in chips) 
Seat 2: FDIBA2009 (5572 in chips) 
s70n3fac3: posts small blind 50
FDIBA2009: posts big blind 100
*** HOLE CARDS ***
s70n3fac3: raises 100 to 200
FDIBA2009: raises 300 to 500
s70n3fac3: calls 300
*** FLOP *** [8s 5s 2h]
FDIBA2009: bets 472
s70n3fac3: calls 472
*** TURN *** [8s 5s 2h] [9h]
FDIBA2009: bets 1300
s70n3fac3: calls 1300
*** RIVER *** [8s 5s 2h 9h] [8d]
FDIBA2009: bets 2300
s70n3fac3: folds 
Uncalled bet (2300) returned to FDIBA2009
FDIBA2009 collected 4294 from pot
*** SUMMARY ***
Total pot 4544 | Rake 250 
Board [8s 5s 2h 9h 8d]
Seat 1: s70n3fac3 (button) (small blind) folded on the River
Seat 2: FDIBA2009 (big blind) collected (4294)



PokerStars Home Game Hand #226819643954: {Club #4781089}  Hold'em No Limit (50/100) - 2021/05/17 0:03:00 EET [2021/05/16 17:03:00 ET]
Table 'VTPP NLHE 1605' 2-max (Play Money) Seat #2 is the button
Seat 1: s70n3fac3 (10125 in chips) 
Seat 2: FDIBA2009 (7594 in chips) 
FDIBA2009: posts small blind 50
s70n3fac3: posts big blind 100
*** HOLE CARDS ***
FDIBA2009: raises 100 to 200
s70n3fac3: folds 
Uncalled bet (100) returned to FDIBA2009
FDIBA2009 collected 200 from pot
*** SUMMARY ***
Total pot 200 | Rake 0 
Seat 1: s70n3fac3 (big blind) folded before Flop
Seat 2: FDIBA2009 (button) (small blind) collected (200)



PokerStars Home Game Hand #226819648174: {Club #4781089}  Hold'em No Limit (50/100) - 2021/05/17 0:03:07 EET [2021/05/16 17:03:07 ET]
Table 'VTPP NLHE 1605' 2-max (Play Money) Seat #1 is the button
Seat 1: s70n3fac3 (10025 in chips) 
Seat 2: FDIBA2009 (7694 in chips) 
s70n3fac3: posts small blind 50
FDIBA2009: posts big blind 100
*** HOLE CARDS ***
s70n3fac3: raises 100 to 200
FDIBA2009: raises 400 to 600
s70n3fac3: folds 
Uncalled bet (400) returned to FDIBA2009
FDIBA2009 collected 400 from pot
*** SUMMARY ***
Total pot 400 | Rake 0 
Seat 1: s70n3fac3 (button) (small blind) folded before Flop
Seat 2: FDIBA2009 (big blind) collected (400)



PokerStars Home Game Hand #226819653545: {Club #4781089}  Hold'em No Limit (50/100) - 2021/05/17 0:03:15 EET [2021/05/16 17:03:15 ET]
Table 'VTPP NLHE 1605' 2-max (Play Money) Seat #2 is the button
Seat 1: s70n3fac3 (9825 in chips) 
Seat 2: FDIBA2009 (7894 in chips) 
FDIBA2009: posts small blind 50
s70n3fac3: posts big blind 100
*** HOLE CARDS ***
FDIBA2009: raises 100 to 200
s70n3fac3: folds 
Uncalled bet (100) returned to FDIBA2009
FDIBA2009 collected 200 from pot
*** SUMMARY ***
Total pot 200 | Rake 0 
Seat 1: s70n3fac3 (big blind) folded before Flop
Seat 2: FDIBA2009 (button) (small blind) collected (200)



PokerStars Home Game Hand #226819658925: {Club #4781089}  Hold'em No Limit (50/100) - 2021/05/17 0:03:23 EET [2021/05/16 17:03:23 ET]
Table 'VTPP NLHE 1605' 2-max (Play Money) Seat #1 is the button
Seat 1: s70n3fac3 (9725 in chips) 
Seat 2: FDIBA2009 (7994 in chips) 
s70n3fac3: posts small blind 50
FDIBA2009: posts big blind 100
*** HOLE CARDS ***
s70n3fac3: raises 150 to 250
FDIBA2009: calls 150
*** FLOP *** [8d Ad 2s]
FDIBA2009: checks 
s70n3fac3: bets 300
FDIBA2009: calls 300
*** TURN *** [8d Ad 2s] [Kh]
FDIBA2009: checks 
s70n3fac3: checks 
*** RIVER *** [8d Ad 2s Kh] [6h]
FDIBA2009: bets 400
s70n3fac3: folds 
Uncalled bet (400) returned to FDIBA2009
FDIBA2009 collected 1039 from pot
*** SUMMARY ***
Total pot 1100 | Rake 61 
Board [8d Ad 2s Kh 6h]
Seat 1: s70n3fac3 (button) (small blind) folded on the River
Seat 2: FDIBA2009 (big blind) collected (1039)



PokerStars Home Game Hand #226819676583: {Club #4781089}  Hold'em No Limit (50/100) - 2021/05/17 0:03:54 EET [2021/05/16 17:03:54 ET]
Table 'VTPP NLHE 1605' 2-max (Play Money) Seat #2 is the button
Seat 1: s70n3fac3 (9175 in chips) 
Seat 2: FDIBA2009 (8483 in chips) 
FDIBA2009: posts small blind 50
s70n3fac3: posts big blind 100
*** HOLE CARDS ***
FDIBA2009: raises 100 to 200
s70n3fac3: folds 
Uncalled bet (100) returned to FDIBA2009
FDIBA2009 collected 200 from pot
*** SUMMARY ***
Total pot 200 | Rake 0 
Seat 1: s70n3fac3 (big blind) folded before Flop
Seat 2: FDIBA2009 (button) (small blind) collected (200)



PokerStars Home Game Hand #226819679943: {Club #4781089}  Hold'em No Limit (50/100) - 2021/05/17 0:03:59 EET [2021/05/16 17:03:59 ET]
Table 'VTPP NLHE 1605' 2-max (Play Money) Seat #1 is the button
Seat 1: s70n3fac3 (9075 in chips) 
Seat 2: FDIBA2009 (8583 in chips) 
s70n3fac3: posts small blind 50
FDIBA2009: posts big blind 100
*** HOLE CARDS ***
s70n3fac3: raises 100 to 200
FDIBA2009: calls 100
*** FLOP *** [2d Qs 3d]
FDIBA2009: checks 
s70n3fac3: bets 200
FDIBA2009: folds 
Uncalled bet (200) returned to s70n3fac3
s70n3fac3 collected 378 from pot
s70n3fac3: doesn't show hand 
*** SUMMARY ***
Total pot 400 | Rake 22 
Board [2d Qs 3d]
Seat 1: s70n3fac3 (button) (small blind) collected (378)
Seat 2: FDIBA2009 (big blind) folded on the Flop



PokerStars Home Game Hand #226819687477: {Club #4781089}  Hold'em No Limit (50/100) - 2021/05/17 0:04:12 EET [2021/05/16 17:04:12 ET]
Table 'VTPP NLHE 1605' 2-max (Play Money) Seat #2 is the button
Seat 1: s70n3fac3 (9253 in chips) 
Seat 2: FDIBA2009 (8383 in chips) 
FDIBA2009: posts small blind 50
s70n3fac3: posts big blind 100
*** HOLE CARDS ***
FDIBA2009: raises 100 to 200
s70n3fac3: calls 100
*** FLOP *** [7c Kc 4d]
s70n3fac3: checks 
FDIBA2009: bets 189
s70n3fac3: calls 189
*** TURN *** [7c Kc 4d] [Qs]
s70n3fac3: checks 
FDIBA2009: checks 
*** RIVER *** [7c Kc 4d Qs] [2h]
s70n3fac3: bets 400
FDIBA2009: calls 400
*** SHOW DOWN ***
s70n3fac3: shows [5d Qd] (a pair of Queens)
FDIBA2009: mucks hand 
s70n3fac3 collected 1491 from pot
*** SUMMARY ***
Total pot 1578 | Rake 87 
Board [7c Kc 4d Qs 2h]
Seat 1: s70n3fac3 (big blind) showed [5d Qd] and won (1491) with a pair of Queens
Seat 2: FDIBA2009 (button) (small blind) mucked [8d 8h]



PokerStars Home Game Hand #226819701929: {Club #4781089}  Hold'em No Limit (50/100) - 2021/05/17 0:04:36 EET [2021/05/16 17:04:36 ET]
Table 'VTPP NLHE 1605' 2-max (Play Money) Seat #1 is the button
Seat 1: s70n3fac3 (9955 in chips) 
Seat 2: FDIBA2009 (7594 in chips) 
s70n3fac3: posts small blind 50
FDIBA2009: posts big blind 100
*** HOLE CARDS ***
s70n3fac3: folds 
Uncalled bet (50) returned to FDIBA2009
FDIBA2009 collected 100 from pot
*** SUMMARY ***
Total pot 100 | Rake 0 
Seat 1: s70n3fac3 (button) (small blind) folded before Flop
Seat 2: FDIBA2009 (big blind) collected (100)



PokerStars Home Game Hand #226819704134: {Club #4781089}  Hold'em No Limit (50/100) - 2021/05/17 0:04:40 EET [2021/05/16 17:04:40 ET]
Table 'VTPP NLHE 1605' 2-max (Play Money) Seat #2 is the button
Seat 1: s70n3fac3 (9905 in chips) 
Seat 2: FDIBA2009 (7644 in chips) 
FDIBA2009: posts small blind 50
s70n3fac3: posts big blind 100
*** HOLE CARDS ***
FDIBA2009: raises 200 to 300
s70n3fac3: folds 
Uncalled bet (200) returned to FDIBA2009
FDIBA2009 collected 200 from pot
*** SUMMARY ***
Total pot 200 | Rake 0 
Seat 1: s70n3fac3 (big blind) folded before Flop
Seat 2: FDIBA2009 (button) (small blind) collected (200)



PokerStars Home Game Hand #226819710622: {Club #4781089}  Hold'em No Limit (50/100) - 2021/05/17 0:04:47 EET [2021/05/16 17:04:47 ET]
Table 'VTPP NLHE 1605' 2-max (Play Money) Seat #1 is the button
Seat 1: s70n3fac3 (9805 in chips) 
Seat 2: FDIBA2009 (7744 in chips) 
s70n3fac3: posts small blind 50
FDIBA2009: posts big blind 100
*** HOLE CARDS ***
s70n3fac3: raises 100 to 200
FDIBA2009: raises 400 to 600
s70n3fac3: folds 
Uncalled bet (400) returned to FDIBA2009
FDIBA2009 collected 400 from pot
*** SUMMARY ***
Total pot 400 | Rake 0 
Seat 1: s70n3fac3 (button) (small blind) folded before Flop
Seat 2: FDIBA2009 (big blind) collected (400)



PokerStars Home Game Hand #226819715857: {Club #4781089}  Hold'em No Limit (50/100) - 2021/05/17 0:04:55 EET [2021/05/16 17:04:55 ET]
Table 'VTPP NLHE 1605' 2-max (Play Money) Seat #2 is the button
Seat 1: s70n3fac3 (9605 in chips) 
Seat 2: FDIBA2009 (7944 in chips) 
FDIBA2009: posts small blind 50
s70n3fac3: posts big blind 100
*** HOLE CARDS ***
FDIBA2009: raises 100 to 200
s70n3fac3: folds 
Uncalled bet (100) returned to FDIBA2009
FDIBA2009 collected 200 from pot
*** SUMMARY ***
Total pot 200 | Rake 0 
Seat 1: s70n3fac3 (big blind) folded before Flop
Seat 2: FDIBA2009 (button) (small blind) collected (200)



PokerStars Home Game Hand #226819719625: {Club #4781089}  Hold'em No Limit (50/100) - 2021/05/17 0:05:01 EET [2021/05/16 17:05:01 ET]
Table 'VTPP NLHE 1605' 2-max (Play Money) Seat #1 is the button
Seat 1: s70n3fac3 (9505 in chips) 
Seat 2: FDIBA2009 (8044 in chips) 
s70n3fac3: posts small blind 50
FDIBA2009: posts big blind 100
*** HOLE CARDS ***
s70n3fac3: folds 
Uncalled bet (50) returned to FDIBA2009
FDIBA2009 collected 100 from pot
*** SUMMARY ***
Total pot 100 | Rake 0 
Seat 1: s70n3fac3 (button) (small blind) folded before Flop
Seat 2: FDIBA2009 (big blind) collected (100)



PokerStars Home Game Hand #226819722281: {Club #4781089}  Hold'em No Limit (50/100) - 2021/05/17 0:05:05 EET [2021/05/16 17:05:05 ET]
Table 'VTPP NLHE 1605' 2-max (Play Money) Seat #2 is the button
Seat 1: s70n3fac3 (9455 in chips) 
Seat 2: FDIBA2009 (8094 in chips) 
FDIBA2009: posts small blind 50
s70n3fac3: posts big blind 100
*** HOLE CARDS ***
FDIBA2009: raises 100 to 200
s70n3fac3: folds 
Uncalled bet (100) returned to FDIBA2009
FDIBA2009 collected 200 from pot
*** SUMMARY ***
Total pot 200 | Rake 0 
Seat 1: s70n3fac3 (big blind) folded before Flop
Seat 2: FDIBA2009 (button) (small blind) collected (200)



PokerStars Home Game Hand #226819732324: {Club #4781089}  Hold'em No Limit (50/100) - 2021/05/17 0:05:12 EET [2021/05/16 17:05:12 ET]
Table 'VTPP NLHE 1605' 2-max (Play Money) Seat #1 is the button
Seat 1: s70n3fac3 (9355 in chips) 
Seat 2: FDIBA2009 (8194 in chips) 
s70n3fac3: posts small blind 50
FDIBA2009: posts big blind 100
*** HOLE CARDS ***
s70n3fac3: raises 100 to 200
FDIBA2009: calls 100
*** FLOP *** [6s 9c Kh]
FDIBA2009: checks 
s70n3fac3: bets 200
FDIBA2009: folds 
Uncalled bet (200) returned to s70n3fac3
s70n3fac3 collected 378 from pot
s70n3fac3: doesn't show hand 
*** SUMMARY ***
Total pot 400 | Rake 22 
Board [6s 9c Kh]
Seat 1: s70n3fac3 (button) (small blind) collected (378)
Seat 2: FDIBA2009 (big blind) folded on the Flop



PokerStars Home Game Hand #226819738839: {Club #4781089}  Hold'em No Limit (50/100) - 2021/05/17 0:05:23 EET [2021/05/16 17:05:23 ET]
Table 'VTPP NLHE 1605' 2-max (Play Money) Seat #2 is the button
Seat 1: s70n3fac3 (9533 in chips) 
Seat 2: FDIBA2009 (7994 in chips) 
FDIBA2009: posts small blind 50
s70n3fac3: posts big blind 100
*** HOLE CARDS ***
FDIBA2009: raises 100 to 200
s70n3fac3: folds 
Uncalled bet (100) returned to FDIBA2009
FDIBA2009 collected 200 from pot
*** SUMMARY ***
Total pot 200 | Rake 0 
Seat 1: s70n3fac3 (big blind) folded before Flop
Seat 2: FDIBA2009 (button) (small blind) collected (200)



PokerStars Home Game Hand #226819742045: {Club #4781089}  Hold'em No Limit (50/100) - 2021/05/17 0:05:28 EET [2021/05/16 17:05:28 ET]
Table 'VTPP NLHE 1605' 2-max (Play Money) Seat #1 is the button
Seat 1: s70n3fac3 (9433 in chips) 
Seat 2: FDIBA2009 (8094 in chips) 
s70n3fac3: posts small blind 50
FDIBA2009: posts big blind 100
*** HOLE CARDS ***
s70n3fac3: calls 50
FDIBA2009: checks 
*** FLOP *** [7s 2c 4c]
FDIBA2009: checks 
s70n3fac3: checks 
*** TURN *** [7s 2c 4c] [5c]
FDIBA2009: bets 189
s70n3fac3: folds 
Uncalled bet (189) returned to FDIBA2009
FDIBA2009 collected 189 from pot
*** SUMMARY ***
Total pot 200 | Rake 11 
Board [7s 2c 4c 5c]
Seat 1: s70n3fac3 (button) (small blind) folded on the Turn
Seat 2: FDIBA2009 (big blind) collected (189)



PokerStars Home Game Hand #226819751972: {Club #4781089}  Hold'em No Limit (50/100) - 2021/05/17 0:05:45 EET [2021/05/16 17:05:45 ET]
Table 'VTPP NLHE 1605' 2-max (Play Money) Seat #2 is the button
Seat 1: s70n3fac3 (9333 in chips) 
Seat 2: FDIBA2009 (8183 in chips) 
FDIBA2009: posts small blind 50
s70n3fac3: posts big blind 100
*** HOLE CARDS ***
FDIBA2009: raises 100 to 200
s70n3fac3: folds 
Uncalled bet (100) returned to FDIBA2009
FDIBA2009 collected 200 from pot
*** SUMMARY ***
Total pot 200 | Rake 0 
Seat 1: s70n3fac3 (big blind) folded before Flop
Seat 2: FDIBA2009 (button) (small blind) collected (200)



PokerStars Home Game Hand #226819755876: {Club #4781089}  Hold'em No Limit (50/100) - 2021/05/17 0:05:51 EET [2021/05/16 17:05:51 ET]
Table 'VTPP NLHE 1605' 2-max (Play Money) Seat #1 is the button
Seat 1: s70n3fac3 (9233 in chips) 
Seat 2: FDIBA2009 (8283 in chips) 
s70n3fac3: posts small blind 50
FDIBA2009: posts big blind 100
*** HOLE CARDS ***
s70n3fac3: folds 
Uncalled bet (50) returned to FDIBA2009
FDIBA2009 collected 100 from pot
*** SUMMARY ***
Total pot 100 | Rake 0 
Seat 1: s70n3fac3 (button) (small blind) folded before Flop
Seat 2: FDIBA2009 (big blind) collected (100)



PokerStars Home Game Hand #226819758270: {Club #4781089}  Hold'em No Limit (50/100) - 2021/05/17 0:05:55 EET [2021/05/16 17:05:55 ET]
Table 'VTPP NLHE 1605' 2-max (Play Money) Seat #2 is the button
Seat 1: s70n3fac3 (9183 in chips) 
Seat 2: FDIBA2009 (8333 in chips) 
FDIBA2009: posts small blind 50
s70n3fac3: posts big blind 100
*** HOLE CARDS ***
FDIBA2009: raises 100 to 200
s70n3fac3: calls 100
*** FLOP *** [3d 5c 3c]
s70n3fac3: checks 
FDIBA2009: bets 378
s70n3fac3: calls 378
*** TURN *** [3d 5c 3c] [8d]
s70n3fac3: checks 
FDIBA2009: checks 
*** RIVER *** [3d 5c 3c 8d] [Kh]
s70n3fac3: checks 
FDIBA2009: checks 
*** SHOW DOWN ***
s70n3fac3: shows [7d Ad] (a pair of Threes)
FDIBA2009: mucks hand 
s70n3fac3 collected 1092 from pot
*** SUMMARY ***
Total pot 1156 | Rake 64 
Board [3d 5c 3c 8d Kh]
Seat 1: s70n3fac3 (big blind) showed [7d Ad] and won (1092) with a pair of Threes
Seat 2: FDIBA2009 (button) (small blind) mucked [4c 9c]



PokerStars Home Game Hand #226819771564: {Club #4781089}  Hold'em No Limit (50/100) - 2021/05/17 0:06:17 EET [2021/05/16 17:06:17 ET]
Table 'VTPP NLHE 1605' 2-max (Play Money) Seat #1 is the button
Seat 1: s70n3fac3 (9697 in chips) 
Seat 2: FDIBA2009 (7755 in chips) 
s70n3fac3: posts small blind 50
FDIBA2009: posts big blind 100
*** HOLE CARDS ***
s70n3fac3: raises 100 to 200
FDIBA2009: calls 100
*** FLOP *** [4h 7c 2h]
FDIBA2009: checks 
s70n3fac3: bets 200
FDIBA2009: folds 
Uncalled bet (200) returned to s70n3fac3
s70n3fac3 collected 378 from pot
s70n3fac3: doesn't show hand 
*** SUMMARY ***
Total pot 400 | Rake 22 
Board [4h 7c 2h]
Seat 1: s70n3fac3 (button) (small blind) collected (378)
Seat 2: FDIBA2009 (big blind) folded on the Flop



PokerStars Home Game Hand #226819780143: {Club #4781089}  Hold'em No Limit (50/100) - 2021/05/17 0:06:31 EET [2021/05/16 17:06:31 ET]
Table 'VTPP NLHE 1605' 2-max (Play Money) Seat #2 is the button
Seat 1: s70n3fac3 (9875 in chips) 
Seat 2: FDIBA2009 (7555 in chips) 
FDIBA2009: posts small blind 50
s70n3fac3: posts big blind 100
*** HOLE CARDS ***
FDIBA2009: raises 100 to 200
s70n3fac3: calls 100
*** FLOP *** [5c 4h 4c]
s70n3fac3: checks 
FDIBA2009: checks 
*** TURN *** [5c 4h 4c] [2h]
s70n3fac3: bets 200
FDIBA2009: calls 200
*** RIVER *** [5c 4h 4c 2h] [8s]
s70n3fac3: bets 400
FDIBA2009: folds 
Uncalled bet (400) returned to s70n3fac3
s70n3fac3 collected 756 from pot
s70n3fac3: doesn't show hand 
*** SUMMARY ***
Total pot 800 | Rake 44 
Board [5c 4h 4c 2h 8s]
Seat 1: s70n3fac3 (big blind) collected (756)
Seat 2: FDIBA2009 (button) (small blind) folded on the River



PokerStars Home Game Hand #226819795777: {Club #4781089}  Hold'em No Limit (50/100) - 2021/05/17 0:06:56 EET [2021/05/16 17:06:56 ET]
Table 'VTPP NLHE 1605' 2-max (Play Money) Seat #1 is the button
Seat 1: s70n3fac3 (10231 in chips) 
Seat 2: FDIBA2009 (7155 in chips) 
s70n3fac3: posts small blind 50
FDIBA2009: posts big blind 100
*** HOLE CARDS ***
s70n3fac3: raises 100 to 200
FDIBA2009: calls 100
*** FLOP *** [Ac Qs Th]
FDIBA2009: checks 
s70n3fac3: bets 200
FDIBA2009: calls 200
*** TURN *** [Ac Qs Th] [5s]
FDIBA2009: checks 
s70n3fac3: bets 400
FDIBA2009: raises 600 to 1000
s70n3fac3: calls 600
*** RIVER *** [Ac Qs Th 5s] [6d]
FDIBA2009: bets 2500
s70n3fac3: folds 
Uncalled bet (2500) returned to FDIBA2009
FDIBA2009 collected 2646 from pot
*** SUMMARY ***
Total pot 2800 | Rake 154 
Board [Ac Qs Th 5s 6d]
Seat 1: s70n3fac3 (button) (small blind) folded on the River
Seat 2: FDIBA2009 (big blind) collected (2646)



PokerStars Home Game Hand #226819831266: {Club #4781089}  Hold'em No Limit (50/100) - 2021/05/17 0:07:55 EET [2021/05/16 17:07:55 ET]
Table 'VTPP NLHE 1605' 2-max (Play Money) Seat #2 is the button
Seat 1: s70n3fac3 (8831 in chips) 
Seat 2: FDIBA2009 (8401 in chips) 
FDIBA2009: posts small blind 50
s70n3fac3: posts big blind 100
*** HOLE CARDS ***
FDIBA2009: raises 100 to 200
s70n3fac3: calls 100
*** FLOP *** [9h 4s 8s]
s70n3fac3: checks 
FDIBA2009: checks 
*** TURN *** [9h 4s 8s] [3c]
s70n3fac3: checks 
FDIBA2009: bets 200
s70n3fac3: calls 200
*** RIVER *** [9h 4s 8s 3c] [Th]
s70n3fac3: checks 
FDIBA2009: bets 756
s70n3fac3: folds 
Uncalled bet (756) returned to FDIBA2009
FDIBA2009 collected 756 from pot
*** SUMMARY ***
Total pot 800 | Rake 44 
Board [9h 4s 8s 3c Th]
Seat 1: s70n3fac3 (big blind) folded on the River
Seat 2: FDIBA2009 (button) (small blind) collected (756)



PokerStars Home Game Hand #226819845979: {Club #4781089}  Hold'em No Limit (50/100) - 2021/05/17 0:08:20 EET [2021/05/16 17:08:20 ET]
Table 'VTPP NLHE 1605' 2-max (Play Money) Seat #1 is the button
Seat 1: s70n3fac3 (8431 in chips) 
Seat 2: FDIBA2009 (8757 in chips) 
s70n3fac3: posts small blind 50
FDIBA2009: posts big blind 100
*** HOLE CARDS ***
s70n3fac3: raises 100 to 200
FDIBA2009: calls 100
*** FLOP *** [3c 9d Js]
FDIBA2009: checks 
s70n3fac3: bets 200
FDIBA2009: calls 200
*** TURN *** [3c 9d Js] [Ah]
FDIBA2009: checks 
s70n3fac3: bets 400
FDIBA2009: folds 
Uncalled bet (400) returned to s70n3fac3
s70n3fac3 collected 756 from pot
s70n3fac3: doesn't show hand 
*** SUMMARY ***
Total pot 800 | Rake 44 
Board [3c 9d Js Ah]
Seat 1: s70n3fac3 (button) (small blind) collected (756)
Seat 2: FDIBA2009 (big blind) folded on the Turn



PokerStars Home Game Hand #226819857080: {Club #4781089}  Hold'em No Limit (50/100) - 2021/05/17 0:08:38 EET [2021/05/16 17:08:38 ET]
Table 'VTPP NLHE 1605' 2-max (Play Money) Seat #2 is the button
Seat 1: s70n3fac3 (8787 in chips) 
Seat 2: FDIBA2009 (8357 in chips) 
FDIBA2009: posts small blind 50
s70n3fac3: posts big blind 100
*** HOLE CARDS ***
FDIBA2009: raises 100 to 200
s70n3fac3: calls 100
*** FLOP *** [Ac 2d 5s]
s70n3fac3: checks 
FDIBA2009: bets 378
s70n3fac3: folds 
Uncalled bet (378) returned to FDIBA2009
FDIBA2009 collected 378 from pot
*** SUMMARY ***
Total pot 400 | Rake 22 
Board [Ac 2d 5s]
Seat 1: s70n3fac3 (big blind) folded on the Flop
Seat 2: FDIBA2009 (button) (small blind) collected (378)



PokerStars Home Game Hand #226819863500: {Club #4781089}  Hold'em No Limit (50/100) - 2021/05/17 0:08:49 EET [2021/05/16 17:08:49 ET]
Table 'VTPP NLHE 1605' 2-max (Play Money) Seat #1 is the button
Seat 1: s70n3fac3 (8587 in chips) 
Seat 2: FDIBA2009 (8535 in chips) 
s70n3fac3: posts small blind 50
FDIBA2009: posts big blind 100
*** HOLE CARDS ***
s70n3fac3: calls 50
FDIBA2009: checks 
*** FLOP *** [3h Kd Ac]
FDIBA2009: checks 
s70n3fac3: checks 
*** TURN *** [3h Kd Ac] [Td]
FDIBA2009: checks 
s70n3fac3: bets 100
FDIBA2009: raises 200 to 300
s70n3fac3: calls 200
*** RIVER *** [3h Kd Ac Td] [Ad]
FDIBA2009: bets 400
s70n3fac3: calls 400
*** SHOW DOWN ***
FDIBA2009: shows [Jh Ks] (two pair, Aces and Kings)
s70n3fac3: mucks hand 
FDIBA2009 collected 1512 from pot
*** SUMMARY ***
Total pot 1600 | Rake 88 
Board [3h Kd Ac Td Ad]
Seat 1: s70n3fac3 (button) (small blind) mucked [Qs 8d]
Seat 2: FDIBA2009 (big blind) showed [Jh Ks] and won (1512) with two pair, Aces and Kings



PokerStars Home Game Hand #226819882226: {Club #4781089}  Hold'em No Limit (50/100) - 2021/05/17 0:09:20 EET [2021/05/16 17:09:20 ET]
Table 'VTPP NLHE 1605' 2-max (Play Money) Seat #2 is the button
Seat 1: s70n3fac3 (7787 in chips) 
Seat 2: FDIBA2009 (9247 in chips) 
FDIBA2009: posts small blind 50
s70n3fac3: posts big blind 100
*** HOLE CARDS ***
FDIBA2009: raises 100 to 200
s70n3fac3: calls 100
*** FLOP *** [6d 5c 4s]
s70n3fac3: checks 
FDIBA2009: checks 
*** TURN *** [6d 5c 4s] [6s]
s70n3fac3: bets 200
FDIBA2009: calls 200
*** RIVER *** [6d 5c 4s 6s] [Th]
s70n3fac3: checks 
FDIBA2009: checks 
*** SHOW DOWN ***
s70n3fac3: shows [2d 5d] (two pair, Sixes and Fives)
FDIBA2009: mucks hand 
s70n3fac3 collected 756 from pot
*** SUMMARY ***
Total pot 800 | Rake 44 
Board [6d 5c 4s 6s Th]
Seat 1: s70n3fac3 (big blind) showed [2d 5d] and won (756) with two pair, Sixes and Fives
Seat 2: FDIBA2009 (button) (small blind) mucked [4h 9c]



PokerStars Home Game Hand #226819897190: {Club #4781089}  Hold'em No Limit (50/100) - 2021/05/17 0:09:45 EET [2021/05/16 17:09:45 ET]
Table 'VTPP NLHE 1605' 2-max (Play Money) Seat #1 is the button
Seat 1: s70n3fac3 (8143 in chips) 
Seat 2: FDIBA2009 (8847 in chips) 
s70n3fac3: posts small blind 50
FDIBA2009: posts big blind 100
*** HOLE CARDS ***
s70n3fac3: raises 100 to 200
FDIBA2009: calls 100
*** FLOP *** [3h Kc 2c]
FDIBA2009: checks 
s70n3fac3: bets 200
FDIBA2009: raises 400 to 600
s70n3fac3: calls 400
*** TURN *** [3h Kc 2c] [6d]
FDIBA2009: bets 1000
s70n3fac3: calls 1000
*** RIVER *** [3h Kc 2c 6d] [Th]
FDIBA2009: bets 3402
s70n3fac3: calls 3402
*** SHOW DOWN ***
FDIBA2009: shows [3s 4c] (a pair of Threes)
s70n3fac3: shows [Jh Kd] (a pair of Kings)
s70n3fac3 collected 9832 from pot
*** SUMMARY ***
Total pot 10404 | Rake 572 
Board [3h Kc 2c 6d Th]
Seat 1: s70n3fac3 (button) (small blind) showed [Jh Kd] and won (9832) with a pair of Kings
Seat 2: FDIBA2009 (big blind) showed [3s 4c] and lost with a pair of Threes



PokerStars Home Game Hand #226819921925: {Club #4781089}  Hold'em No Limit (50/100) - 2021/05/17 0:10:25 EET [2021/05/16 17:10:25 ET]
Table 'VTPP NLHE 1605' 2-max (Play Money) Seat #2 is the button
Seat 1: s70n3fac3 (12773 in chips) 
Seat 2: FDIBA2009 (3645 in chips) 
FDIBA2009: posts small blind 50
s70n3fac3: posts big blind 100
*** HOLE CARDS ***
FDIBA2009: raises 100 to 200
s70n3fac3: raises 500 to 700
FDIBA2009: folds 
Uncalled bet (500) returned to s70n3fac3
s70n3fac3 collected 400 from pot
s70n3fac3: doesn't show hand 
*** SUMMARY ***
Total pot 400 | Rake 0 
Seat 1: s70n3fac3 (big blind) collected (400)
Seat 2: FDIBA2009 (button) (small blind) folded before Flop



PokerStars Home Game Hand #226819927436: {Club #4781089}  Hold'em No Limit (50/100) - 2021/05/17 0:10:35 EET [2021/05/16 17:10:35 ET]
Table 'VTPP NLHE 1605' 2-max (Play Money) Seat #1 is the button
Seat 1: s70n3fac3 (12973 in chips) 
Seat 2: FDIBA2009 (3445 in chips) 
s70n3fac3: posts small blind 50
FDIBA2009: posts big blind 100
*** HOLE CARDS ***
s70n3fac3: folds 
Uncalled bet (50) returned to FDIBA2009
FDIBA2009 collected 100 from pot
*** SUMMARY ***
Total pot 100 | Rake 0 
Seat 1: s70n3fac3 (button) (small blind) folded before Flop
Seat 2: FDIBA2009 (big blind) collected (100)



PokerStars Home Game Hand #226819929686: {Club #4781089}  Hold'em No Limit (50/100) - 2021/05/17 0:10:38 EET [2021/05/16 17:10:38 ET]
Table 'VTPP NLHE 1605' 2-max (Play Money) Seat #2 is the button
Seat 1: s70n3fac3 (12923 in chips) 
Seat 2: FDIBA2009 (3495 in chips) 
FDIBA2009: posts small blind 50
s70n3fac3: posts big blind 100
*** HOLE CARDS ***
FDIBA2009: raises 100 to 200
s70n3fac3: calls 100
*** FLOP *** [6h 4s 3c]
s70n3fac3: checks 
FDIBA2009: bets 378
s70n3fac3: folds 
Uncalled bet (378) returned to FDIBA2009
FDIBA2009 collected 378 from pot
*** SUMMARY ***
Total pot 400 | Rake 22 
Board [6h 4s 3c]
Seat 1: s70n3fac3 (big blind) folded on the Flop
Seat 2: FDIBA2009 (button) (small blind) collected (378)



PokerStars Home Game Hand #226819936415: {Club #4781089}  Hold'em No Limit (50/100) - 2021/05/17 0:10:50 EET [2021/05/16 17:10:50 ET]
Table 'VTPP NLHE 1605' 2-max (Play Money) Seat #1 is the button
Seat 1: s70n3fac3 (12723 in chips) 
Seat 2: FDIBA2009 (3673 in chips) 
s70n3fac3: posts small blind 50
FDIBA2009: posts big blind 100
*** HOLE CARDS ***
s70n3fac3: raises 100 to 200
FDIBA2009: calls 100
*** FLOP *** [Ts 8h 7h]
FDIBA2009: checks 
s70n3fac3: checks 
*** TURN *** [Ts 8h 7h] [Jd]
FDIBA2009: bets 378
s70n3fac3: calls 378
*** RIVER *** [Ts 8h 7h Jd] [6d]
FDIBA2009: checks 
s70n3fac3: bets 600
FDIBA2009: folds 
Uncalled bet (600) returned to s70n3fac3
s70n3fac3 collected 1092 from pot
s70n3fac3: doesn't show hand 
*** SUMMARY ***
Total pot 1156 | Rake 64 
Board [Ts 8h 7h Jd 6d]
Seat 1: s70n3fac3 (button) (small blind) collected (1092)
Seat 2: FDIBA2009 (big blind) folded on the River



PokerStars Home Game Hand #226819954462: {Club #4781089}  Hold'em No Limit (50/100) - 2021/05/17 0:11:11 EET [2021/05/16 17:11:11 ET]
Table 'VTPP NLHE 1605' 2-max (Play Money) Seat #2 is the button
Seat 1: s70n3fac3 (13237 in chips) 
Seat 2: FDIBA2009 (3095 in chips) 
FDIBA2009: posts small blind 50
s70n3fac3: posts big blind 100
*** HOLE CARDS ***
FDIBA2009: raises 100 to 200
s70n3fac3: raises 500 to 700
FDIBA2009: folds 
Uncalled bet (500) returned to s70n3fac3
s70n3fac3 collected 400 from pot
s70n3fac3: doesn't show hand 
*** SUMMARY ***
Total pot 400 | Rake 0 
Seat 1: s70n3fac3 (big blind) collected (400)
Seat 2: FDIBA2009 (button) (small blind) folded before Flop



PokerStars Home Game Hand #226819959794: {Club #4781089}  Hold'em No Limit (50/100) - 2021/05/17 0:11:20 EET [2021/05/16 17:11:20 ET]
Table 'VTPP NLHE 1605' 2-max (Play Money) Seat #1 is the button
Seat 1: s70n3fac3 (13437 in chips) 
Seat 2: FDIBA2009 (2895 in chips) 
s70n3fac3: posts small blind 50
FDIBA2009: posts big blind 100
*** HOLE CARDS ***
s70n3fac3: calls 50
FDIBA2009: raises 200 to 300
s70n3fac3: calls 200
*** FLOP *** [Jh Ts 4d]
FDIBA2009: checks 
s70n3fac3: bets 300
FDIBA2009: folds 
Uncalled bet (300) returned to s70n3fac3
s70n3fac3 collected 567 from pot
s70n3fac3: doesn't show hand 
*** SUMMARY ***
Total pot 600 | Rake 33 
Board [Jh Ts 4d]
Seat 1: s70n3fac3 (button) (small blind) collected (567)
Seat 2: FDIBA2009 (big blind) folded on the Flop



PokerStars Home Game Hand #226819969147: {Club #4781089}  Hold'em No Limit (50/100) - 2021/05/17 0:11:35 EET [2021/05/16 17:11:35 ET]
Table 'VTPP NLHE 1605' 2-max (Play Money) Seat #2 is the button
Seat 1: s70n3fac3 (13704 in chips) 
Seat 2: FDIBA2009 (2595 in chips) 
FDIBA2009: posts small blind 50
s70n3fac3: posts big blind 100
*** HOLE CARDS ***
FDIBA2009: raises 100 to 200
s70n3fac3: calls 100
*** FLOP *** [8h 7h 7s]
s70n3fac3: checks 
FDIBA2009: bets 378
s70n3fac3: folds 
Uncalled bet (378) returned to FDIBA2009
FDIBA2009 collected 378 from pot
*** SUMMARY ***
Total pot 400 | Rake 22 
Board [8h 7h 7s]
Seat 1: s70n3fac3 (big blind) folded on the Flop
Seat 2: FDIBA2009 (button) (small blind) collected (378)



PokerStars Home Game Hand #226819977410: {Club #4781089}  Hold'em No Limit (50/100) - 2021/05/17 0:11:49 EET [2021/05/16 17:11:49 ET]
Table 'VTPP NLHE 1605' 2-max (Play Money) Seat #1 is the button
Seat 1: s70n3fac3 (13504 in chips) 
Seat 2: FDIBA2009 (2773 in chips) 
s70n3fac3: posts small blind 50
FDIBA2009: posts big blind 100
*** HOLE CARDS ***
s70n3fac3: raises 100 to 200
FDIBA2009: calls 100
*** FLOP *** [3c 2s 4s]
FDIBA2009: checks 
s70n3fac3: checks 
*** TURN *** [3c 2s 4s] [6h]
FDIBA2009: bets 378
s70n3fac3: folds 
Uncalled bet (378) returned to FDIBA2009
FDIBA2009 collected 378 from pot
*** SUMMARY ***
Total pot 400 | Rake 22 
Board [3c 2s 4s 6h]
Seat 1: s70n3fac3 (button) (small blind) folded on the Turn
Seat 2: FDIBA2009 (big blind) collected (378)



PokerStars Home Game Hand #226819986598: {Club #4781089}  Hold'em No Limit (50/100) - 2021/05/17 0:12:04 EET [2021/05/16 17:12:04 ET]
Table 'VTPP NLHE 1605' 2-max (Play Money) Seat #2 is the button
Seat 1: s70n3fac3 (13304 in chips) 
Seat 2: FDIBA2009 (2951 in chips) 
FDIBA2009: posts small blind 50
s70n3fac3: posts big blind 100
*** HOLE CARDS ***
FDIBA2009: raises 100 to 200
s70n3fac3: raises 500 to 700
FDIBA2009: folds 
Uncalled bet (500) returned to s70n3fac3
s70n3fac3 collected 400 from pot
s70n3fac3: doesn't show hand 
*** SUMMARY ***
Total pot 400 | Rake 0 
Seat 1: s70n3fac3 (big blind) collected (400)
Seat 2: FDIBA2009 (button) (small blind) folded before Flop



PokerStars Home Game Hand #226819991469: {Club #4781089}  Hold'em No Limit (50/100) - 2021/05/17 0:12:13 EET [2021/05/16 17:12:13 ET]
Table 'VTPP NLHE 1605' 2-max (Play Money) Seat #1 is the button
Seat 1: s70n3fac3 (13504 in chips) 
Seat 2: FDIBA2009 (2751 in chips) 
s70n3fac3: posts small blind 50
FDIBA2009: posts big blind 100
*** HOLE CARDS ***
s70n3fac3: folds 
Uncalled bet (50) returned to FDIBA2009
FDIBA2009 collected 100 from pot
*** SUMMARY ***
Total pot 100 | Rake 0 
Seat 1: s70n3fac3 (button) (small blind) folded before Flop
Seat 2: FDIBA2009 (big blind) collected (100)



PokerStars Home Game Hand #226819993766: {Club #4781089}  Hold'em No Limit (50/100) - 2021/05/17 0:12:17 EET [2021/05/16 17:12:17 ET]
Table 'VTPP NLHE 1605' 2-max (Play Money) Seat #2 is the button
Seat 1: s70n3fac3 (13454 in chips) 
Seat 2: FDIBA2009 (2801 in chips) 
FDIBA2009: posts small blind 50
s70n3fac3: posts big blind 100
*** HOLE CARDS ***
FDIBA2009: raises 100 to 200
s70n3fac3: calls 100
*** FLOP *** [5d Qs 7h]
s70n3fac3: checks 
FDIBA2009: bets 189
s70n3fac3: folds 
Uncalled bet (189) returned to FDIBA2009
FDIBA2009 collected 378 from pot
*** SUMMARY ***
Total pot 400 | Rake 22 
Board [5d Qs 7h]
Seat 1: s70n3fac3 (big blind) folded on the Flop
Seat 2: FDIBA2009 (button) (small blind) collected (378)



PokerStars Home Game Hand #226820001248: {Club #4781089}  Hold'em No Limit (50/100) - 2021/05/17 0:12:29 EET [2021/05/16 17:12:29 ET]
Table 'VTPP NLHE 1605' 2-max (Play Money) Seat #1 is the button
Seat 1: s70n3fac3 (13254 in chips) 
Seat 2: FDIBA2009 (2979 in chips) 
s70n3fac3: posts small blind 50
FDIBA2009: posts big blind 100
*** HOLE CARDS ***
s70n3fac3: folds 
Uncalled bet (50) returned to FDIBA2009
FDIBA2009 collected 100 from pot
*** SUMMARY ***
Total pot 100 | Rake 0 
Seat 1: s70n3fac3 (button) (small blind) folded before Flop
Seat 2: FDIBA2009 (big blind) collected (100)



PokerStars Home Game Hand #226820003488: {Club #4781089}  Hold'em No Limit (50/100) - 2021/05/17 0:12:33 EET [2021/05/16 17:12:33 ET]
Table 'VTPP NLHE 1605' 2-max (Play Money) Seat #2 is the button
Seat 1: s70n3fac3 (13204 in chips) 
Seat 2: FDIBA2009 (3029 in chips) 
FDIBA2009: posts small blind 50
s70n3fac3: posts big blind 100
*** HOLE CARDS ***
FDIBA2009: raises 100 to 200
s70n3fac3: calls 100
*** FLOP *** [Tc Qs 5d]
s70n3fac3: checks 
FDIBA2009: bets 378
s70n3fac3: folds 
Uncalled bet (378) returned to FDIBA2009
FDIBA2009 collected 378 from pot
*** SUMMARY ***
Total pot 400 | Rake 22 
Board [Tc Qs 5d]
Seat 1: s70n3fac3 (big blind) folded on the Flop
Seat 2: FDIBA2009 (button) (small blind) collected (378)



PokerStars Home Game Hand #226820010797: {Club #4781089}  Hold'em No Limit (50/100) - 2021/05/17 0:12:45 EET [2021/05/16 17:12:45 ET]
Table 'VTPP NLHE 1605' 2-max (Play Money) Seat #1 is the button
Seat 1: s70n3fac3 (13004 in chips) 
Seat 2: FDIBA2009 (3207 in chips) 
s70n3fac3: posts small blind 50
FDIBA2009: posts big blind 100
*** HOLE CARDS ***
s70n3fac3: raises 100 to 200
FDIBA2009: calls 100
*** FLOP *** [2s Jh Td]
FDIBA2009: checks 
s70n3fac3: bets 200
FDIBA2009: folds 
Uncalled bet (200) returned to s70n3fac3
s70n3fac3 collected 378 from pot
s70n3fac3: doesn't show hand 
*** SUMMARY ***
Total pot 400 | Rake 22 
Board [2s Jh Td]
Seat 1: s70n3fac3 (button) (small blind) collected (378)
Seat 2: FDIBA2009 (big blind) folded on the Flop



PokerStars Home Game Hand #226820017603: {Club #4781089}  Hold'em No Limit (50/100) - 2021/05/17 0:12:57 EET [2021/05/16 17:12:57 ET]
Table 'VTPP NLHE 1605' 2-max (Play Money) Seat #2 is the button
Seat 1: s70n3fac3 (13182 in chips) 
Seat 2: FDIBA2009 (3007 in chips) 
FDIBA2009: posts small blind 50
s70n3fac3: posts big blind 100
*** HOLE CARDS ***
FDIBA2009: raises 100 to 200
s70n3fac3: folds 
Uncalled bet (100) returned to FDIBA2009
FDIBA2009 collected 200 from pot
*** SUMMARY ***
Total pot 200 | Rake 0 
Seat 1: s70n3fac3 (big blind) folded before Flop
Seat 2: FDIBA2009 (button) (small blind) collected (200)



PokerStars Home Game Hand #226820021033: {Club #4781089}  Hold'em No Limit (50/100) - 2021/05/17 0:13:02 EET [2021/05/16 17:13:02 ET]
Table 'VTPP NLHE 1605' 2-max (Play Money) Seat #1 is the button
Seat 1: s70n3fac3 (13082 in chips) 
Seat 2: FDIBA2009 (3107 in chips) 
s70n3fac3: posts small blind 50
FDIBA2009: posts big blind 100
*** HOLE CARDS ***
s70n3fac3: raises 100 to 200
FDIBA2009: calls 100
*** FLOP *** [Ts 7d Jh]
FDIBA2009: checks 
s70n3fac3: bets 200
FDIBA2009: folds 
Uncalled bet (200) returned to s70n3fac3
s70n3fac3 collected 378 from pot
s70n3fac3: doesn't show hand 
*** SUMMARY ***
Total pot 400 | Rake 22 
Board [Ts 7d Jh]
Seat 1: s70n3fac3 (button) (small blind) collected (378)
Seat 2: FDIBA2009 (big blind) folded on the Flop



PokerStars Home Game Hand #226820027599: {Club #4781089}  Hold'em No Limit (50/100) - 2021/05/17 0:13:14 EET [2021/05/16 17:13:14 ET]
Table 'VTPP NLHE 1605' 2-max (Play Money) Seat #2 is the button
Seat 1: s70n3fac3 (13260 in chips) 
Seat 2: FDIBA2009 (2907 in chips) 
FDIBA2009: posts small blind 50
s70n3fac3: posts big blind 100
*** HOLE CARDS ***
FDIBA2009: raises 100 to 200
s70n3fac3: calls 100
*** FLOP *** [Kd 8d 4h]
s70n3fac3: checks 
FDIBA2009: bets 378
s70n3fac3: calls 378
*** TURN *** [Kd 8d 4h] [7c]
s70n3fac3: checks 
FDIBA2009: checks 
*** RIVER *** [Kd 8d 4h 7c] [2s]
s70n3fac3: bets 600
FDIBA2009: folds 
Uncalled bet (600) returned to s70n3fac3
s70n3fac3 collected 1092 from pot
s70n3fac3: doesn't show hand 
*** SUMMARY ***
Total pot 1156 | Rake 64 
Board [Kd 8d 4h 7c 2s]
Seat 1: s70n3fac3 (big blind) collected (1092)
Seat 2: FDIBA2009 (button) (small blind) folded on the River



PokerStars Home Game Hand #226820038585: {Club #4781089}  Hold'em No Limit (50/100) - 2021/05/17 0:13:32 EET [2021/05/16 17:13:32 ET]
Table 'VTPP NLHE 1605' 2-max (Play Money) Seat #1 is the button
Seat 1: s70n3fac3 (13774 in chips) 
Seat 2: FDIBA2009 (2329 in chips) 
s70n3fac3: posts small blind 50
FDIBA2009: posts big blind 100
*** HOLE CARDS ***
s70n3fac3: folds 
Uncalled bet (50) returned to FDIBA2009
FDIBA2009 collected 100 from pot
*** SUMMARY ***
Total pot 100 | Rake 0 
Seat 1: s70n3fac3 (button) (small blind) folded before Flop
Seat 2: FDIBA2009 (big blind) collected (100)



PokerStars Home Game Hand #226820040886: {Club #4781089}  Hold'em No Limit (50/100) - 2021/05/17 0:13:36 EET [2021/05/16 17:13:36 ET]
Table 'VTPP NLHE 1605' 2-max (Play Money) Seat #2 is the button
Seat 1: s70n3fac3 (13724 in chips) 
Seat 2: FDIBA2009 (2379 in chips) 
FDIBA2009: posts small blind 50
s70n3fac3: posts big blind 100
*** HOLE CARDS ***
FDIBA2009: raises 100 to 200
s70n3fac3: calls 100
*** FLOP *** [7d 9h Ac]
s70n3fac3: checks 
FDIBA2009: bets 378
s70n3fac3: folds 
Uncalled bet (378) returned to FDIBA2009
FDIBA2009 collected 378 from pot
*** SUMMARY ***
Total pot 400 | Rake 22 
Board [7d 9h Ac]
Seat 1: s70n3fac3 (big blind) folded on the Flop
Seat 2: FDIBA2009 (button) (small blind) collected (378)



PokerStars Home Game Hand #226820047377: {Club #4781089}  Hold'em No Limit (50/100) - 2021/05/17 0:13:47 EET [2021/05/16 17:13:47 ET]
Table 'VTPP NLHE 1605' 2-max (Play Money) Seat #1 is the button
Seat 1: s70n3fac3 (13524 in chips) 
Seat 2: FDIBA2009 (2557 in chips) 
s70n3fac3: posts small blind 50
FDIBA2009: posts big blind 100
*** HOLE CARDS ***
s70n3fac3: raises 100 to 200
FDIBA2009: folds 
Uncalled bet (100) returned to s70n3fac3
s70n3fac3 collected 200 from pot
s70n3fac3: doesn't show hand 
*** SUMMARY ***
Total pot 200 | Rake 0 
Seat 1: s70n3fac3 (button) (small blind) collected (200)
Seat 2: FDIBA2009 (big blind) folded before Flop



PokerStars Home Game Hand #226820050777: {Club #4781089}  Hold'em No Limit (50/100) - 2021/05/17 0:13:52 EET [2021/05/16 17:13:52 ET]
Table 'VTPP NLHE 1605' 2-max (Play Money) Seat #2 is the button
Seat 1: s70n3fac3 (13624 in chips) 
Seat 2: FDIBA2009 (2457 in chips) 
FDIBA2009: posts small blind 50
s70n3fac3: posts big blind 100
*** HOLE CARDS ***
FDIBA2009: raises 100 to 200
s70n3fac3: calls 100
*** FLOP *** [4d 8h Kh]
s70n3fac3: checks 
FDIBA2009: checks 
*** TURN *** [4d 8h Kh] [3c]
s70n3fac3: checks 
FDIBA2009: bets 100
s70n3fac3: calls 100
*** RIVER *** [4d 8h Kh 3c] [7h]
s70n3fac3: checks 
FDIBA2009: checks 
*** SHOW DOWN ***
s70n3fac3: shows [Ac 7s] (a pair of Sevens)
FDIBA2009: mucks hand 
s70n3fac3 collected 567 from pot
*** SUMMARY ***
Total pot 600 | Rake 33 
Board [4d 8h Kh 3c 7h]
Seat 1: s70n3fac3 (big blind) showed [Ac 7s] and won (567) with a pair of Sevens
Seat 2: FDIBA2009 (button) (small blind) mucked [3d Qh]



PokerStars Home Game Hand #226820061730: {Club #4781089}  Hold'em No Limit (50/100) - 2021/05/17 0:14:11 EET [2021/05/16 17:14:11 ET]
Table 'VTPP NLHE 1605' 2-max (Play Money) Seat #1 is the button
Seat 1: s70n3fac3 (13891 in chips) 
Seat 2: FDIBA2009 (2157 in chips) 
s70n3fac3: posts small blind 50
FDIBA2009: posts big blind 100
*** HOLE CARDS ***
s70n3fac3: raises 100 to 200
FDIBA2009: raises 1957 to 2157 and is all-in
s70n3fac3: folds 
Uncalled bet (1957) returned to FDIBA2009
FDIBA2009 collected 400 from pot
*** SUMMARY ***
Total pot 400 | Rake 0 
Seat 1: s70n3fac3 (button) (small blind) folded before Flop
Seat 2: FDIBA2009 (big blind) collected (400)



PokerStars Home Game Hand #226820069385: {Club #4781089}  Hold'em No Limit (50/100) - 2021/05/17 0:14:24 EET [2021/05/16 17:14:24 ET]
Table 'VTPP NLHE 1605' 2-max (Play Money) Seat #2 is the button
Seat 1: s70n3fac3 (13691 in chips) 
Seat 2: FDIBA2009 (2357 in chips) 
FDIBA2009: posts small blind 50
s70n3fac3: posts big blind 100
*** HOLE CARDS ***
FDIBA2009: calls 50
s70n3fac3: checks 
*** FLOP *** [6c Ad 9s]
s70n3fac3: checks 
FDIBA2009: bets 189
s70n3fac3: folds 
Uncalled bet (189) returned to FDIBA2009
FDIBA2009 collected 189 from pot
*** SUMMARY ***
Total pot 200 | Rake 11 
Board [6c Ad 9s]
Seat 1: s70n3fac3 (big blind) folded on the Flop
Seat 2: FDIBA2009 (button) (small blind) collected (189)



PokerStars Home Game Hand #226820076728: {Club #4781089}  Hold'em No Limit (50/100) - 2021/05/17 0:14:36 EET [2021/05/16 17:14:36 ET]
Table 'VTPP NLHE 1605' 2-max (Play Money) Seat #1 is the button
Seat 1: s70n3fac3 (13591 in chips) 
Seat 2: FDIBA2009 (2446 in chips) 
s70n3fac3: posts small blind 50
FDIBA2009: posts big blind 100
*** HOLE CARDS ***
s70n3fac3: calls 50
FDIBA2009: checks 
*** FLOP *** [As 2s 6c]
FDIBA2009: checks 
s70n3fac3: bets 100
FDIBA2009: calls 100
*** TURN *** [As 2s 6c] [7s]
FDIBA2009: checks 
s70n3fac3: checks 
*** RIVER *** [As 2s 6c 7s] [3h]
FDIBA2009: checks 
s70n3fac3: checks 
*** SHOW DOWN ***
FDIBA2009: shows [8s Kc] (high card Ace)
s70n3fac3: mucks hand 
FDIBA2009 collected 378 from pot
*** SUMMARY ***
Total pot 400 | Rake 22 
Board [As 2s 6c 7s 3h]
Seat 1: s70n3fac3 (button) (small blind) mucked [8c Qs]
Seat 2: FDIBA2009 (big blind) showed [8s Kc] and won (378) with high card Ace



PokerStars Home Game Hand #226820087110: {Club #4781089}  Hold'em No Limit (50/100) - 2021/05/17 0:14:54 EET [2021/05/16 17:14:54 ET]
Table 'VTPP NLHE 1605' 2-max (Play Money) Seat #2 is the button
Seat 1: s70n3fac3 (13391 in chips) 
Seat 2: FDIBA2009 (2624 in chips) 
FDIBA2009: posts small blind 50
s70n3fac3: posts big blind 100
*** HOLE CARDS ***
FDIBA2009: raises 100 to 200
s70n3fac3: calls 100
*** FLOP *** [6h As Th]
s70n3fac3: checks 
FDIBA2009: checks 
*** TURN *** [6h As Th] [Ks]
s70n3fac3: checks 
FDIBA2009: checks 
*** RIVER *** [6h As Th Ks] [5h]
s70n3fac3: bets 300
FDIBA2009: raises 978 to 1278
s70n3fac3: folds 
Uncalled bet (978) returned to FDIBA2009
FDIBA2009 collected 945 from pot
*** SUMMARY ***
Total pot 1000 | Rake 55 
Board [6h As Th Ks 5h]
Seat 1: s70n3fac3 (big blind) folded on the River
Seat 2: FDIBA2009 (button) (small blind) collected (945)



PokerStars Home Game Hand #226820106536: {Club #4781089}  Hold'em No Limit (50/100) - 2021/05/17 0:15:26 EET [2021/05/16 17:15:26 ET]
Table 'VTPP NLHE 1605' 2-max (Play Money) Seat #1 is the button
Seat 1: s70n3fac3 (12891 in chips) 
Seat 2: FDIBA2009 (3069 in chips) 
s70n3fac3: posts small blind 50
FDIBA2009: posts big blind 100
*** HOLE CARDS ***
s70n3fac3: folds 
Uncalled bet (50) returned to FDIBA2009
FDIBA2009 collected 100 from pot
*** SUMMARY ***
Total pot 100 | Rake 0 
Seat 1: s70n3fac3 (button) (small blind) folded before Flop
Seat 2: FDIBA2009 (big blind) collected (100)



PokerStars Home Game Hand #226820108618: {Club #4781089}  Hold'em No Limit (50/100) - 2021/05/17 0:15:30 EET [2021/05/16 17:15:30 ET]
Table 'VTPP NLHE 1605' 2-max (Play Money) Seat #2 is the button
Seat 1: s70n3fac3 (12841 in chips) 
Seat 2: FDIBA2009 (3119 in chips) 
FDIBA2009: posts small blind 50
s70n3fac3: posts big blind 100
*** HOLE CARDS ***
FDIBA2009: raises 100 to 200
s70n3fac3: folds 
Uncalled bet (100) returned to FDIBA2009
FDIBA2009 collected 200 from pot
*** SUMMARY ***
Total pot 200 | Rake 0 
Seat 1: s70n3fac3 (big blind) folded before Flop
Seat 2: FDIBA2009 (button) (small blind) collected (200)



PokerStars Home Game Hand #226820111836: {Club #4781089}  Hold'em No Limit (50/100) - 2021/05/17 0:15:35 EET [2021/05/16 17:15:35 ET]
Table 'VTPP NLHE 1605' 2-max (Play Money) Seat #1 is the button
Seat 1: s70n3fac3 (12741 in chips) 
Seat 2: FDIBA2009 (3219 in chips) 
s70n3fac3: posts small blind 50
FDIBA2009: posts big blind 100
*** HOLE CARDS ***
s70n3fac3: raises 100 to 200
FDIBA2009: calls 100
*** FLOP *** [7c 5c 6d]
FDIBA2009: checks 
s70n3fac3: checks 
*** TURN *** [7c 5c 6d] [Tc]
FDIBA2009: checks 
s70n3fac3: bets 200
FDIBA2009: folds 
Uncalled bet (200) returned to s70n3fac3
s70n3fac3 collected 378 from pot
s70n3fac3: doesn't show hand 
*** SUMMARY ***
Total pot 400 | Rake 22 
Board [7c 5c 6d Tc]
Seat 1: s70n3fac3 (button) (small blind) collected (378)
Seat 2: FDIBA2009 (big blind) folded on the Turn



PokerStars Home Game Hand #226820120331: {Club #4781089}  Hold'em No Limit (50/100) - 2021/05/17 0:15:50 EET [2021/05/16 17:15:50 ET]
Table 'VTPP NLHE 1605' 2-max (Play Money) Seat #2 is the button
Seat 1: s70n3fac3 (12919 in chips) 
Seat 2: FDIBA2009 (3019 in chips) 
FDIBA2009: posts small blind 50
s70n3fac3: posts big blind 100
*** HOLE CARDS ***
FDIBA2009: raises 100 to 200
s70n3fac3: calls 100
*** FLOP *** [Js 8s Tc]
s70n3fac3: checks 
FDIBA2009: bets 200
s70n3fac3: calls 200
*** TURN *** [Js 8s Tc] [Ad]
s70n3fac3: checks 
FDIBA2009: checks 
*** RIVER *** [Js 8s Tc Ad] [2s]
s70n3fac3: checks 
FDIBA2009: checks 
*** SHOW DOWN ***
s70n3fac3: shows [9s Kd] (high card Ace)
FDIBA2009: mucks hand 
s70n3fac3 collected 756 from pot
*** SUMMARY ***
Total pot 800 | Rake 44 
Board [Js 8s Tc Ad 2s]
Seat 1: s70n3fac3 (big blind) showed [9s Kd] and won (756) with high card Ace
Seat 2: FDIBA2009 (button) (small blind) mucked [5d 4c]



PokerStars Home Game Hand #226820132290: {Club #4781089}  Hold'em No Limit (50/100) - 2021/05/17 0:16:10 EET [2021/05/16 17:16:10 ET]
Table 'VTPP NLHE 1605' 2-max (Play Money) Seat #1 is the button
Seat 1: s70n3fac3 (13275 in chips) 
Seat 2: FDIBA2009 (2619 in chips) 
s70n3fac3: posts small blind 50
FDIBA2009: posts big blind 100
*** HOLE CARDS ***
s70n3fac3: calls 50
FDIBA2009: raises 200 to 300
s70n3fac3: calls 200
*** FLOP *** [Jd 8c Ts]
FDIBA2009: checks 
s70n3fac3: checks 
*** TURN *** [Jd 8c Ts] [5h]
FDIBA2009: bets 567
s70n3fac3: calls 567
*** RIVER *** [Jd 8c Ts 5h] [3s]
FDIBA2009: checks 
s70n3fac3: bets 300
FDIBA2009: folds 
Uncalled bet (300) returned to s70n3fac3
s70n3fac3 collected 1639 from pot
s70n3fac3: doesn't show hand 
*** SUMMARY ***
Total pot 1734 | Rake 95 
Board [Jd 8c Ts 5h 3s]
Seat 1: s70n3fac3 (button) (small blind) collected (1639)
Seat 2: FDIBA2009 (big blind) folded on the River



PokerStars Home Game Hand #226820147210: {Club #4781089}  Hold'em No Limit (50/100) - 2021/05/17 0:16:35 EET [2021/05/16 17:16:35 ET]
Table 'VTPP NLHE 1605' 2-max (Play Money) Seat #2 is the button
Seat 1: s70n3fac3 (14047 in chips) 
Seat 2: FDIBA2009 (1752 in chips) 
FDIBA2009: posts small blind 50
s70n3fac3: posts big blind 100
*** HOLE CARDS ***
FDIBA2009: calls 50
s70n3fac3: raises 300 to 400
FDIBA2009: folds 
Uncalled bet (300) returned to s70n3fac3
s70n3fac3 collected 200 from pot
s70n3fac3: doesn't show hand 
*** SUMMARY ***
Total pot 200 | Rake 0 
Seat 1: s70n3fac3 (big blind) collected (200)
Seat 2: FDIBA2009 (button) (small blind) folded before Flop



PokerStars Home Game Hand #226820153821: {Club #4781089}  Hold'em No Limit (50/100) - 2021/05/17 0:16:46 EET [2021/05/16 17:16:46 ET]
Table 'VTPP NLHE 1605' 2-max (Play Money) Seat #1 is the button
Seat 1: s70n3fac3 (14147 in chips) 
Seat 2: FDIBA2009 (1652 in chips) 
s70n3fac3: posts small blind 50
FDIBA2009: posts big blind 100
*** HOLE CARDS ***
s70n3fac3: folds 
Uncalled bet (50) returned to FDIBA2009
FDIBA2009 collected 100 from pot
*** SUMMARY ***
Total pot 100 | Rake 0 
Seat 1: s70n3fac3 (button) (small blind) folded before Flop
Seat 2: FDIBA2009 (big blind) collected (100)



PokerStars Home Game Hand #226820156081: {Club #4781089}  Hold'em No Limit (50/100) - 2021/05/17 0:16:50 EET [2021/05/16 17:16:50 ET]
Table 'VTPP NLHE 1605' 2-max (Play Money) Seat #2 is the button
Seat 1: s70n3fac3 (14097 in chips) 
Seat 2: FDIBA2009 (1702 in chips) 
FDIBA2009: posts small blind 50
s70n3fac3: posts big blind 100
*** HOLE CARDS ***
FDIBA2009: folds 
Uncalled bet (50) returned to s70n3fac3
s70n3fac3 collected 100 from pot
s70n3fac3: doesn't show hand 
*** SUMMARY ***
Total pot 100 | Rake 0 
Seat 1: s70n3fac3 (big blind) collected (100)
Seat 2: FDIBA2009 (button) (small blind) folded before Flop



PokerStars Home Game Hand #226820158752: {Club #4781089}  Hold'em No Limit (50/100) - 2021/05/17 0:16:55 EET [2021/05/16 17:16:55 ET]
Table 'VTPP NLHE 1605' 2-max (Play Money) Seat #1 is the button
Seat 1: s70n3fac3 (14147 in chips) 
Seat 2: FDIBA2009 (1652 in chips) 
s70n3fac3: posts small blind 50
FDIBA2009: posts big blind 100
*** HOLE CARDS ***
s70n3fac3: calls 50
FDIBA2009: checks 
*** FLOP *** [7s 5d 4h]
FDIBA2009: checks 
s70n3fac3: bets 100
FDIBA2009: raises 1452 to 1552 and is all-in
s70n3fac3: folds 
Uncalled bet (1452) returned to FDIBA2009
FDIBA2009 collected 378 from pot
*** SUMMARY ***
Total pot 400 | Rake 22 
Board [7s 5d 4h]
Seat 1: s70n3fac3 (button) (small blind) folded on the Flop
Seat 2: FDIBA2009 (big blind) collected (378)



PokerStars Home Game Hand #226820169967: {Club #4781089}  Hold'em No Limit (50/100) - 2021/05/17 0:17:14 EET [2021/05/16 17:17:14 ET]
Table 'VTPP NLHE 1605' 2-max (Play Money) Seat #2 is the button
Seat 1: s70n3fac3 (13947 in chips) 
Seat 2: FDIBA2009 (1830 in chips) 
FDIBA2009: posts small blind 50
s70n3fac3: posts big blind 100
*** HOLE CARDS ***
FDIBA2009: folds 
Uncalled bet (50) returned to s70n3fac3
s70n3fac3 collected 100 from pot
s70n3fac3: doesn't show hand 
*** SUMMARY ***
Total pot 100 | Rake 0 
Seat 1: s70n3fac3 (big blind) collected (100)
Seat 2: FDIBA2009 (button) (small blind) folded before Flop



PokerStars Home Game Hand #226820178154: {Club #4781089}  Hold'em No Limit (50/100) - 2021/05/17 0:17:28 EET [2021/05/16 17:17:28 ET]
Table 'VTPP NLHE 1605' 2-max (Play Money) Seat #1 is the button
Seat 1: s70n3fac3 (13997 in chips) 
Seat 2: FDIBA2009 (1780 in chips) 
s70n3fac3: posts small blind 50
FDIBA2009: posts big blind 100
*** HOLE CARDS ***
s70n3fac3: calls 50
FDIBA2009: checks 
*** FLOP *** [Jc 7s Tc]
FDIBA2009: checks 
s70n3fac3: checks 
*** TURN *** [Jc 7s Tc] [6s]
FDIBA2009: checks 
s70n3fac3: bets 100
FDIBA2009: folds 
Uncalled bet (100) returned to s70n3fac3
s70n3fac3 collected 189 from pot
s70n3fac3: doesn't show hand 
*** SUMMARY ***
Total pot 200 | Rake 11 
Board [Jc 7s Tc 6s]
Seat 1: s70n3fac3 (button) (small blind) collected (189)
Seat 2: FDIBA2009 (big blind) folded on the Turn



PokerStars Home Game Hand #226820185919: {Club #4781089}  Hold'em No Limit (50/100) - 2021/05/17 0:17:41 EET [2021/05/16 17:17:41 ET]
Table 'VTPP NLHE 1605' 2-max (Play Money) Seat #2 is the button
Seat 1: s70n3fac3 (14086 in chips) 
Seat 2: FDIBA2009 (1680 in chips) 
FDIBA2009: posts small blind 50
s70n3fac3: posts big blind 100
*** HOLE CARDS ***
FDIBA2009: calls 50
s70n3fac3: checks 
*** FLOP *** [3d 7d 2h]
s70n3fac3: checks 
FDIBA2009: bets 100
s70n3fac3: calls 100
*** TURN *** [3d 7d 2h] [Qs]
s70n3fac3: checks 
FDIBA2009: bets 300
s70n3fac3: folds 
Uncalled bet (300) returned to FDIBA2009
FDIBA2009 collected 378 from pot
*** SUMMARY ***
Total pot 400 | Rake 22 
Board [3d 7d 2h Qs]
Seat 1: s70n3fac3 (big blind) folded on the Turn
Seat 2: FDIBA2009 (button) (small blind) collected (378)



PokerStars Home Game Hand #226820196110: {Club #4781089}  Hold'em No Limit (50/100) - 2021/05/17 0:17:58 EET [2021/05/16 17:17:58 ET]
Table 'VTPP NLHE 1605' 2-max (Play Money) Seat #1 is the button
Seat 1: s70n3fac3 (13886 in chips) 
Seat 2: FDIBA2009 (1858 in chips) 
s70n3fac3: posts small blind 50
FDIBA2009: posts big blind 100
*** HOLE CARDS ***
s70n3fac3: calls 50
FDIBA2009: checks 
*** FLOP *** [Qs Ts Td]
FDIBA2009: checks 
s70n3fac3: bets 100
FDIBA2009: folds 
Uncalled bet (100) returned to s70n3fac3
s70n3fac3 collected 189 from pot
s70n3fac3: doesn't show hand 
*** SUMMARY ***
Total pot 200 | Rake 11 
Board [Qs Ts Td]
Seat 1: s70n3fac3 (button) (small blind) collected (189)
Seat 2: FDIBA2009 (big blind) folded on the Flop



PokerStars Home Game Hand #226820202005: {Club #4781089}  Hold'em No Limit (50/100) - 2021/05/17 0:18:08 EET [2021/05/16 17:18:08 ET]
Table 'VTPP NLHE 1605' 2-max (Play Money) Seat #2 is the button
Seat 1: s70n3fac3 (13975 in chips) 
Seat 2: FDIBA2009 (1758 in chips) 
FDIBA2009: posts small blind 50
s70n3fac3: posts big blind 100
*** HOLE CARDS ***
FDIBA2009: raises 100 to 200
s70n3fac3: calls 100
*** FLOP *** [5c Jc Qc]
s70n3fac3: checks 
FDIBA2009: bets 100
s70n3fac3: calls 100
*** TURN *** [5c Jc Qc] [4d]
s70n3fac3: checks 
FDIBA2009: bets 100
s70n3fac3: calls 100
*** RIVER *** [5c Jc Qc 4d] [2s]
s70n3fac3: checks 
FDIBA2009: checks 
*** SHOW DOWN ***
s70n3fac3: shows [5s 9s] (a pair of Fives)
FDIBA2009: mucks hand 
s70n3fac3 collected 756 from pot
*** SUMMARY ***
Total pot 800 | Rake 44 
Board [5c Jc Qc 4d 2s]
Seat 1: s70n3fac3 (big blind) showed [5s 9s] and won (756) with a pair of Fives
Seat 2: FDIBA2009 (button) (small blind) mucked [4c 6s]



PokerStars Home Game Hand #226820214413: {Club #4781089}  Hold'em No Limit (50/100) - 2021/05/17 0:18:29 EET [2021/05/16 17:18:29 ET]
Table 'VTPP NLHE 1605' 2-max (Play Money) Seat #1 is the button
Seat 1: s70n3fac3 (14331 in chips) 
Seat 2: FDIBA2009 (1358 in chips) 
s70n3fac3: posts small blind 50
FDIBA2009: posts big blind 100
*** HOLE CARDS ***
s70n3fac3: calls 50
FDIBA2009: raises 1258 to 1358 and is all-in
s70n3fac3: calls 1258
*** FLOP *** [Ah 8d Ks]
*** TURN *** [Ah 8d Ks] [Qh]
*** RIVER *** [Ah 8d Ks Qh] [2c]
*** SHOW DOWN ***
FDIBA2009: shows [As 8h] (two pair, Aces and Eights)
s70n3fac3: shows [Jh Kd] (a pair of Kings)
FDIBA2009 collected 2567 from pot
*** SUMMARY ***
Total pot 2716 | Rake 149 
Board [Ah 8d Ks Qh 2c]
Seat 1: s70n3fac3 (button) (small blind) showed [Jh Kd] and lost with a pair of Kings
Seat 2: FDIBA2009 (big blind) showed [As 8h] and won (2567) with two pair, Aces and Eights



PokerStars Home Game Hand #226820223774: {Club #4781089}  Hold'em No Limit (50/100) - 2021/05/17 0:18:45 EET [2021/05/16 17:18:45 ET]
Table 'VTPP NLHE 1605' 2-max (Play Money) Seat #2 is the button
Seat 1: s70n3fac3 (12973 in chips) 
Seat 2: FDIBA2009 (2567 in chips) 
FDIBA2009: posts small blind 50
s70n3fac3: posts big blind 100
*** HOLE CARDS ***
FDIBA2009: calls 50
s70n3fac3: checks 
*** FLOP *** [Tc 4d Kd]
s70n3fac3: checks 
FDIBA2009: checks 
*** TURN *** [Tc 4d Kd] [Qs]
s70n3fac3: bets 100
FDIBA2009: calls 100
*** RIVER *** [Tc 4d Kd Qs] [3c]
s70n3fac3: bets 300
FDIBA2009: folds 
Uncalled bet (300) returned to s70n3fac3
s70n3fac3 collected 378 from pot
s70n3fac3: doesn't show hand 
*** SUMMARY ***
Total pot 400 | Rake 22 
Board [Tc 4d Kd Qs 3c]
Seat 1: s70n3fac3 (big blind) collected (378)
Seat 2: FDIBA2009 (button) (small blind) folded on the River



PokerStars Home Game Hand #226820241791: {Club #4781089}  Hold'em No Limit (50/100) - 2021/05/17 0:19:01 EET [2021/05/16 17:19:01 ET]
Table 'VTPP NLHE 1605' 2-max (Play Money) Seat #1 is the button
Seat 1: s70n3fac3 (13151 in chips) 
Seat 2: FDIBA2009 (2367 in chips) 
s70n3fac3: posts small blind 50
FDIBA2009: posts big blind 100
*** HOLE CARDS ***
s70n3fac3: folds 
Uncalled bet (50) returned to FDIBA2009
FDIBA2009 collected 100 from pot
*** SUMMARY ***
Total pot 100 | Rake 0 
Seat 1: s70n3fac3 (button) (small blind) folded before Flop
Seat 2: FDIBA2009 (big blind) collected (100)



PokerStars Home Game Hand #226820244086: {Club #4781089}  Hold'em No Limit (50/100) - 2021/05/17 0:19:05 EET [2021/05/16 17:19:05 ET]
Table 'VTPP NLHE 1605' 2-max (Play Money) Seat #2 is the button
Seat 1: s70n3fac3 (13101 in chips) 
Seat 2: FDIBA2009 (2417 in chips) 
FDIBA2009: posts small blind 50
s70n3fac3: posts big blind 100
*** HOLE CARDS ***
FDIBA2009: raises 100 to 200
s70n3fac3: calls 100
*** FLOP *** [2c 4s 4c]
s70n3fac3: checks 
FDIBA2009: bets 200
s70n3fac3: raises 400 to 600
FDIBA2009: folds 
Uncalled bet (400) returned to s70n3fac3
s70n3fac3 collected 756 from pot
s70n3fac3: doesn't show hand 
*** SUMMARY ***
Total pot 800 | Rake 44 
Board [2c 4s 4c]
Seat 1: s70n3fac3 (big blind) collected (756)
Seat 2: FDIBA2009 (button) (small blind) folded on the Flop



PokerStars Home Game Hand #226820253469: {Club #4781089}  Hold'em No Limit (50/100) - 2021/05/17 0:19:21 EET [2021/05/16 17:19:21 ET]
Table 'VTPP NLHE 1605' 2-max (Play Money) Seat #1 is the button
Seat 1: s70n3fac3 (13457 in chips) 
Seat 2: FDIBA2009 (2017 in chips) 
s70n3fac3: posts small blind 50
FDIBA2009: posts big blind 100
*** HOLE CARDS ***
s70n3fac3: calls 50
FDIBA2009: checks 
*** FLOP *** [5c 3s 7c]
FDIBA2009: checks 
s70n3fac3: bets 100
FDIBA2009: calls 100
*** TURN *** [5c 3s 7c] [Tc]
FDIBA2009: checks 
s70n3fac3: checks 
*** RIVER *** [5c 3s 7c Tc] [7d]
FDIBA2009: checks 
s70n3fac3: bets 300
FDIBA2009: calls 300
*** SHOW DOWN ***
s70n3fac3: shows [8c Kc] (a flush, King high)
FDIBA2009: mucks hand 
s70n3fac3 collected 945 from pot
*** SUMMARY ***
Total pot 1000 | Rake 55 
Board [5c 3s 7c Tc 7d]
Seat 1: s70n3fac3 (button) (small blind) showed [8c Kc] and won (945) with a flush, King high
Seat 2: FDIBA2009 (big blind) mucked [3c 8h]



PokerStars Home Game Hand #226820267055: {Club #4781089}  Hold'em No Limit (50/100) - 2021/05/17 0:19:44 EET [2021/05/16 17:19:44 ET]
Table 'VTPP NLHE 1605' 2-max (Play Money) Seat #2 is the button
Seat 1: s70n3fac3 (13902 in chips) 
Seat 2: FDIBA2009 (1517 in chips) 
FDIBA2009: posts small blind 50
s70n3fac3: posts big blind 100
*** HOLE CARDS ***
FDIBA2009: raises 100 to 200
s70n3fac3: folds 
Uncalled bet (100) returned to FDIBA2009
FDIBA2009 collected 200 from pot
*** SUMMARY ***
Total pot 200 | Rake 0 
Seat 1: s70n3fac3 (big blind) folded before Flop
Seat 2: FDIBA2009 (button) (small blind) collected (200)



PokerStars Home Game Hand #226820270987: {Club #4781089}  Hold'em No Limit (50/100) - 2021/05/17 0:19:51 EET [2021/05/16 17:19:51 ET]
Table 'VTPP NLHE 1605' 2-max (Play Money) Seat #1 is the button
Seat 1: s70n3fac3 (13802 in chips) 
Seat 2: FDIBA2009 (1617 in chips) 
s70n3fac3: posts small blind 50
FDIBA2009: posts big blind 100
*** HOLE CARDS ***
s70n3fac3: folds 
Uncalled bet (50) returned to FDIBA2009
FDIBA2009 collected 100 from pot
*** SUMMARY ***
Total pot 100 | Rake 0 
Seat 1: s70n3fac3 (button) (small blind) folded before Flop
Seat 2: FDIBA2009 (big blind) collected (100)



PokerStars Home Game Hand #226820273156: {Club #4781089}  Hold'em No Limit (50/100) - 2021/05/17 0:19:55 EET [2021/05/16 17:19:55 ET]
Table 'VTPP NLHE 1605' 2-max (Play Money) Seat #2 is the button
Seat 1: s70n3fac3 (13752 in chips) 
Seat 2: FDIBA2009 (1667 in chips) 
FDIBA2009: posts small blind 50
s70n3fac3: posts big blind 100
*** HOLE CARDS ***
FDIBA2009: raises 100 to 200
s70n3fac3: calls 100
*** FLOP *** [Ts 4d Qs]
s70n3fac3: checks 
FDIBA2009: checks 
*** TURN *** [Ts 4d Qs] [Tc]
s70n3fac3: checks 
FDIBA2009: bets 200
s70n3fac3: calls 200
*** RIVER *** [Ts 4d Qs Tc] [8c]
s70n3fac3: checks 
FDIBA2009: bets 1267 and is all-in
s70n3fac3: calls 1267
*** SHOW DOWN ***
FDIBA2009: shows [Qh Ac] (two pair, Queens and Tens)
s70n3fac3: shows [4h Qc] (two pair, Queens and Tens - lower kicker)
FDIBA2009 collected 3151 from pot
*** SUMMARY ***
Total pot 3334 | Rake 183 
Board [Ts 4d Qs Tc 8c]
Seat 1: s70n3fac3 (big blind) showed [4h Qc] and lost with two pair, Queens and Tens
Seat 2: FDIBA2009 (button) (small blind) showed [Qh Ac] and won (3151) with two pair, Queens and Tens



PokerStars Home Game Hand #226820288225: {Club #4781089}  Hold'em No Limit (50/100) - 2021/05/17 0:20:21 EET [2021/05/16 17:20:21 ET]
Table 'VTPP NLHE 1605' 2-max (Play Money) Seat #1 is the button
Seat 1: s70n3fac3 (12085 in chips) 
Seat 2: FDIBA2009 (3151 in chips) 
s70n3fac3: posts small blind 50
FDIBA2009: posts big blind 100
*** HOLE CARDS ***
s70n3fac3: raises 100 to 200
FDIBA2009: calls 100
*** FLOP *** [7h 6c 7c]
FDIBA2009: checks 
s70n3fac3: checks 
*** TURN *** [7h 6c 7c] [4s]
FDIBA2009: bets 100
s70n3fac3: calls 100
*** RIVER *** [7h 6c 7c 4s] [Ad]
FDIBA2009: checks 
s70n3fac3: bets 300
FDIBA2009: folds 
Uncalled bet (300) returned to s70n3fac3
s70n3fac3 collected 567 from pot
s70n3fac3: doesn't show hand 
*** SUMMARY ***
Total pot 600 | Rake 33 
Board [7h 6c 7c 4s Ad]
Seat 1: s70n3fac3 (button) (small blind) collected (567)
Seat 2: FDIBA2009 (big blind) folded on the River



PokerStars Home Game Hand #226820300130: {Club #4781089}  Hold'em No Limit (50/100) - 2021/05/17 0:20:41 EET [2021/05/16 17:20:41 ET]
Table 'VTPP NLHE 1605' 2-max (Play Money) Seat #2 is the button
Seat 1: s70n3fac3 (12352 in chips) 
Seat 2: FDIBA2009 (2851 in chips) 
FDIBA2009: posts small blind 50
s70n3fac3: posts big blind 100
*** HOLE CARDS ***
FDIBA2009: calls 50
s70n3fac3: checks 
*** FLOP *** [4h Ac 4c]
s70n3fac3: checks 
FDIBA2009: bets 100
s70n3fac3: folds 
Uncalled bet (100) returned to FDIBA2009
FDIBA2009 collected 189 from pot
*** SUMMARY ***
Total pot 200 | Rake 11 
Board [4h Ac 4c]
Seat 1: s70n3fac3 (big blind) folded on the Flop
Seat 2: FDIBA2009 (button) (small blind) collected (189)



PokerStars Home Game Hand #226820307584: {Club #4781089}  Hold'em No Limit (50/100) - 2021/05/17 0:20:54 EET [2021/05/16 17:20:54 ET]
Table 'VTPP NLHE 1605' 2-max (Play Money) Seat #1 is the button
Seat 1: s70n3fac3 (12252 in chips) 
Seat 2: FDIBA2009 (2940 in chips) 
s70n3fac3: posts small blind 50
FDIBA2009: posts big blind 100
*** HOLE CARDS ***
s70n3fac3: raises 100 to 200
FDIBA2009: calls 100
*** FLOP *** [3c Js 6h]
FDIBA2009: checks 
s70n3fac3: bets 200
FDIBA2009: calls 200
*** TURN *** [3c Js 6h] [7d]
FDIBA2009: checks 
s70n3fac3: checks 
*** RIVER *** [3c Js 6h 7d] [7c]
FDIBA2009: checks 
s70n3fac3: checks 
*** SHOW DOWN ***
FDIBA2009: shows [3h 9h] (two pair, Sevens and Threes)
s70n3fac3: mucks hand 
FDIBA2009 collected 756 from pot
*** SUMMARY ***
Total pot 800 | Rake 44 
Board [3c Js 6h 7d 7c]
Seat 1: s70n3fac3 (button) (small blind) mucked [2c 2h]
Seat 2: FDIBA2009 (big blind) showed [3h 9h] and won (756) with two pair, Sevens and Threes



PokerStars Home Game Hand #226820318547: {Club #4781089}  Hold'em No Limit (50/100) - 2021/05/17 0:21:12 EET [2021/05/16 17:21:12 ET]
Table 'VTPP NLHE 1605' 2-max (Play Money) Seat #2 is the button
Seat 1: s70n3fac3 (11852 in chips) 
Seat 2: FDIBA2009 (3296 in chips) 
FDIBA2009: posts small blind 50
s70n3fac3: posts big blind 100
*** HOLE CARDS ***
FDIBA2009: raises 100 to 200
s70n3fac3: folds 
Uncalled bet (100) returned to FDIBA2009
FDIBA2009 collected 200 from pot
*** SUMMARY ***
Total pot 200 | Rake 0 
Seat 1: s70n3fac3 (big blind) folded before Flop
Seat 2: FDIBA2009 (button) (small blind) collected (200)



PokerStars Home Game Hand #226820322147: {Club #4781089}  Hold'em No Limit (50/100) - 2021/05/17 0:21:18 EET [2021/05/16 17:21:18 ET]
Table 'VTPP NLHE 1605' 2-max (Play Money) Seat #1 is the button
Seat 1: s70n3fac3 (11752 in chips) 
Seat 2: FDIBA2009 (3396 in chips) 
s70n3fac3: posts small blind 50
FDIBA2009: posts big blind 100
*** HOLE CARDS ***
s70n3fac3: calls 50
FDIBA2009: checks 
*** FLOP *** [Ad 3h 3d]
FDIBA2009: checks 
s70n3fac3: checks 
*** TURN *** [Ad 3h 3d] [9h]
FDIBA2009: checks 
s70n3fac3: bets 100
FDIBA2009: folds 
Uncalled bet (100) returned to s70n3fac3
s70n3fac3 collected 189 from pot
s70n3fac3: doesn't show hand 
*** SUMMARY ***
Total pot 200 | Rake 11 
Board [Ad 3h 3d 9h]
Seat 1: s70n3fac3 (button) (small blind) collected (189)
Seat 2: FDIBA2009 (big blind) folded on the Turn



PokerStars Home Game Hand #226820329596: {Club #4781089}  Hold'em No Limit (50/100) - 2021/05/17 0:21:31 EET [2021/05/16 17:21:31 ET]
Table 'VTPP NLHE 1605' 2-max (Play Money) Seat #2 is the button
Seat 1: s70n3fac3 (11841 in chips) 
Seat 2: FDIBA2009 (3296 in chips) 
FDIBA2009: posts small blind 50
s70n3fac3: posts big blind 100
*** HOLE CARDS ***
FDIBA2009: raises 100 to 200
s70n3fac3: folds 
Uncalled bet (100) returned to FDIBA2009
FDIBA2009 collected 200 from pot
*** SUMMARY ***
Total pot 200 | Rake 0 
Seat 1: s70n3fac3 (big blind) folded before Flop
Seat 2: FDIBA2009 (button) (small blind) collected (200)



PokerStars Home Game Hand #226820333090: {Club #4781089}  Hold'em No Limit (50/100) - 2021/05/17 0:21:37 EET [2021/05/16 17:21:37 ET]
Table 'VTPP NLHE 1605' 2-max (Play Money) Seat #1 is the button
Seat 1: s70n3fac3 (11741 in chips) 
Seat 2: FDIBA2009 (3396 in chips) 
s70n3fac3: posts small blind 50
FDIBA2009: posts big blind 100
*** HOLE CARDS ***
s70n3fac3: raises 100 to 200
FDIBA2009: calls 100
*** FLOP *** [6d Kh Jd]
FDIBA2009: checks 
s70n3fac3: bets 200
FDIBA2009: folds 
Uncalled bet (200) returned to s70n3fac3
s70n3fac3 collected 378 from pot
s70n3fac3: doesn't show hand 
*** SUMMARY ***
Total pot 400 | Rake 22 
Board [6d Kh Jd]
Seat 1: s70n3fac3 (button) (small blind) collected (378)
Seat 2: FDIBA2009 (big blind) folded on the Flop



PokerStars Home Game Hand #226820339291: {Club #4781089}  Hold'em No Limit (50/100) - 2021/05/17 0:21:48 EET [2021/05/16 17:21:48 ET]
Table 'VTPP NLHE 1605' 2-max (Play Money) Seat #2 is the button
Seat 1: s70n3fac3 (11919 in chips) 
Seat 2: FDIBA2009 (3196 in chips) 
FDIBA2009: posts small blind 50
s70n3fac3: posts big blind 100
*** HOLE CARDS ***
FDIBA2009: raises 100 to 200
s70n3fac3: calls 100
*** FLOP *** [Jd 3h Qd]
s70n3fac3: checks 
FDIBA2009: checks 
*** TURN *** [Jd 3h Qd] [Kd]
s70n3fac3: checks 
FDIBA2009: checks 
*** RIVER *** [Jd 3h Qd Kd] [7c]
s70n3fac3: checks 
FDIBA2009: checks 
*** SHOW DOWN ***
s70n3fac3: shows [5s 2s] (high card King)
FDIBA2009: shows [9h 5c] (high card King - Queen+Jack+Nine kicker)
FDIBA2009 collected 378 from pot
*** SUMMARY ***
Total pot 400 | Rake 22 
Board [Jd 3h Qd Kd 7c]
Seat 1: s70n3fac3 (big blind) showed [5s 2s] and lost with high card King
Seat 2: FDIBA2009 (button) (small blind) showed [9h 5c] and won (378) with high card King



PokerStars Home Game Hand #226820349774: {Club #4781089}  Hold'em No Limit (50/100) - 2021/05/17 0:22:06 EET [2021/05/16 17:22:06 ET]
Table 'VTPP NLHE 1605' 2-max (Play Money) Seat #1 is the button
Seat 1: s70n3fac3 (11719 in chips) 
Seat 2: FDIBA2009 (3374 in chips) 
s70n3fac3: posts small blind 50
FDIBA2009: posts big blind 100
*** HOLE CARDS ***
s70n3fac3: folds 
Uncalled bet (50) returned to FDIBA2009
FDIBA2009 collected 100 from pot
*** SUMMARY ***
Total pot 100 | Rake 0 
Seat 1: s70n3fac3 (button) (small blind) folded before Flop
Seat 2: FDIBA2009 (big blind) collected (100)



PokerStars Home Game Hand #226820352248: {Club #4781089}  Hold'em No Limit (50/100) - 2021/05/17 0:22:10 EET [2021/05/16 17:22:10 ET]
Table 'VTPP NLHE 1605' 2-max (Play Money) Seat #2 is the button
Seat 1: s70n3fac3 (11669 in chips) 
Seat 2: FDIBA2009 (3424 in chips) 
FDIBA2009: posts small blind 50
s70n3fac3: posts big blind 100
*** HOLE CARDS ***
FDIBA2009: raises 100 to 200
s70n3fac3: calls 100
*** FLOP *** [Th Ac Js]
s70n3fac3: checks 
FDIBA2009: bets 300
s70n3fac3: raises 500 to 800
FDIBA2009: folds 
Uncalled bet (500) returned to s70n3fac3
s70n3fac3 collected 945 from pot
s70n3fac3: doesn't show hand 
*** SUMMARY ***
Total pot 1000 | Rake 55 
Board [Th Ac Js]
Seat 1: s70n3fac3 (big blind) collected (945)
Seat 2: FDIBA2009 (button) (small blind) folded on the Flop



PokerStars Home Game Hand #226820367953: {Club #4781089}  Hold'em No Limit (50/100) - 2021/05/17 0:22:37 EET [2021/05/16 17:22:37 ET]
Table 'VTPP NLHE 1605' 2-max (Play Money) Seat #1 is the button
Seat 1: s70n3fac3 (12114 in chips) 
Seat 2: FDIBA2009 (2924 in chips) 
s70n3fac3: posts small blind 50
FDIBA2009: posts big blind 100
*** HOLE CARDS ***
s70n3fac3: raises 100 to 200
FDIBA2009: calls 100
*** FLOP *** [6s As 7c]
FDIBA2009: checks 
s70n3fac3: bets 200
FDIBA2009: calls 200
*** TURN *** [6s As 7c] [Qd]
FDIBA2009: checks 
s70n3fac3: checks 
*** RIVER *** [6s As 7c Qd] [Th]
FDIBA2009: checks 
s70n3fac3: checks 
*** SHOW DOWN ***
FDIBA2009: shows [7s 5d] (a pair of Sevens)
s70n3fac3: mucks hand 
FDIBA2009 collected 756 from pot
*** SUMMARY ***
Total pot 800 | Rake 44 
Board [6s As 7c Qd Th]
Seat 1: s70n3fac3 (button) (small blind) mucked [6c 8c]
Seat 2: FDIBA2009 (big blind) showed [7s 5d] and won (756) with a pair of Sevens



PokerStars Home Game Hand #226820380939: {Club #4781089}  Hold'em No Limit (50/100) - 2021/05/17 0:22:59 EET [2021/05/16 17:22:59 ET]
Table 'VTPP NLHE 1605' 2-max (Play Money) Seat #2 is the button
Seat 1: s70n3fac3 (11714 in chips) 
Seat 2: FDIBA2009 (3280 in chips) 
FDIBA2009: posts small blind 50
s70n3fac3: posts big blind 100
*** HOLE CARDS ***
FDIBA2009: raises 100 to 200
s70n3fac3: calls 100
*** FLOP *** [2c 9d 6d]
s70n3fac3: checks 
FDIBA2009: checks 
*** TURN *** [2c 9d 6d] [2h]
s70n3fac3: bets 200
FDIBA2009: calls 200
*** RIVER *** [2c 9d 6d 2h] [8s]
s70n3fac3: bets 300
FDIBA2009: raises 1000 to 1300
s70n3fac3: calls 1000
*** SHOW DOWN ***
FDIBA2009: shows [2d Js] (three of a kind, Deuces)
s70n3fac3: mucks hand 
FDIBA2009 collected 3213 from pot
*** SUMMARY ***
Total pot 3400 | Rake 187 
Board [2c 9d 6d 2h 8s]
Seat 1: s70n3fac3 (big blind) mucked [8h Ah]
Seat 2: FDIBA2009 (button) (small blind) showed [2d Js] and won (3213) with three of a kind, Deuces



PokerStars Home Game Hand #226820411516: {Club #4781089}  Hold'em No Limit (50/100) - 2021/05/17 0:23:41 EET [2021/05/16 17:23:41 ET]
Table 'VTPP NLHE 1605' 2-max (Play Money) Seat #1 is the button
Seat 1: s70n3fac3 (10014 in chips) 
Seat 2: FDIBA2009 (4793 in chips) 
s70n3fac3: posts small blind 50
FDIBA2009: posts big blind 100
*** HOLE CARDS ***
s70n3fac3: calls 50
FDIBA2009: raises 200 to 300
s70n3fac3: calls 200
*** FLOP *** [As 4h Ks]
FDIBA2009: bets 300
s70n3fac3: folds 
Uncalled bet (300) returned to FDIBA2009
FDIBA2009 collected 567 from pot
*** SUMMARY ***
Total pot 600 | Rake 33 
Board [As 4h Ks]
Seat 1: s70n3fac3 (button) (small blind) folded on the Flop
Seat 2: FDIBA2009 (big blind) collected (567)



PokerStars Home Game Hand #226820420681: {Club #4781089}  Hold'em No Limit (50/100) - 2021/05/17 0:23:57 EET [2021/05/16 17:23:57 ET]
Table 'VTPP NLHE 1605' 2-max (Play Money) Seat #2 is the button
Seat 1: s70n3fac3 (9714 in chips) 
Seat 2: FDIBA2009 (5060 in chips) 
FDIBA2009: posts small blind 50
s70n3fac3: posts big blind 100
*** HOLE CARDS ***
FDIBA2009: raises 100 to 200
s70n3fac3: raises 400 to 600
FDIBA2009: calls 400
*** FLOP *** [3s 7d 4d]
s70n3fac3: bets 600
FDIBA2009: folds 
Uncalled bet (600) returned to s70n3fac3
s70n3fac3 collected 1134 from pot
s70n3fac3: doesn't show hand 
*** SUMMARY ***
Total pot 1200 | Rake 66 
Board [3s 7d 4d]
Seat 1: s70n3fac3 (big blind) collected (1134)
Seat 2: FDIBA2009 (button) (small blind) folded on the Flop



PokerStars Home Game Hand #226820430317: {Club #4781089}  Hold'em No Limit (50/100) - 2021/05/17 0:24:13 EET [2021/05/16 17:24:13 ET]
Table 'VTPP NLHE 1605' 2-max (Play Money) Seat #1 is the button
Seat 1: s70n3fac3 (10248 in chips) 
Seat 2: FDIBA2009 (4460 in chips) 
s70n3fac3: posts small blind 50
FDIBA2009: posts big blind 100
*** HOLE CARDS ***
s70n3fac3: calls 50
FDIBA2009: checks 
*** FLOP *** [4h Jc 5d]
FDIBA2009: checks 
s70n3fac3: bets 100
FDIBA2009: folds 
Uncalled bet (100) returned to s70n3fac3
s70n3fac3 collected 189 from pot
s70n3fac3: doesn't show hand 
*** SUMMARY ***
Total pot 200 | Rake 11 
Board [4h Jc 5d]
Seat 1: s70n3fac3 (button) (small blind) collected (189)
Seat 2: FDIBA2009 (big blind) folded on the Flop



PokerStars Home Game Hand #226820436100: {Club #4781089}  Hold'em No Limit (50/100) - 2021/05/17 0:24:23 EET [2021/05/16 17:24:23 ET]
Table 'VTPP NLHE 1605' 2-max (Play Money) Seat #2 is the button
Seat 1: s70n3fac3 (10337 in chips) 
Seat 2: FDIBA2009 (4360 in chips) 
FDIBA2009: posts small blind 50
s70n3fac3: posts big blind 100
*** HOLE CARDS ***
FDIBA2009: raises 100 to 200
s70n3fac3: raises 400 to 600
FDIBA2009: folds 
Uncalled bet (400) returned to s70n3fac3
s70n3fac3 collected 400 from pot
s70n3fac3: doesn't show hand 
*** SUMMARY ***
Total pot 400 | Rake 0 
Seat 1: s70n3fac3 (big blind) collected (400)
Seat 2: FDIBA2009 (button) (small blind) folded before Flop



PokerStars Home Game Hand #226820441824: {Club #4781089}  Hold'em No Limit (50/100) - 2021/05/17 0:24:33 EET [2021/05/16 17:24:33 ET]
Table 'VTPP NLHE 1605' 2-max (Play Money) Seat #1 is the button
Seat 1: s70n3fac3 (10537 in chips) 
Seat 2: FDIBA2009 (4160 in chips) 
s70n3fac3: posts small blind 50
FDIBA2009: posts big blind 100
*** HOLE CARDS ***
s70n3fac3: folds 
Uncalled bet (50) returned to FDIBA2009
FDIBA2009 collected 100 from pot
*** SUMMARY ***
Total pot 100 | Rake 0 
Seat 1: s70n3fac3 (button) (small blind) folded before Flop
Seat 2: FDIBA2009 (big blind) collected (100)



PokerStars Home Game Hand #226820444073: {Club #4781089}  Hold'em No Limit (50/100) - 2021/05/17 0:24:37 EET [2021/05/16 17:24:37 ET]
Table 'VTPP NLHE 1605' 2-max (Play Money) Seat #2 is the button
Seat 1: s70n3fac3 (10487 in chips) 
Seat 2: FDIBA2009 (4210 in chips) 
FDIBA2009: posts small blind 50
s70n3fac3: posts big blind 100
*** HOLE CARDS ***
FDIBA2009: folds 
Uncalled bet (50) returned to s70n3fac3
s70n3fac3 collected 100 from pot
s70n3fac3: doesn't show hand 
*** SUMMARY ***
Total pot 100 | Rake 0 
Seat 1: s70n3fac3 (big blind) collected (100)
Seat 2: FDIBA2009 (button) (small blind) folded before Flop



PokerStars Home Game Hand #226820446604: {Club #4781089}  Hold'em No Limit (50/100) - 2021/05/17 0:24:41 EET [2021/05/16 17:24:41 ET]
Table 'VTPP NLHE 1605' 2-max (Play Money) Seat #1 is the button
Seat 1: s70n3fac3 (10537 in chips) 
Seat 2: FDIBA2009 (4160 in chips) 
s70n3fac3: posts small blind 50
FDIBA2009: posts big blind 100
*** HOLE CARDS ***
s70n3fac3: raises 100 to 200
FDIBA2009: folds 
Uncalled bet (100) returned to s70n3fac3
s70n3fac3 collected 200 from pot
s70n3fac3: doesn't show hand 
*** SUMMARY ***
Total pot 200 | Rake 0 
Seat 1: s70n3fac3 (button) (small blind) collected (200)
Seat 2: FDIBA2009 (big blind) folded before Flop



PokerStars Home Game Hand #226820449350: {Club #4781089}  Hold'em No Limit (50/100) - 2021/05/17 0:24:46 EET [2021/05/16 17:24:46 ET]
Table 'VTPP NLHE 1605' 2-max (Play Money) Seat #2 is the button
Seat 1: s70n3fac3 (10637 in chips) 
Seat 2: FDIBA2009 (4060 in chips) 
FDIBA2009: posts small blind 50
s70n3fac3: posts big blind 100
*** HOLE CARDS ***
FDIBA2009: raises 100 to 200
s70n3fac3: raises 400 to 600
FDIBA2009: calls 400
*** FLOP *** [4c 3c 9c]
s70n3fac3: checks 
FDIBA2009: checks 
*** TURN *** [4c 3c 9c] [Ac]
s70n3fac3: checks 
FDIBA2009: checks 
*** RIVER *** [4c 3c 9c Ac] [5d]
s70n3fac3: checks 
FDIBA2009: bets 700
s70n3fac3: calls 700
*** SHOW DOWN ***
FDIBA2009: shows [Kc 5c] (a flush, Ace high)
s70n3fac3: mucks hand 
FDIBA2009 collected 2457 from pot
*** SUMMARY ***
Total pot 2600 | Rake 143 
Board [4c 3c 9c Ac 5d]
Seat 1: s70n3fac3 (big blind) mucked [Td Ah]
Seat 2: FDIBA2009 (button) (small blind) showed [Kc 5c] and won (2457) with a flush, Ace high



PokerStars Home Game Hand #226820465150: {Club #4781089}  Hold'em No Limit (50/100) - 2021/05/17 0:25:13 EET [2021/05/16 17:25:13 ET]
Table 'VTPP NLHE 1605' 2-max (Play Money) Seat #1 is the button
Seat 1: s70n3fac3 (9337 in chips) 
Seat 2: FDIBA2009 (5217 in chips) 
s70n3fac3: posts small blind 50
FDIBA2009: posts big blind 100
*** HOLE CARDS ***
s70n3fac3: calls 50
FDIBA2009: raises 100 to 200
s70n3fac3: calls 100
*** FLOP *** [4h Jc 2c]
FDIBA2009: checks 
s70n3fac3: checks 
*** TURN *** [4h Jc 2c] [Qd]
FDIBA2009: bets 300
s70n3fac3: folds 
Uncalled bet (300) returned to FDIBA2009
FDIBA2009 collected 378 from pot
*** SUMMARY ***
Total pot 400 | Rake 22 
Board [4h Jc 2c Qd]
Seat 1: s70n3fac3 (button) (small blind) folded on the Turn
Seat 2: FDIBA2009 (big blind) collected (378)



PokerStars Home Game Hand #226820476967: {Club #4781089}  Hold'em No Limit (50/100) - 2021/05/17 0:25:33 EET [2021/05/16 17:25:33 ET]
Table 'VTPP NLHE 1605' 2-max (Play Money) Seat #2 is the button
Seat 1: s70n3fac3 (9137 in chips) 
Seat 2: FDIBA2009 (5395 in chips) 
FDIBA2009: posts small blind 50
s70n3fac3: posts big blind 100
*** HOLE CARDS ***
FDIBA2009: folds 
Uncalled bet (50) returned to s70n3fac3
s70n3fac3 collected 100 from pot
s70n3fac3: doesn't show hand 
*** SUMMARY ***
Total pot 100 | Rake 0 
Seat 1: s70n3fac3 (big blind) collected (100)
Seat 2: FDIBA2009 (button) (small blind) folded before Flop



PokerStars Home Game Hand #226820480258: {Club #4781089}  Hold'em No Limit (50/100) - 2021/05/17 0:25:39 EET [2021/05/16 17:25:39 ET]
Table 'VTPP NLHE 1605' 2-max (Play Money) Seat #1 is the button
Seat 1: s70n3fac3 (9187 in chips) 
Seat 2: FDIBA2009 (5345 in chips) 
s70n3fac3: posts small blind 50
FDIBA2009: posts big blind 100
*** HOLE CARDS ***
s70n3fac3: folds 
Uncalled bet (50) returned to FDIBA2009
FDIBA2009 collected 100 from pot
*** SUMMARY ***
Total pot 100 | Rake 0 
Seat 1: s70n3fac3 (button) (small blind) folded before Flop
Seat 2: FDIBA2009 (big blind) collected (100)



PokerStars Home Game Hand #226820482591: {Club #4781089}  Hold'em No Limit (50/100) - 2021/05/17 0:25:43 EET [2021/05/16 17:25:43 ET]
Table 'VTPP NLHE 1605' 2-max (Play Money) Seat #2 is the button
Seat 1: s70n3fac3 (9137 in chips) 
Seat 2: FDIBA2009 (5395 in chips) 
FDIBA2009: posts small blind 50
s70n3fac3: posts big blind 100
*** HOLE CARDS ***
FDIBA2009: raises 100 to 200
s70n3fac3: raises 400 to 600
FDIBA2009: calls 400
*** FLOP *** [2d Js As]
s70n3fac3: checks 
FDIBA2009: checks 
*** TURN *** [2d Js As] [Jh]
s70n3fac3: checks 
FDIBA2009: bets 300
s70n3fac3: calls 300
*** RIVER *** [2d Js As Jh] [Ah]
s70n3fac3: checks 
FDIBA2009: bets 600
s70n3fac3: folds 
Uncalled bet (600) returned to FDIBA2009
FDIBA2009 collected 1701 from pot
*** SUMMARY ***
Total pot 1800 | Rake 99 
Board [2d Js As Jh Ah]
Seat 1: s70n3fac3 (big blind) folded on the River
Seat 2: FDIBA2009 (button) (small blind) collected (1701)



PokerStars Home Game Hand #226820502240: {Club #4781089}  Hold'em No Limit (50/100) - 2021/05/17 0:26:17 EET [2021/05/16 17:26:17 ET]
Table 'VTPP NLHE 1605' 2-max (Play Money) Seat #1 is the button
Seat 1: s70n3fac3 (8237 in chips) 
Seat 2: FDIBA2009 (6196 in chips) 
s70n3fac3: posts small blind 50
FDIBA2009: posts big blind 100
*** HOLE CARDS ***
s70n3fac3: raises 100 to 200
FDIBA2009: calls 100
*** FLOP *** [Qd 7c 8d]
FDIBA2009: checks 
s70n3fac3: checks 
*** TURN *** [Qd 7c 8d] [4c]
FDIBA2009: checks 
s70n3fac3: checks 
*** RIVER *** [Qd 7c 8d 4c] [5d]
FDIBA2009: bets 400
s70n3fac3: raises 400 to 800
FDIBA2009: calls 400
*** SHOW DOWN ***
s70n3fac3: shows [Kd 6s] (a straight, Four to Eight)
FDIBA2009: shows [6h Js] (a straight, Four to Eight)
FDIBA2009 collected 945 from pot
s70n3fac3 collected 945 from pot
*** SUMMARY ***
Total pot 2000 | Rake 110 
Board [Qd 7c 8d 4c 5d]
Seat 1: s70n3fac3 (button) (small blind) showed [Kd 6s] and won (945) with a straight, Four to Eight
Seat 2: FDIBA2009 (big blind) showed [6h Js] and won (945) with a straight, Four to Eight



PokerStars Home Game Hand #226820515850: {Club #4781089}  Hold'em No Limit (50/100) - 2021/05/17 0:26:40 EET [2021/05/16 17:26:40 ET]
Table 'VTPP NLHE 1605' 2-max (Play Money) Seat #2 is the button
Seat 1: s70n3fac3 (8182 in chips) 
Seat 2: FDIBA2009 (6141 in chips) 
FDIBA2009: posts small blind 50
s70n3fac3: posts big blind 100
*** HOLE CARDS ***
FDIBA2009: raises 100 to 200
s70n3fac3: folds 
Uncalled bet (100) returned to FDIBA2009
FDIBA2009 collected 200 from pot
*** SUMMARY ***
Total pot 200 | Rake 0 
Seat 1: s70n3fac3 (big blind) folded before Flop
Seat 2: FDIBA2009 (button) (small blind) collected (200)



PokerStars Home Game Hand #226820519680: {Club #4781089}  Hold'em No Limit (50/100) - 2021/05/17 0:26:47 EET [2021/05/16 17:26:47 ET]
Table 'VTPP NLHE 1605' 2-max (Play Money) Seat #1 is the button
Seat 1: s70n3fac3 (8082 in chips) 
Seat 2: FDIBA2009 (6241 in chips) 
s70n3fac3: posts small blind 50
FDIBA2009: posts big blind 100
*** HOLE CARDS ***
s70n3fac3: folds 
Uncalled bet (50) returned to FDIBA2009
FDIBA2009 collected 100 from pot
*** SUMMARY ***
Total pot 100 | Rake 0 
Seat 1: s70n3fac3 (button) (small blind) folded before Flop
Seat 2: FDIBA2009 (big blind) collected (100)



PokerStars Home Game Hand #226820521926: {Club #4781089}  Hold'em No Limit (50/100) - 2021/05/17 0:26:51 EET [2021/05/16 17:26:51 ET]
Table 'VTPP NLHE 1605' 2-max (Play Money) Seat #2 is the button
Seat 1: s70n3fac3 (8032 in chips) 
Seat 2: FDIBA2009 (6291 in chips) 
FDIBA2009: posts small blind 50
s70n3fac3: posts big blind 100
*** HOLE CARDS ***
FDIBA2009: raises 100 to 200
s70n3fac3: calls 100
*** FLOP *** [7c 6h 2h]
s70n3fac3: checks 
FDIBA2009: bets 200
s70n3fac3: raises 400 to 600
FDIBA2009: calls 400
*** TURN *** [7c 6h 2h] [5d]
s70n3fac3: bets 800
FDIBA2009: calls 800
*** RIVER *** [7c 6h 2h 5d] [Qc]
s70n3fac3: bets 1300
FDIBA2009: raises 3391 to 4691 and is all-in
s70n3fac3: calls 3391
*** SHOW DOWN ***
FDIBA2009: shows [9c 8h] (a straight, Five to Nine)
s70n3fac3: shows [7h 9d] (a pair of Sevens)
FDIBA2009 collected 11890 from pot
*** SUMMARY ***
Total pot 12582 | Rake 692 
Board [7c 6h 2h 5d Qc]
Seat 1: s70n3fac3 (big blind) showed [7h 9d] and lost with a pair of Sevens
Seat 2: FDIBA2009 (button) (small blind) showed [9c 8h] and won (11890) with a straight, Five to Nine



PokerStars Home Game Hand #226820553297: {Club #4781089}  Hold'em No Limit (50/100) - 2021/05/17 0:27:45 EET [2021/05/16 17:27:45 ET]
Table 'VTPP NLHE 1605' 2-max (Play Money) Seat #1 is the button
Seat 1: s70n3fac3 (1741 in chips) 
Seat 2: FDIBA2009 (11890 in chips) 
s70n3fac3: posts small blind 50
FDIBA2009: posts big blind 100
*** HOLE CARDS ***
s70n3fac3: calls 50
FDIBA2009: raises 200 to 300
s70n3fac3: calls 200
*** FLOP *** [Td 7h 5h]
FDIBA2009: checks 
s70n3fac3: checks 
*** TURN *** [Td 7h 5h] [4d]
FDIBA2009: bets 200
s70n3fac3: calls 200
*** RIVER *** [Td 7h 5h 4d] [Jh]
FDIBA2009: checks 
s70n3fac3: checks 
*** SHOW DOWN ***
FDIBA2009: shows [Kd Qh] (high card King)
s70n3fac3: mucks hand 
FDIBA2009 collected 945 from pot
*** SUMMARY ***
Total pot 1000 | Rake 55 
Board [Td 7h 5h 4d Jh]
Seat 1: s70n3fac3 (button) (small blind) mucked [6h Qs]
Seat 2: FDIBA2009 (big blind) showed [Kd Qh] and won (945) with high card King



PokerStars Home Game Hand #226820567860: {Club #4781089}  Hold'em No Limit (50/100) - 2021/05/17 0:28:10 EET [2021/05/16 17:28:10 ET]
Table 'VTPP NLHE 1605' 2-max (Play Money) Seat #2 is the button
Seat 1: s70n3fac3 (1241 in chips) 
Seat 2: FDIBA2009 (12335 in chips) 
FDIBA2009: posts small blind 50
s70n3fac3: posts big blind 100
*** HOLE CARDS ***
FDIBA2009: raises 100 to 200
s70n3fac3: folds 
Uncalled bet (100) returned to FDIBA2009
FDIBA2009 collected 200 from pot
*** SUMMARY ***
Total pot 200 | Rake 0 
Seat 1: s70n3fac3 (big blind) folded before Flop
Seat 2: FDIBA2009 (button) (small blind) collected (200)



PokerStars Home Game Hand #226820571393: {Club #4781089}  Hold'em No Limit (50/100) - 2021/05/17 0:28:16 EET [2021/05/16 17:28:16 ET]
Table 'VTPP NLHE 1605' 2-max (Play Money) Seat #1 is the button
Seat 1: s70n3fac3 (1141 in chips) 
Seat 2: FDIBA2009 (12435 in chips) 
s70n3fac3: posts small blind 50
FDIBA2009: posts big blind 100
*** HOLE CARDS ***
s70n3fac3: calls 50
FDIBA2009: raises 12335 to 12435 and is all-in
s70n3fac3: calls 1041 and is all-in
Uncalled bet (11294) returned to FDIBA2009
*** FLOP *** [8c 9c 3c]
*** TURN *** [8c 9c 3c] [Td]
*** RIVER *** [8c 9c 3c Td] [3h]
*** SHOW DOWN ***
FDIBA2009: shows [8h 8s] (a full house, Eights full of Threes)
s70n3fac3: shows [Ts Qh] (two pair, Tens and Threes)
FDIBA2009 collected 2156 from pot
*** SUMMARY ***
Total pot 2282 | Rake 126 
Board [8c 9c 3c Td 3h]
Seat 1: s70n3fac3 (button) (small blind) showed [Ts Qh] and lost with two pair, Tens and Threes
Seat 2: FDIBA2009 (big blind) showed [8h 8s] and won (2156) with a full house, Eights full of Threes



PokerStars Home Game Hand #226820587522: {Club #4781089}  Hold'em No Limit (50/100) - 2021/05/17 0:28:45 EET [2021/05/16 17:28:45 ET]
Table 'VTPP NLHE 1605' 2-max (Play Money) Seat #2 is the button
Seat 1: s70n3fac3 (10000 in chips) 
Seat 2: FDIBA2009 (13450 in chips) 
FDIBA2009: posts small blind 50
s70n3fac3: posts big blind 100
*** HOLE CARDS ***
FDIBA2009: raises 100 to 200
s70n3fac3: raises 400 to 600
FDIBA2009: calls 400
*** FLOP *** [Tc 5s 2s]
s70n3fac3: checks 
FDIBA2009: checks 
*** TURN *** [Tc 5s 2s] [4s]
s70n3fac3: checks 
FDIBA2009: bets 300
s70n3fac3: calls 300
*** RIVER *** [Tc 5s 2s 4s] [2d]
s70n3fac3: checks 
FDIBA2009: bets 900
s70n3fac3: calls 900
*** SHOW DOWN ***
FDIBA2009: shows [9s Js] (a flush, Jack high)
s70n3fac3: mucks hand 
FDIBA2009 collected 3402 from pot
*** SUMMARY ***
Total pot 3600 | Rake 198 
Board [Tc 5s 2s 4s 2d]
Seat 1: s70n3fac3 (big blind) mucked [Jh Ad]
Seat 2: FDIBA2009 (button) (small blind) showed [9s Js] and won (3402) with a flush, Jack high



PokerStars Home Game Hand #226820604051: {Club #4781089}  Hold'em No Limit (50/100) - 2021/05/17 0:29:14 EET [2021/05/16 17:29:14 ET]
Table 'VTPP NLHE 1605' 2-max (Play Money) Seat #1 is the button
Seat 1: s70n3fac3 (8200 in chips) 
Seat 2: FDIBA2009 (15052 in chips) 
s70n3fac3: posts small blind 50
FDIBA2009: posts big blind 100
*** HOLE CARDS ***
s70n3fac3: raises 100 to 200
FDIBA2009: calls 100
*** FLOP *** [8h 6s 6h]
FDIBA2009: checks 
s70n3fac3: checks 
*** TURN *** [8h 6s 6h] [5h]
FDIBA2009: checks 
s70n3fac3: checks 
*** RIVER *** [8h 6s 6h 5h] [3h]
FDIBA2009: bets 300
s70n3fac3: folds 
Uncalled bet (300) returned to FDIBA2009
FDIBA2009 collected 378 from pot
*** SUMMARY ***
Total pot 400 | Rake 22 
Board [8h 6s 6h 5h 3h]
Seat 1: s70n3fac3 (button) (small blind) folded on the River
Seat 2: FDIBA2009 (big blind) collected (378)



PokerStars Home Game Hand #226820617011: {Club #4781089}  Hold'em No Limit (50/100) - 2021/05/17 0:29:36 EET [2021/05/16 17:29:36 ET]
Table 'VTPP NLHE 1605' 2-max (Play Money) Seat #2 is the button
Seat 1: s70n3fac3 (8000 in chips) 
Seat 2: FDIBA2009 (15230 in chips) 
FDIBA2009: posts small blind 50
s70n3fac3: posts big blind 100
*** HOLE CARDS ***
FDIBA2009: raises 100 to 200
s70n3fac3: calls 100
*** FLOP *** [7d 6h 8d]
s70n3fac3: checks 
FDIBA2009: checks 
*** TURN *** [7d 6h 8d] [Qh]
s70n3fac3: bets 200
FDIBA2009: folds 
Uncalled bet (200) returned to s70n3fac3
s70n3fac3 collected 378 from pot
s70n3fac3: doesn't show hand 
*** SUMMARY ***
Total pot 400 | Rake 22 
Board [7d 6h 8d Qh]
Seat 1: s70n3fac3 (big blind) collected (378)
Seat 2: FDIBA2009 (button) (small blind) folded on the Turn



PokerStars Home Game Hand #226820623955: {Club #4781089}  Hold'em No Limit (50/100) - 2021/05/17 0:29:49 EET [2021/05/16 17:29:49 ET]
Table 'VTPP NLHE 1605' 2-max (Play Money) Seat #1 is the button
Seat 1: s70n3fac3 (8178 in chips) 
Seat 2: FDIBA2009 (15030 in chips) 
s70n3fac3: posts small blind 50
FDIBA2009: posts big blind 100
*** HOLE CARDS ***
s70n3fac3: raises 100 to 200
FDIBA2009: calls 100
*** FLOP *** [6s 9d Ah]
FDIBA2009: checks 
s70n3fac3: bets 200
FDIBA2009: calls 200
*** TURN *** [6s 9d Ah] [Ad]
FDIBA2009: checks 
s70n3fac3: checks 
*** RIVER *** [6s 9d Ah Ad] [7d]
FDIBA2009: bets 500
s70n3fac3: folds 
Uncalled bet (500) returned to FDIBA2009
FDIBA2009 collected 756 from pot
*** SUMMARY ***
Total pot 800 | Rake 44 
Board [6s 9d Ah Ad 7d]
Seat 1: s70n3fac3 (button) (small blind) folded on the River
Seat 2: FDIBA2009 (big blind) collected (756)



PokerStars Home Game Hand #226820637515: {Club #4781089}  Hold'em No Limit (50/100) - 2021/05/17 0:30:12 EET [2021/05/16 17:30:12 ET]
Table 'VTPP NLHE 1605' 2-max (Play Money) Seat #2 is the button
Seat 1: s70n3fac3 (7778 in chips) 
Seat 2: FDIBA2009 (15386 in chips) 
FDIBA2009: posts small blind 50
s70n3fac3: posts big blind 100
*** HOLE CARDS ***
FDIBA2009: raises 100 to 200
s70n3fac3: calls 100
*** FLOP *** [Ad 7d Th]
s70n3fac3: checks 
FDIBA2009: checks 
*** TURN *** [Ad 7d Th] [5s]
s70n3fac3: checks 
FDIBA2009: bets 200
s70n3fac3: raises 500 to 700
FDIBA2009: folds 
Uncalled bet (500) returned to s70n3fac3
s70n3fac3 collected 756 from pot
s70n3fac3: doesn't show hand 
*** SUMMARY ***
Total pot 800 | Rake 44 
Board [Ad 7d Th 5s]
Seat 1: s70n3fac3 (big blind) collected (756)
Seat 2: FDIBA2009 (button) (small blind) folded on the Turn



PokerStars Home Game Hand #226820648714: {Club #4781089}  Hold'em No Limit (50/100) - 2021/05/17 0:30:32 EET [2021/05/16 17:30:32 ET]
Table 'VTPP NLHE 1605' 2-max (Play Money) Seat #1 is the button
Seat 1: s70n3fac3 (8134 in chips) 
Seat 2: FDIBA2009 (14986 in chips) 
s70n3fac3: posts small blind 50
FDIBA2009: posts big blind 100
*** HOLE CARDS ***
s70n3fac3: raises 100 to 200
FDIBA2009: calls 100
*** FLOP *** [3c As Jh]
FDIBA2009: checks 
s70n3fac3: bets 200
FDIBA2009: folds 
Uncalled bet (200) returned to s70n3fac3
s70n3fac3 collected 378 from pot
s70n3fac3: doesn't show hand 
*** SUMMARY ***
Total pot 400 | Rake 22 
Board [3c As Jh]
Seat 1: s70n3fac3 (button) (small blind) collected (378)
Seat 2: FDIBA2009 (big blind) folded on the Flop



PokerStars Home Game Hand #226820654832: {Club #4781089}  Hold'em No Limit (50/100) - 2021/05/17 0:30:43 EET [2021/05/16 17:30:43 ET]
Table 'VTPP NLHE 1605' 2-max (Play Money) Seat #2 is the button
Seat 1: s70n3fac3 (8312 in chips) 
Seat 2: FDIBA2009 (14786 in chips) 
FDIBA2009: posts small blind 50
s70n3fac3: posts big blind 100
*** HOLE CARDS ***
FDIBA2009: folds 
Uncalled bet (50) returned to s70n3fac3
s70n3fac3 collected 100 from pot
s70n3fac3: doesn't show hand 
*** SUMMARY ***
Total pot 100 | Rake 0 
Seat 1: s70n3fac3 (big blind) collected (100)
Seat 2: FDIBA2009 (button) (small blind) folded before Flop



PokerStars Home Game Hand #226820658574: {Club #4781089}  Hold'em No Limit (50/100) - 2021/05/17 0:30:49 EET [2021/05/16 17:30:49 ET]
Table 'VTPP NLHE 1605' 2-max (Play Money) Seat #1 is the button
Seat 1: s70n3fac3 (8362 in chips) 
Seat 2: FDIBA2009 (14736 in chips) 
s70n3fac3: posts small blind 50
FDIBA2009: posts big blind 100
*** HOLE CARDS ***
s70n3fac3: raises 100 to 200
FDIBA2009: calls 100
*** FLOP *** [Ad 5h 8d]
FDIBA2009: checks 
s70n3fac3: checks 
*** TURN *** [Ad 5h 8d] [Jd]
FDIBA2009: bets 378
s70n3fac3: calls 378
*** RIVER *** [Ad 5h 8d Jd] [4h]
FDIBA2009: checks 
s70n3fac3: bets 1325
FDIBA2009: folds 
Uncalled bet (1325) returned to s70n3fac3
s70n3fac3 collected 1092 from pot
s70n3fac3: doesn't show hand 
*** SUMMARY ***
Total pot 1156 | Rake 64 
Board [Ad 5h 8d Jd 4h]
Seat 1: s70n3fac3 (button) (small blind) collected (1092)
Seat 2: FDIBA2009 (big blind) folded on the River



PokerStars Home Game Hand #226820673906: {Club #4781089}  Hold'em No Limit (50/100) - 2021/05/17 0:31:16 EET [2021/05/16 17:31:16 ET]
Table 'VTPP NLHE 1605' 2-max (Play Money) Seat #2 is the button
Seat 1: s70n3fac3 (8876 in chips) 
Seat 2: FDIBA2009 (14158 in chips) 
FDIBA2009: posts small blind 50
s70n3fac3: posts big blind 100
*** HOLE CARDS ***
FDIBA2009: raises 100 to 200
s70n3fac3: folds 
Uncalled bet (100) returned to FDIBA2009
FDIBA2009 collected 200 from pot
*** SUMMARY ***
Total pot 200 | Rake 0 
Seat 1: s70n3fac3 (big blind) folded before Flop
Seat 2: FDIBA2009 (button) (small blind) collected (200)



PokerStars Home Game Hand #226820677210: {Club #4781089}  Hold'em No Limit (50/100) - 2021/05/17 0:31:22 EET [2021/05/16 17:31:22 ET]
Table 'VTPP NLHE 1605' 2-max (Play Money) Seat #1 is the button
Seat 1: s70n3fac3 (8776 in chips) 
Seat 2: FDIBA2009 (14258 in chips) 
s70n3fac3: posts small blind 50
FDIBA2009: posts big blind 100
*** HOLE CARDS ***
s70n3fac3: folds 
Uncalled bet (50) returned to FDIBA2009
FDIBA2009 collected 100 from pot
*** SUMMARY ***
Total pot 100 | Rake 0 
Seat 1: s70n3fac3 (button) (small blind) folded before Flop
Seat 2: FDIBA2009 (big blind) collected (100)



PokerStars Home Game Hand #226820679281: {Club #4781089}  Hold'em No Limit (50/100) - 2021/05/17 0:31:26 EET [2021/05/16 17:31:26 ET]
Table 'VTPP NLHE 1605' 2-max (Play Money) Seat #2 is the button
Seat 1: s70n3fac3 (8726 in chips) 
Seat 2: FDIBA2009 (14308 in chips) 
FDIBA2009: posts small blind 50
s70n3fac3: posts big blind 100
*** HOLE CARDS ***
FDIBA2009: raises 100 to 200
s70n3fac3: calls 100
*** FLOP *** [Tc 9s 6s]
s70n3fac3: checks 
FDIBA2009: checks 
*** TURN *** [Tc 9s 6s] [Kd]
s70n3fac3: checks 
FDIBA2009: bets 300
s70n3fac3: folds 
Uncalled bet (300) returned to FDIBA2009
FDIBA2009 collected 378 from pot
*** SUMMARY ***
Total pot 400 | Rake 22 
Board [Tc 9s 6s Kd]
Seat 1: s70n3fac3 (big blind) folded on the Turn
Seat 2: FDIBA2009 (button) (small blind) collected (378)



PokerStars Home Game Hand #226820688040: {Club #4781089}  Hold'em No Limit (50/100) - 2021/05/17 0:31:41 EET [2021/05/16 17:31:41 ET]
Table 'VTPP NLHE 1605' 2-max (Play Money) Seat #1 is the button
Seat 1: s70n3fac3 (8526 in chips) 
Seat 2: FDIBA2009 (14486 in chips) 
s70n3fac3: posts small blind 50
FDIBA2009: posts big blind 100
*** HOLE CARDS ***
s70n3fac3: raises 100 to 200
FDIBA2009: calls 100
*** FLOP *** [Jh 3h 5h]
FDIBA2009: checks 
s70n3fac3: checks 
*** TURN *** [Jh 3h 5h] [4h]
FDIBA2009: checks 
s70n3fac3: bets 100
FDIBA2009: folds 
Uncalled bet (100) returned to s70n3fac3
s70n3fac3 collected 378 from pot
s70n3fac3: doesn't show hand 
*** SUMMARY ***
Total pot 400 | Rake 22 
Board [Jh 3h 5h 4h]
Seat 1: s70n3fac3 (button) (small blind) collected (378)
Seat 2: FDIBA2009 (big blind) folded on the Turn



PokerStars Home Game Hand #226820697620: {Club #4781089}  Hold'em No Limit (50/100) - 2021/05/17 0:31:58 EET [2021/05/16 17:31:58 ET]
Table 'VTPP NLHE 1605' 2-max (Play Money) Seat #2 is the button
Seat 1: s70n3fac3 (8704 in chips) 
Seat 2: FDIBA2009 (14286 in chips) 
FDIBA2009: posts small blind 50
s70n3fac3: posts big blind 100
*** HOLE CARDS ***
FDIBA2009: folds 
Uncalled bet (50) returned to s70n3fac3
s70n3fac3 collected 100 from pot
s70n3fac3: doesn't show hand 
*** SUMMARY ***
Total pot 100 | Rake 0 
Seat 1: s70n3fac3 (big blind) collected (100)
Seat 2: FDIBA2009 (button) (small blind) folded before Flop



PokerStars Home Game Hand #226820700198: {Club #4781089}  Hold'em No Limit (50/100) - 2021/05/17 0:32:02 EET [2021/05/16 17:32:02 ET]
Table 'VTPP NLHE 1605' 2-max (Play Money) Seat #1 is the button
Seat 1: s70n3fac3 (8754 in chips) 
Seat 2: FDIBA2009 (14236 in chips) 
s70n3fac3: posts small blind 50
FDIBA2009: posts big blind 100
*** HOLE CARDS ***
s70n3fac3: raises 100 to 200
FDIBA2009: calls 100
*** FLOP *** [Js As 6c]
FDIBA2009: checks 
s70n3fac3: checks 
*** TURN *** [Js As 6c] [8s]
FDIBA2009: bets 300
s70n3fac3: folds 
Uncalled bet (300) returned to FDIBA2009
FDIBA2009 collected 378 from pot
*** SUMMARY ***
Total pot 400 | Rake 22 
Board [Js As 6c 8s]
Seat 1: s70n3fac3 (button) (small blind) folded on the Turn
Seat 2: FDIBA2009 (big blind) collected (378)



PokerStars Home Game Hand #226820710071: {Club #4781089}  Hold'em No Limit (50/100) - 2021/05/17 0:32:19 EET [2021/05/16 17:32:19 ET]
Table 'VTPP NLHE 1605' 2-max (Play Money) Seat #2 is the button
Seat 1: s70n3fac3 (8554 in chips) 
Seat 2: FDIBA2009 (14414 in chips) 
FDIBA2009: posts small blind 50
s70n3fac3: posts big blind 100
*** HOLE CARDS ***
FDIBA2009: raises 100 to 200
s70n3fac3: calls 100
*** FLOP *** [Ah 5d Js]
s70n3fac3: checks 
FDIBA2009: bets 300
s70n3fac3: folds 
Uncalled bet (300) returned to FDIBA2009
FDIBA2009 collected 378 from pot
*** SUMMARY ***
Total pot 400 | Rake 22 
Board [Ah 5d Js]
Seat 1: s70n3fac3 (big blind) folded on the Flop
Seat 2: FDIBA2009 (button) (small blind) collected (378)



PokerStars Home Game Hand #226820716364: {Club #4781089}  Hold'em No Limit (50/100) - 2021/05/17 0:32:31 EET [2021/05/16 17:32:31 ET]
Table 'VTPP NLHE 1605' 2-max (Play Money) Seat #1 is the button
Seat 1: s70n3fac3 (8354 in chips) 
Seat 2: FDIBA2009 (14592 in chips) 
s70n3fac3: posts small blind 50
FDIBA2009: posts big blind 100
*** HOLE CARDS ***
s70n3fac3: raises 100 to 200
FDIBA2009: folds 
Uncalled bet (100) returned to s70n3fac3
s70n3fac3 collected 200 from pot
s70n3fac3: doesn't show hand 
*** SUMMARY ***
Total pot 200 | Rake 0 
Seat 1: s70n3fac3 (button) (small blind) collected (200)
Seat 2: FDIBA2009 (big blind) folded before Flop



PokerStars Home Game Hand #226820719458: {Club #4781089}  Hold'em No Limit (50/100) - 2021/05/17 0:32:36 EET [2021/05/16 17:32:36 ET]
Table 'VTPP NLHE 1605' 2-max (Play Money) Seat #2 is the button
Seat 1: s70n3fac3 (8454 in chips) 
Seat 2: FDIBA2009 (14492 in chips) 
FDIBA2009: posts small blind 50
s70n3fac3: posts big blind 100
*** HOLE CARDS ***
FDIBA2009: raises 100 to 200
s70n3fac3: calls 100
*** FLOP *** [2d Ad 5c]
s70n3fac3: checks 
FDIBA2009: bets 200
s70n3fac3: raises 400 to 600
FDIBA2009: calls 400
*** TURN *** [2d Ad 5c] [Kc]
s70n3fac3: bets 800
FDIBA2009: folds 
Uncalled bet (800) returned to s70n3fac3
s70n3fac3 collected 1512 from pot
s70n3fac3: doesn't show hand 
*** SUMMARY ***
Total pot 1600 | Rake 88 
Board [2d Ad 5c Kc]
Seat 1: s70n3fac3 (big blind) collected (1512)
Seat 2: FDIBA2009 (button) (small blind) folded on the Turn



PokerStars Home Game Hand #226820736164: {Club #4781089}  Hold'em No Limit (50/100) - 2021/05/17 0:33:06 EET [2021/05/16 17:33:06 ET]
Table 'VTPP NLHE 1605' 2-max (Play Money) Seat #1 is the button
Seat 1: s70n3fac3 (9166 in chips) 
Seat 2: FDIBA2009 (13692 in chips) 
s70n3fac3: posts small blind 50
FDIBA2009: posts big blind 100
*** HOLE CARDS ***
s70n3fac3: raises 100 to 200
FDIBA2009: calls 100
*** FLOP *** [Ah Js 2c]
FDIBA2009: checks 
s70n3fac3: bets 200
FDIBA2009: folds 
Uncalled bet (200) returned to s70n3fac3
s70n3fac3 collected 378 from pot
s70n3fac3: doesn't show hand 
*** SUMMARY ***
Total pot 400 | Rake 22 
Board [Ah Js 2c]
Seat 1: s70n3fac3 (button) (small blind) collected (378)
Seat 2: FDIBA2009 (big blind) folded on the Flop



PokerStars Home Game Hand #226820743069: {Club #4781089}  Hold'em No Limit (50/100) - 2021/05/17 0:33:18 EET [2021/05/16 17:33:18 ET]
Table 'VTPP NLHE 1605' 2-max (Play Money) Seat #2 is the button
Seat 1: s70n3fac3 (9344 in chips) 
Seat 2: FDIBA2009 (13492 in chips) 
FDIBA2009: posts small blind 50
s70n3fac3: posts big blind 100
*** HOLE CARDS ***
FDIBA2009: raises 100 to 200
s70n3fac3: folds 
Uncalled bet (100) returned to FDIBA2009
FDIBA2009 collected 200 from pot
*** SUMMARY ***
Total pot 200 | Rake 0 
Seat 1: s70n3fac3 (big blind) folded before Flop
Seat 2: FDIBA2009 (button) (small blind) collected (200)



PokerStars Home Game Hand #226820746334: {Club #4781089}  Hold'em No Limit (50/100) - 2021/05/17 0:33:24 EET [2021/05/16 17:33:24 ET]
Table 'VTPP NLHE 1605' 2-max (Play Money) Seat #1 is the button
Seat 1: s70n3fac3 (9244 in chips) 
Seat 2: FDIBA2009 (13592 in chips) 
s70n3fac3: posts small blind 50
FDIBA2009: posts big blind 100
*** HOLE CARDS ***
s70n3fac3: raises 100 to 200
FDIBA2009: calls 100
*** FLOP *** [6h 4s 9d]
FDIBA2009: checks 
s70n3fac3: bets 200
FDIBA2009: calls 200
*** TURN *** [6h 4s 9d] [4c]
FDIBA2009: checks 
s70n3fac3: bets 400
FDIBA2009: calls 400
*** RIVER *** [6h 4s 9d 4c] [Js]
FDIBA2009: checks 
s70n3fac3: checks 
*** SHOW DOWN ***
FDIBA2009: shows [Th 9s] (two pair, Nines and Fours)
s70n3fac3: mucks hand 
FDIBA2009 collected 1512 from pot
*** SUMMARY ***
Total pot 1600 | Rake 88 
Board [6h 4s 9d 4c Js]
Seat 1: s70n3fac3 (button) (small blind) mucked [2d 6d]
Seat 2: FDIBA2009 (big blind) showed [Th 9s] and won (1512) with two pair, Nines and Fours



PokerStars Home Game Hand #226820759462: {Club #4781089}  Hold'em No Limit (50/100) - 2021/05/17 0:33:47 EET [2021/05/16 17:33:47 ET]
Table 'VTPP NLHE 1605' 2-max (Play Money) Seat #2 is the button
Seat 1: s70n3fac3 (8444 in chips) 
Seat 2: FDIBA2009 (14304 in chips) 
FDIBA2009: posts small blind 50
s70n3fac3: posts big blind 100
*** HOLE CARDS ***
FDIBA2009: raises 100 to 200
s70n3fac3: calls 100
*** FLOP *** [4c 8d Jd]
s70n3fac3: checks 
FDIBA2009: checks 
*** TURN *** [4c 8d Jd] [Td]
s70n3fac3: checks 
FDIBA2009: bets 378
s70n3fac3: calls 378
*** RIVER *** [4c 8d Jd Td] [Ac]
s70n3fac3: checks 
FDIBA2009: bets 600
s70n3fac3: folds 
Uncalled bet (600) returned to FDIBA2009
FDIBA2009 collected 1092 from pot
*** SUMMARY ***
Total pot 1156 | Rake 64 
Board [4c 8d Jd Td Ac]
Seat 1: s70n3fac3 (big blind) folded on the River
Seat 2: FDIBA2009 (button) (small blind) collected (1092)



PokerStars Home Game Hand #226820775733: {Club #4781089}  Hold'em No Limit (50/100) - 2021/05/17 0:34:17 EET [2021/05/16 17:34:17 ET]
Table 'VTPP NLHE 1605' 2-max (Play Money) Seat #1 is the button
Seat 1: s70n3fac3 (7866 in chips) 
Seat 2: FDIBA2009 (14818 in chips) 
s70n3fac3: posts small blind 50
FDIBA2009: posts big blind 100
*** HOLE CARDS ***
s70n3fac3: folds 
Uncalled bet (50) returned to FDIBA2009
FDIBA2009 collected 100 from pot
*** SUMMARY ***
Total pot 100 | Rake 0 
Seat 1: s70n3fac3 (button) (small blind) folded before Flop
Seat 2: FDIBA2009 (big blind) collected (100)



PokerStars Home Game Hand #226820777886: {Club #4781089}  Hold'em No Limit (50/100) - 2021/05/17 0:34:21 EET [2021/05/16 17:34:21 ET]
Table 'VTPP NLHE 1605' 2-max (Play Money) Seat #2 is the button
Seat 1: s70n3fac3 (7816 in chips) 
Seat 2: FDIBA2009 (14868 in chips) 
FDIBA2009: posts small blind 50
s70n3fac3: posts big blind 100
*** HOLE CARDS ***
FDIBA2009: raises 100 to 200
s70n3fac3: calls 100
*** FLOP *** [Qd 6h 2d]
s70n3fac3: checks 
FDIBA2009: bets 200
s70n3fac3: folds 
Uncalled bet (200) returned to FDIBA2009
FDIBA2009 collected 378 from pot
*** SUMMARY ***
Total pot 400 | Rake 22 
Board [Qd 6h 2d]
Seat 1: s70n3fac3 (big blind) folded on the Flop
Seat 2: FDIBA2009 (button) (small blind) collected (378)



PokerStars Home Game Hand #226820788839: {Club #4781089}  Hold'em No Limit (50/100) - 2021/05/17 0:34:40 EET [2021/05/16 17:34:40 ET]
Table 'VTPP NLHE 1605' 2-max (Play Money) Seat #1 is the button
Seat 1: s70n3fac3 (7616 in chips) 
Seat 2: FDIBA2009 (15046 in chips) 
s70n3fac3: posts small blind 50
FDIBA2009: posts big blind 100
*** HOLE CARDS ***
s70n3fac3: raises 150 to 250
FDIBA2009: folds 
Uncalled bet (150) returned to s70n3fac3
s70n3fac3 collected 200 from pot
s70n3fac3: doesn't show hand 
*** SUMMARY ***
Total pot 200 | Rake 0 
Seat 1: s70n3fac3 (button) (small blind) collected (200)
Seat 2: FDIBA2009 (big blind) folded before Flop



PokerStars Home Game Hand #226820793377: {Club #4781089}  Hold'em No Limit (50/100) - 2021/05/17 0:34:48 EET [2021/05/16 17:34:48 ET]
Table 'VTPP NLHE 1605' 2-max (Play Money) Seat #2 is the button
Seat 1: s70n3fac3 (7716 in chips) 
Seat 2: FDIBA2009 (14946 in chips) 
FDIBA2009: posts small blind 50
s70n3fac3: posts big blind 100
*** HOLE CARDS ***
FDIBA2009: raises 100 to 200
s70n3fac3: calls 100
*** FLOP *** [6s Tc Th]
s70n3fac3: checks 
FDIBA2009: checks 
*** TURN *** [6s Tc Th] [6d]
s70n3fac3: checks 
FDIBA2009: bets 200
s70n3fac3: folds 
Uncalled bet (200) returned to FDIBA2009
FDIBA2009 collected 378 from pot
*** SUMMARY ***
Total pot 400 | Rake 22 
Board [6s Tc Th 6d]
Seat 1: s70n3fac3 (big blind) folded on the Turn
Seat 2: FDIBA2009 (button) (small blind) collected (378)



PokerStars Home Game Hand #226820802497: {Club #4781089}  Hold'em No Limit (50/100) - 2021/05/17 0:35:04 EET [2021/05/16 17:35:04 ET]
Table 'VTPP NLHE 1605' 2-max (Play Money) Seat #1 is the button
Seat 1: s70n3fac3 (7516 in chips) 
Seat 2: FDIBA2009 (15124 in chips) 
s70n3fac3: posts small blind 50
FDIBA2009: posts big blind 100
*** HOLE CARDS ***
s70n3fac3: folds 
Uncalled bet (50) returned to FDIBA2009
FDIBA2009 collected 100 from pot
*** SUMMARY ***
Total pot 100 | Rake 0 
Seat 1: s70n3fac3 (button) (small blind) folded before Flop
Seat 2: FDIBA2009 (big blind) collected (100)



PokerStars Home Game Hand #226820804636: {Club #4781089}  Hold'em No Limit (50/100) - 2021/05/17 0:35:08 EET [2021/05/16 17:35:08 ET]
Table 'VTPP NLHE 1605' 2-max (Play Money) Seat #2 is the button
Seat 1: s70n3fac3 (7466 in chips) 
Seat 2: FDIBA2009 (15174 in chips) 
FDIBA2009: posts small blind 50
s70n3fac3: posts big blind 100
*** HOLE CARDS ***
FDIBA2009: raises 100 to 200
s70n3fac3: calls 100
*** FLOP *** [Ah 7h 4s]
s70n3fac3: checks 
FDIBA2009: checks 
*** TURN *** [Ah 7h 4s] [Jh]
s70n3fac3: checks 
FDIBA2009: bets 200
s70n3fac3: folds 
Uncalled bet (200) returned to FDIBA2009
FDIBA2009 collected 378 from pot
*** SUMMARY ***
Total pot 400 | Rake 22 
Board [Ah 7h 4s Jh]
Seat 1: s70n3fac3 (big blind) folded on the Turn
Seat 2: FDIBA2009 (button) (small blind) collected (378)



PokerStars Home Game Hand #226820813445: {Club #4781089}  Hold'em No Limit (50/100) - 2021/05/17 0:35:24 EET [2021/05/16 17:35:24 ET]
Table 'VTPP NLHE 1605' 2-max (Play Money) Seat #1 is the button
Seat 1: s70n3fac3 (7266 in chips) 
Seat 2: FDIBA2009 (15352 in chips) 
s70n3fac3: posts small blind 50
FDIBA2009: posts big blind 100
*** HOLE CARDS ***
s70n3fac3: raises 100 to 200
FDIBA2009: calls 100
*** FLOP *** [5d Tc 8h]
FDIBA2009: checks 
s70n3fac3: bets 200
FDIBA2009: calls 200
*** TURN *** [5d Tc 8h] [9d]
FDIBA2009: checks 
s70n3fac3: bets 400
FDIBA2009: calls 400
*** RIVER *** [5d Tc 8h 9d] [Jd]
FDIBA2009: checks 
s70n3fac3: bets 1000
FDIBA2009: folds 
Uncalled bet (1000) returned to s70n3fac3
s70n3fac3 collected 1512 from pot
s70n3fac3: doesn't show hand 
*** SUMMARY ***
Total pot 1600 | Rake 88 
Board [5d Tc 8h 9d Jd]
Seat 1: s70n3fac3 (button) (small blind) collected (1512)
Seat 2: FDIBA2009 (big blind) folded on the River



PokerStars Home Game Hand #226820835700: {Club #4781089}  Hold'em No Limit (50/100) - 2021/05/17 0:36:04 EET [2021/05/16 17:36:04 ET]
Table 'VTPP NLHE 1605' 2-max (Play Money) Seat #2 is the button
Seat 1: s70n3fac3 (7978 in chips) 
Seat 2: FDIBA2009 (14552 in chips) 
FDIBA2009: posts small blind 50
s70n3fac3: posts big blind 100
*** HOLE CARDS ***
FDIBA2009: raises 100 to 200
s70n3fac3: calls 100
*** FLOP *** [2c 4h Ks]
s70n3fac3: checks 
FDIBA2009: bets 200
s70n3fac3: folds 
Uncalled bet (200) returned to FDIBA2009
FDIBA2009 collected 378 from pot
*** SUMMARY ***
Total pot 400 | Rake 22 
Board [2c 4h Ks]
Seat 1: s70n3fac3 (big blind) folded on the Flop
Seat 2: FDIBA2009 (button) (small blind) collected (378)



PokerStars Home Game Hand #226820842924: {Club #4781089}  Hold'em No Limit (50/100) - 2021/05/17 0:36:17 EET [2021/05/16 17:36:17 ET]
Table 'VTPP NLHE 1605' 2-max (Play Money) Seat #1 is the button
Seat 1: s70n3fac3 (7778 in chips) 
Seat 2: FDIBA2009 (14730 in chips) 
s70n3fac3: posts small blind 50
FDIBA2009: posts big blind 100
*** HOLE CARDS ***
s70n3fac3: raises 100 to 200
FDIBA2009: calls 100
*** FLOP *** [5h 9h 7d]
FDIBA2009: checks 
s70n3fac3: bets 200
FDIBA2009: calls 200
*** TURN *** [5h 9h 7d] [6d]
FDIBA2009: checks 
s70n3fac3: bets 400
FDIBA2009: folds 
Uncalled bet (400) returned to s70n3fac3
s70n3fac3 collected 756 from pot
s70n3fac3: doesn't show hand 
*** SUMMARY ***
Total pot 800 | Rake 44 
Board [5h 9h 7d 6d]
Seat 1: s70n3fac3 (button) (small blind) collected (756)
Seat 2: FDIBA2009 (big blind) folded on the Turn



PokerStars Home Game Hand #226820854067: {Club #4781089}  Hold'em No Limit (50/100) - 2021/05/17 0:36:37 EET [2021/05/16 17:36:37 ET]
Table 'VTPP NLHE 1605' 2-max (Play Money) Seat #2 is the button
Seat 1: s70n3fac3 (8134 in chips) 
Seat 2: FDIBA2009 (14330 in chips) 
FDIBA2009: posts small blind 50
s70n3fac3: posts big blind 100
*** HOLE CARDS ***
FDIBA2009: raises 100 to 200
s70n3fac3: calls 100
*** FLOP *** [5s 3d 2d]
s70n3fac3: checks 
FDIBA2009: bets 378
s70n3fac3: calls 378
*** TURN *** [5s 3d 2d] [Jd]
s70n3fac3: checks 
FDIBA2009: bets 500
s70n3fac3: folds 
Uncalled bet (500) returned to FDIBA2009
FDIBA2009 collected 1092 from pot
*** SUMMARY ***
Total pot 1156 | Rake 64 
Board [5s 3d 2d Jd]
Seat 1: s70n3fac3 (big blind) folded on the Turn
Seat 2: FDIBA2009 (button) (small blind) collected (1092)



PokerStars Home Game Hand #226820869410: {Club #4781089}  Hold'em No Limit (50/100) - 2021/05/17 0:37:04 EET [2021/05/16 17:37:04 ET]
Table 'VTPP NLHE 1605' 2-max (Play Money) Seat #1 is the button
Seat 1: s70n3fac3 (7556 in chips) 
Seat 2: FDIBA2009 (14844 in chips) 
s70n3fac3: posts small blind 50
FDIBA2009: posts big blind 100
*** HOLE CARDS ***
s70n3fac3: calls 50
FDIBA2009: checks 
*** FLOP *** [Jc 5s 8h]
FDIBA2009: checks 
s70n3fac3: bets 100
FDIBA2009: folds 
Uncalled bet (100) returned to s70n3fac3
s70n3fac3 collected 189 from pot
s70n3fac3: doesn't show hand 
*** SUMMARY ***
Total pot 200 | Rake 11 
Board [Jc 5s 8h]
Seat 1: s70n3fac3 (button) (small blind) collected (189)
Seat 2: FDIBA2009 (big blind) folded on the Flop



PokerStars Home Game Hand #226820875312: {Club #4781089}  Hold'em No Limit (50/100) - 2021/05/17 0:37:15 EET [2021/05/16 17:37:15 ET]
Table 'VTPP NLHE 1605' 2-max (Play Money) Seat #2 is the button
Seat 1: s70n3fac3 (7645 in chips) 
Seat 2: FDIBA2009 (14744 in chips) 
FDIBA2009: posts small blind 50
s70n3fac3: posts big blind 100
*** HOLE CARDS ***
FDIBA2009: raises 100 to 200
s70n3fac3: calls 100
*** FLOP *** [Jc 2d Th]
s70n3fac3: checks 
FDIBA2009: checks 
*** TURN *** [Jc 2d Th] [Ts]
s70n3fac3: checks 
FDIBA2009: bets 200
s70n3fac3: calls 200
*** RIVER *** [Jc 2d Th Ts] [4s]
s70n3fac3: checks 
FDIBA2009: checks 
*** SHOW DOWN ***
s70n3fac3: shows [7h Ac] (a pair of Tens)
FDIBA2009: shows [4d 5s] (two pair, Tens and Fours)
FDIBA2009 collected 756 from pot
*** SUMMARY ***
Total pot 800 | Rake 44 
Board [Jc 2d Th Ts 4s]
Seat 1: s70n3fac3 (big blind) showed [7h Ac] and lost with a pair of Tens
Seat 2: FDIBA2009 (button) (small blind) showed [4d 5s] and won (756) with two pair, Tens and Fours



PokerStars Home Game Hand #226820887354: {Club #4781089}  Hold'em No Limit (50/100) - 2021/05/17 0:37:36 EET [2021/05/16 17:37:36 ET]
Table 'VTPP NLHE 1605' 2-max (Play Money) Seat #1 is the button
Seat 1: s70n3fac3 (7245 in chips) 
Seat 2: FDIBA2009 (15100 in chips) 
s70n3fac3: posts small blind 50
FDIBA2009: posts big blind 100
*** HOLE CARDS ***
s70n3fac3: calls 50
FDIBA2009: checks 
*** FLOP *** [5c Td 8s]
FDIBA2009: checks 
s70n3fac3: bets 100
FDIBA2009: calls 100
*** TURN *** [5c Td 8s] [As]
FDIBA2009: checks 
s70n3fac3: bets 200
FDIBA2009: calls 200
*** RIVER *** [5c Td 8s As] [Th]
FDIBA2009: checks 
s70n3fac3: bets 400
FDIBA2009: folds 
Uncalled bet (400) returned to s70n3fac3
s70n3fac3 collected 756 from pot
s70n3fac3: doesn't show hand 
*** SUMMARY ***
Total pot 800 | Rake 44 
Board [5c Td 8s As Th]
Seat 1: s70n3fac3 (button) (small blind) collected (756)
Seat 2: FDIBA2009 (big blind) folded on the River



PokerStars Home Game Hand #226820900901: {Club #4781089}  Hold'em No Limit (50/100) - 2021/05/17 0:38:00 EET [2021/05/16 17:38:00 ET]
Table 'VTPP NLHE 1605' 2-max (Play Money) Seat #2 is the button
Seat 1: s70n3fac3 (7601 in chips) 
Seat 2: FDIBA2009 (14700 in chips) 
FDIBA2009: posts small blind 50
s70n3fac3: posts big blind 100
*** HOLE CARDS ***
FDIBA2009: raises 100 to 200
s70n3fac3: folds 
Uncalled bet (100) returned to FDIBA2009
FDIBA2009 collected 200 from pot
*** SUMMARY ***
Total pot 200 | Rake 0 
Seat 1: s70n3fac3 (big blind) folded before Flop
Seat 2: FDIBA2009 (button) (small blind) collected (200)



PokerStars Home Game Hand #226820903698: {Club #4781089}  Hold'em No Limit (50/100) - 2021/05/17 0:38:06 EET [2021/05/16 17:38:06 ET]
Table 'VTPP NLHE 1605' 2-max (Play Money) Seat #1 is the button
Seat 1: s70n3fac3 (7501 in chips) 
Seat 2: FDIBA2009 (14800 in chips) 
s70n3fac3: posts small blind 50
FDIBA2009: posts big blind 100
*** HOLE CARDS ***
s70n3fac3: folds 
Uncalled bet (50) returned to FDIBA2009
FDIBA2009 collected 100 from pot
*** SUMMARY ***
Total pot 100 | Rake 0 
Seat 1: s70n3fac3 (button) (small blind) folded before Flop
Seat 2: FDIBA2009 (big blind) collected (100)



PokerStars Home Game Hand #226820906104: {Club #4781089}  Hold'em No Limit (50/100) - 2021/05/17 0:38:10 EET [2021/05/16 17:38:10 ET]
Table 'VTPP NLHE 1605' 2-max (Play Money) Seat #2 is the button
Seat 1: s70n3fac3 (7451 in chips) 
Seat 2: FDIBA2009 (14850 in chips) 
FDIBA2009: posts small blind 50
s70n3fac3: posts big blind 100
*** HOLE CARDS ***
FDIBA2009: raises 100 to 200
s70n3fac3: calls 100
*** FLOP *** [4c 6d 2s]
s70n3fac3: checks 
FDIBA2009: bets 200
s70n3fac3: calls 200
*** TURN *** [4c 6d 2s] [5s]
s70n3fac3: checks 
FDIBA2009: bets 500
s70n3fac3: folds 
Uncalled bet (500) returned to FDIBA2009
FDIBA2009 collected 756 from pot
*** SUMMARY ***
Total pot 800 | Rake 44 
Board [4c 6d 2s 5s]
Seat 1: s70n3fac3 (big blind) folded on the Turn
Seat 2: FDIBA2009 (button) (small blind) collected (756)



PokerStars Home Game Hand #226820917218: {Club #4781089}  Hold'em No Limit (50/100) - 2021/05/17 0:38:30 EET [2021/05/16 17:38:30 ET]
Table 'VTPP NLHE 1605' 2-max (Play Money) Seat #1 is the button
Seat 1: s70n3fac3 (7051 in chips) 
Seat 2: FDIBA2009 (15206 in chips) 
s70n3fac3: posts small blind 50
FDIBA2009: posts big blind 100
*** HOLE CARDS ***
s70n3fac3: folds 
Uncalled bet (50) returned to FDIBA2009
FDIBA2009 collected 100 from pot
*** SUMMARY ***
Total pot 100 | Rake 0 
Seat 1: s70n3fac3 (button) (small blind) folded before Flop
Seat 2: FDIBA2009 (big blind) collected (100)



PokerStars Home Game Hand #226820920864: {Club #4781089}  Hold'em No Limit (50/100) - 2021/05/17 0:38:34 EET [2021/05/16 17:38:34 ET]
Table 'VTPP NLHE 1605' 2-max (Play Money) Seat #2 is the button
Seat 1: s70n3fac3 (7001 in chips) 
Seat 2: FDIBA2009 (15256 in chips) 
FDIBA2009: posts small blind 50
s70n3fac3: posts big blind 100
*** HOLE CARDS ***
FDIBA2009: raises 100 to 200
s70n3fac3: calls 100
*** FLOP *** [5d 7h 3s]
s70n3fac3: checks 
FDIBA2009: bets 200
s70n3fac3: calls 200
*** TURN *** [5d 7h 3s] [2s]
s70n3fac3: checks 
FDIBA2009: bets 500
s70n3fac3: raises 500 to 1000
FDIBA2009: calls 500
*** RIVER *** [5d 7h 3s 2s] [Qc]
s70n3fac3: bets 1600
FDIBA2009: calls 1600
*** SHOW DOWN ***
s70n3fac3: shows [Ac 4c] (a straight, Ace to Five)
FDIBA2009: mucks hand 
s70n3fac3 collected 5670 from pot
*** SUMMARY ***
Total pot 6000 | Rake 330 
Board [5d 7h 3s 2s Qc]
Seat 1: s70n3fac3 (big blind) showed [Ac 4c] and won (5670) with a straight, Ace to Five
Seat 2: FDIBA2009 (button) (small blind) mucked [7s Kh]



PokerStars Home Game Hand #226820942251: {Club #4781089}  Hold'em No Limit (50/100) - 2021/05/17 0:39:12 EET [2021/05/16 17:39:12 ET]
Table 'VTPP NLHE 1605' 2-max (Play Money) Seat #1 is the button
Seat 1: s70n3fac3 (9671 in chips) 
Seat 2: FDIBA2009 (12256 in chips) 
s70n3fac3: posts small blind 50
FDIBA2009: posts big blind 100
*** HOLE CARDS ***
s70n3fac3: raises 100 to 200
FDIBA2009: calls 100
*** FLOP *** [3c Jh 8h]
FDIBA2009: checks 
s70n3fac3: bets 200
FDIBA2009: folds 
Uncalled bet (200) returned to s70n3fac3
s70n3fac3 collected 378 from pot
s70n3fac3: doesn't show hand 
*** SUMMARY ***
Total pot 400 | Rake 22 
Board [3c Jh 8h]
Seat 1: s70n3fac3 (button) (small blind) collected (378)
Seat 2: FDIBA2009 (big blind) folded on the Flop



PokerStars Home Game Hand #226820948763: {Club #4781089}  Hold'em No Limit (50/100) - 2021/05/17 0:39:24 EET [2021/05/16 17:39:24 ET]
Table 'VTPP NLHE 1605' 2-max (Play Money) Seat #2 is the button
Seat 1: s70n3fac3 (9849 in chips) 
Seat 2: FDIBA2009 (12056 in chips) 
FDIBA2009: posts small blind 50
s70n3fac3: posts big blind 100
*** HOLE CARDS ***
FDIBA2009: raises 100 to 200
s70n3fac3: calls 100
*** FLOP *** [Th Jd 6s]
s70n3fac3: checks 
FDIBA2009: bets 200
s70n3fac3: calls 200
*** TURN *** [Th Jd 6s] [8s]
s70n3fac3: checks 
FDIBA2009: checks 
*** RIVER *** [Th Jd 6s 8s] [3s]
s70n3fac3: bets 500
FDIBA2009: folds 
Uncalled bet (500) returned to s70n3fac3
s70n3fac3 collected 756 from pot
s70n3fac3: doesn't show hand 
*** SUMMARY ***
Total pot 800 | Rake 44 
Board [Th Jd 6s 8s 3s]
Seat 1: s70n3fac3 (big blind) collected (756)
Seat 2: FDIBA2009 (button) (small blind) folded on the River



PokerStars Home Game Hand #226820958312: {Club #4781089}  Hold'em No Limit (50/100) - 2021/05/17 0:39:42 EET [2021/05/16 17:39:42 ET]
Table 'VTPP NLHE 1605' 2-max (Play Money) Seat #1 is the button
Seat 1: s70n3fac3 (10205 in chips) 
Seat 2: FDIBA2009 (11656 in chips) 
s70n3fac3: posts small blind 50
FDIBA2009: posts big blind 100
*** HOLE CARDS ***
s70n3fac3: folds 
Uncalled bet (50) returned to FDIBA2009
FDIBA2009 collected 100 from pot
*** SUMMARY ***
Total pot 100 | Rake 0 
Seat 1: s70n3fac3 (button) (small blind) folded before Flop
Seat 2: FDIBA2009 (big blind) collected (100)



PokerStars Home Game Hand #226820960522: {Club #4781089}  Hold'em No Limit (50/100) - 2021/05/17 0:39:46 EET [2021/05/16 17:39:46 ET]
Table 'VTPP NLHE 1605' 2-max (Play Money) Seat #2 is the button
Seat 1: s70n3fac3 (10155 in chips) 
Seat 2: FDIBA2009 (11706 in chips) 
FDIBA2009: posts small blind 50
s70n3fac3: posts big blind 100
*** HOLE CARDS ***
FDIBA2009: raises 100 to 200
s70n3fac3: raises 500 to 700
FDIBA2009: calls 500
*** FLOP *** [4h 3d 5d]
s70n3fac3: checks 
FDIBA2009: checks 
*** TURN *** [4h 3d 5d] [9h]
s70n3fac3: checks 
FDIBA2009: bets 800
s70n3fac3: folds 
Uncalled bet (800) returned to FDIBA2009
FDIBA2009 collected 1323 from pot
*** SUMMARY ***
Total pot 1400 | Rake 77 
Board [4h 3d 5d 9h]
Seat 1: s70n3fac3 (big blind) folded on the Turn
Seat 2: FDIBA2009 (button) (small blind) collected (1323)



PokerStars Home Game Hand #226820980891: {Club #4781089}  Hold'em No Limit (50/100) - 2021/05/17 0:40:14 EET [2021/05/16 17:40:14 ET]
Table 'VTPP NLHE 1605' 2-max (Play Money) Seat #1 is the button
Seat 1: s70n3fac3 (9455 in chips) 
Seat 2: FDIBA2009 (12329 in chips) 
s70n3fac3: posts small blind 50
FDIBA2009: posts big blind 100
*** HOLE CARDS ***
s70n3fac3: raises 100 to 200
FDIBA2009: folds 
Uncalled bet (100) returned to s70n3fac3
s70n3fac3 collected 200 from pot
s70n3fac3: doesn't show hand 
*** SUMMARY ***
Total pot 200 | Rake 0 
Seat 1: s70n3fac3 (button) (small blind) collected (200)
Seat 2: FDIBA2009 (big blind) folded before Flop



PokerStars Home Game Hand #226820983682: {Club #4781089}  Hold'em No Limit (50/100) - 2021/05/17 0:40:19 EET [2021/05/16 17:40:19 ET]
Table 'VTPP NLHE 1605' 2-max (Play Money) Seat #2 is the button
Seat 1: s70n3fac3 (9555 in chips) 
Seat 2: FDIBA2009 (12229 in chips) 
FDIBA2009: posts small blind 50
s70n3fac3: posts big blind 100
*** HOLE CARDS ***
FDIBA2009: raises 100 to 200
s70n3fac3: calls 100
*** FLOP *** [4s Qs 3d]
s70n3fac3: checks 
FDIBA2009: checks 
*** TURN *** [4s Qs 3d] [8c]
s70n3fac3: checks 
FDIBA2009: checks 
*** RIVER *** [4s Qs 3d 8c] [Ad]
s70n3fac3: bets 200
FDIBA2009: raises 200 to 400
s70n3fac3: raises 600 to 1000
FDIBA2009: calls 600
*** SHOW DOWN ***
s70n3fac3: shows [Qc 8s] (two pair, Queens and Eights)
FDIBA2009: mucks hand 
s70n3fac3 collected 2268 from pot
*** SUMMARY ***
Total pot 2400 | Rake 132 
Board [4s Qs 3d 8c Ad]
Seat 1: s70n3fac3 (big blind) showed [Qc 8s] and won (2268) with two pair, Queens and Eights
Seat 2: FDIBA2009 (button) (small blind) mucked [As 7h]



PokerStars Home Game Hand #226821003581: {Club #4781089}  Hold'em No Limit (50/100) - 2021/05/17 0:40:48 EET [2021/05/16 17:40:48 ET]
Table 'VTPP NLHE 1605' 2-max (Play Money) Seat #1 is the button
Seat 1: s70n3fac3 (10623 in chips) 
Seat 2: FDIBA2009 (11029 in chips) 
s70n3fac3: posts small blind 50
FDIBA2009: posts big blind 100
*** HOLE CARDS ***
s70n3fac3: raises 100 to 200
FDIBA2009: calls 100
*** FLOP *** [3d Kc 3s]
FDIBA2009: checks 
s70n3fac3: checks 
*** TURN *** [3d Kc 3s] [Ad]
FDIBA2009: checks 
s70n3fac3: checks 
*** RIVER *** [3d Kc 3s Ad] [Jd]
FDIBA2009: checks 
s70n3fac3: bets 200
FDIBA2009: raises 800 to 1000
s70n3fac3: raises 1800 to 2800
FDIBA2009: calls 1800
*** SHOW DOWN ***
s70n3fac3: shows [3h 3c] (four of a kind, Threes)
FDIBA2009: mucks hand 
s70n3fac3 collected 5670 from pot
*** SUMMARY ***
Total pot 6000 | Rake 330 
Board [3d Kc 3s Ad Jd]
Seat 1: s70n3fac3 (button) (small blind) showed [3h 3c] and won (5670) with four of a kind, Threes
Seat 2: FDIBA2009 (big blind) mucked [5d 2d]



PokerStars Home Game Hand #226821029676: {Club #4781089}  Hold'em No Limit (50/100) - 2021/05/17 0:41:35 EET [2021/05/16 17:41:35 ET]
Table 'VTPP NLHE 1605' 2-max (Play Money) Seat #2 is the button
Seat 1: s70n3fac3 (13293 in chips) 
Seat 2: FDIBA2009 (8029 in chips) 
FDIBA2009: posts small blind 50
s70n3fac3: posts big blind 100
*** HOLE CARDS ***
FDIBA2009: raises 100 to 200
s70n3fac3: calls 100
*** FLOP *** [Td 2s Jc]
s70n3fac3: checks 
FDIBA2009: bets 100
s70n3fac3: folds 
Uncalled bet (100) returned to FDIBA2009
FDIBA2009 collected 378 from pot
*** SUMMARY ***
Total pot 400 | Rake 22 
Board [Td 2s Jc]
Seat 1: s70n3fac3 (big blind) folded on the Flop
Seat 2: FDIBA2009 (button) (small blind) collected (378)



PokerStars Home Game Hand #226821039737: {Club #4781089}  Hold'em No Limit (50/100) - 2021/05/17 0:41:54 EET [2021/05/16 17:41:54 ET]
Table 'VTPP NLHE 1605' 2-max (Play Money) Seat #1 is the button
Seat 1: s70n3fac3 (13093 in chips) 
Seat 2: FDIBA2009 (8207 in chips) 
s70n3fac3: posts small blind 50
FDIBA2009: posts big blind 100
*** HOLE CARDS ***
s70n3fac3: raises 100 to 200
FDIBA2009: raises 100 to 300
s70n3fac3: calls 100
*** FLOP *** [9d 5c 4h]
FDIBA2009: bets 283
s70n3fac3: raises 517 to 800
FDIBA2009: calls 517
*** TURN *** [9d 5c 4h] [4c]
FDIBA2009: checks 
s70n3fac3: bets 800
FDIBA2009: calls 800
*** RIVER *** [9d 5c 4h 4c] [Ad]
FDIBA2009: checks 
s70n3fac3: checks 
*** SHOW DOWN ***
FDIBA2009: shows [Th 9c] (two pair, Nines and Fours)
s70n3fac3: mucks hand 
FDIBA2009 collected 3591 from pot
*** SUMMARY ***
Total pot 3800 | Rake 209 
Board [9d 5c 4h 4c Ad]
Seat 1: s70n3fac3 (button) (small blind) mucked [8c 8s]
Seat 2: FDIBA2009 (big blind) showed [Th 9c] and won (3591) with two pair, Nines and Fours



PokerStars Home Game Hand #226821056463: {Club #4781089}  Hold'em No Limit (50/100) - 2021/05/17 0:42:25 EET [2021/05/16 17:42:25 ET]
Table 'VTPP NLHE 1605' 2-max (Play Money) Seat #2 is the button
Seat 1: s70n3fac3 (11193 in chips) 
Seat 2: FDIBA2009 (9898 in chips) 
FDIBA2009: posts small blind 50
s70n3fac3: posts big blind 100
*** HOLE CARDS ***
FDIBA2009: raises 100 to 200
s70n3fac3: calls 100
*** FLOP *** [Jc 6s Qd]
s70n3fac3: checks 
FDIBA2009: bets 189
s70n3fac3: folds 
Uncalled bet (189) returned to FDIBA2009
FDIBA2009 collected 378 from pot
*** SUMMARY ***
Total pot 400 | Rake 22 
Board [Jc 6s Qd]
Seat 1: s70n3fac3 (big blind) folded on the Flop
Seat 2: FDIBA2009 (button) (small blind) collected (378)



PokerStars Home Game Hand #226821066963: {Club #4781089}  Hold'em No Limit (50/100) - 2021/05/17 0:42:43 EET [2021/05/16 17:42:43 ET]
Table 'VTPP NLHE 1605' 2-max (Play Money) Seat #1 is the button
Seat 1: s70n3fac3 (10993 in chips) 
Seat 2: FDIBA2009 (10076 in chips) 
s70n3fac3: posts small blind 50
FDIBA2009: posts big blind 100
*** HOLE CARDS ***
s70n3fac3: raises 100 to 200
FDIBA2009: folds 
Uncalled bet (100) returned to s70n3fac3
s70n3fac3 collected 200 from pot
s70n3fac3: doesn't show hand 
*** SUMMARY ***
Total pot 200 | Rake 0 
Seat 1: s70n3fac3 (button) (small blind) collected (200)
Seat 2: FDIBA2009 (big blind) folded before Flop



PokerStars Home Game Hand #226821070988: {Club #4781089}  Hold'em No Limit (50/100) - 2021/05/17 0:42:50 EET [2021/05/16 17:42:50 ET]
Table 'VTPP NLHE 1605' 2-max (Play Money) Seat #2 is the button
Seat 1: s70n3fac3 (11093 in chips) 
Seat 2: FDIBA2009 (9976 in chips) 
FDIBA2009: posts small blind 50
s70n3fac3: posts big blind 100
*** HOLE CARDS ***
FDIBA2009: raises 100 to 200
s70n3fac3: folds 
Uncalled bet (100) returned to FDIBA2009
FDIBA2009 collected 200 from pot
*** SUMMARY ***
Total pot 200 | Rake 0 
Seat 1: s70n3fac3 (big blind) folded before Flop
Seat 2: FDIBA2009 (button) (small blind) collected (200)



PokerStars Home Game Hand #226821074110: {Club #4781089}  Hold'em No Limit (50/100) - 2021/05/17 0:42:56 EET [2021/05/16 17:42:56 ET]
Table 'VTPP NLHE 1605' 2-max (Play Money) Seat #1 is the button
Seat 1: s70n3fac3 (10993 in chips) 
Seat 2: FDIBA2009 (10076 in chips) 
s70n3fac3: posts small blind 50
FDIBA2009: posts big blind 100
*** HOLE CARDS ***
s70n3fac3: folds 
Uncalled bet (50) returned to FDIBA2009
FDIBA2009 collected 100 from pot
*** SUMMARY ***
Total pot 100 | Rake 0 
Seat 1: s70n3fac3 (button) (small blind) folded before Flop
Seat 2: FDIBA2009 (big blind) collected (100)



PokerStars Home Game Hand #226821076045: {Club #4781089}  Hold'em No Limit (50/100) - 2021/05/17 0:43:00 EET [2021/05/16 17:43:00 ET]
Table 'VTPP NLHE 1605' 2-max (Play Money) Seat #2 is the button
Seat 1: s70n3fac3 (10943 in chips) 
Seat 2: FDIBA2009 (10126 in chips) 
FDIBA2009: posts small blind 50
s70n3fac3: posts big blind 100
*** HOLE CARDS ***
FDIBA2009: raises 100 to 200
s70n3fac3: calls 100
*** FLOP *** [Js 3d 7h]
s70n3fac3: checks 
FDIBA2009: bets 189
s70n3fac3: raises 511 to 700
FDIBA2009: folds 
Uncalled bet (511) returned to s70n3fac3
s70n3fac3 collected 735 from pot
s70n3fac3: doesn't show hand 
*** SUMMARY ***
Total pot 778 | Rake 43 
Board [Js 3d 7h]
Seat 1: s70n3fac3 (big blind) collected (735)
Seat 2: FDIBA2009 (button) (small blind) folded on the Flop



PokerStars Home Game Hand #226821083466: {Club #4781089}  Hold'em No Limit (50/100) - 2021/05/17 0:43:14 EET [2021/05/16 17:43:14 ET]
Table 'VTPP NLHE 1605' 2-max (Play Money) Seat #1 is the button
Seat 1: s70n3fac3 (11289 in chips) 
Seat 2: FDIBA2009 (9737 in chips) 
s70n3fac3: posts small blind 50
FDIBA2009: posts big blind 100
*** HOLE CARDS ***
s70n3fac3: folds 
Uncalled bet (50) returned to FDIBA2009
FDIBA2009 collected 100 from pot
*** SUMMARY ***
Total pot 100 | Rake 0 
Seat 1: s70n3fac3 (button) (small blind) folded before Flop
Seat 2: FDIBA2009 (big blind) collected (100)



PokerStars Home Game Hand #226821085499: {Club #4781089}  Hold'em No Limit (50/100) - 2021/05/17 0:43:17 EET [2021/05/16 17:43:17 ET]
Table 'VTPP NLHE 1605' 2-max (Play Money) Seat #2 is the button
Seat 1: s70n3fac3 (11239 in chips) 
Seat 2: FDIBA2009 (9787 in chips) 
FDIBA2009: posts small blind 50
s70n3fac3: posts big blind 100
*** HOLE CARDS ***
FDIBA2009: raises 200 to 300
s70n3fac3: folds 
Uncalled bet (200) returned to FDIBA2009
FDIBA2009 collected 200 from pot
*** SUMMARY ***
Total pot 200 | Rake 0 
Seat 1: s70n3fac3 (big blind) folded before Flop
Seat 2: FDIBA2009 (button) (small blind) collected (200)



PokerStars Home Game Hand #226821088723: {Club #4781089}  Hold'em No Limit (50/100) - 2021/05/17 0:43:23 EET [2021/05/16 17:43:23 ET]
Table 'VTPP NLHE 1605' 2-max (Play Money) Seat #1 is the button
Seat 1: s70n3fac3 (11139 in chips) 
Seat 2: FDIBA2009 (9887 in chips) 
s70n3fac3: posts small blind 50
FDIBA2009: posts big blind 100
*** HOLE CARDS ***
s70n3fac3: raises 100 to 200
FDIBA2009: folds 
Uncalled bet (100) returned to s70n3fac3
s70n3fac3 collected 200 from pot
s70n3fac3: doesn't show hand 
*** SUMMARY ***
Total pot 200 | Rake 0 
Seat 1: s70n3fac3 (button) (small blind) collected (200)
Seat 2: FDIBA2009 (big blind) folded before Flop



PokerStars Home Game Hand #226821091599: {Club #4781089}  Hold'em No Limit (50/100) - 2021/05/17 0:43:29 EET [2021/05/16 17:43:29 ET]
Table 'VTPP NLHE 1605' 2-max (Play Money) Seat #2 is the button
Seat 1: s70n3fac3 (11239 in chips) 
Seat 2: FDIBA2009 (9787 in chips) 
FDIBA2009: posts small blind 50
s70n3fac3: posts big blind 100
*** HOLE CARDS ***
FDIBA2009: raises 200 to 300
s70n3fac3: folds 
Uncalled bet (200) returned to FDIBA2009
FDIBA2009 collected 200 from pot
*** SUMMARY ***
Total pot 200 | Rake 0 
Seat 1: s70n3fac3 (big blind) folded before Flop
Seat 2: FDIBA2009 (button) (small blind) collected (200)



PokerStars Home Game Hand #226821095357: {Club #4781089}  Hold'em No Limit (50/100) - 2021/05/17 0:43:36 EET [2021/05/16 17:43:36 ET]
Table 'VTPP NLHE 1605' 2-max (Play Money) Seat #1 is the button
Seat 1: s70n3fac3 (11139 in chips) 
Seat 2: FDIBA2009 (9887 in chips) 
s70n3fac3: posts small blind 50
FDIBA2009: posts big blind 100
*** HOLE CARDS ***
s70n3fac3: raises 100 to 200
FDIBA2009: calls 100
*** FLOP *** [9s 5s As]
FDIBA2009: checks 
s70n3fac3: bets 200
FDIBA2009: calls 200
*** TURN *** [9s 5s As] [7d]
FDIBA2009: checks 
s70n3fac3: bets 400
FDIBA2009: calls 400
*** RIVER *** [9s 5s As 7d] [Jc]
FDIBA2009: checks 
s70n3fac3: bets 800
FDIBA2009: calls 800
*** SHOW DOWN ***
s70n3fac3: shows [Ac Qh] (a pair of Aces)
FDIBA2009: mucks hand 
s70n3fac3 collected 3024 from pot
*** SUMMARY ***
Total pot 3200 | Rake 176 
Board [9s 5s As 7d Jc]
Seat 1: s70n3fac3 (button) (small blind) showed [Ac Qh] and won (3024) with a pair of Aces
Seat 2: FDIBA2009 (big blind) mucked [3h Ah]



PokerStars Home Game Hand #226821111661: {Club #4781089}  Hold'em No Limit (50/100) - 2021/05/17 0:44:06 EET [2021/05/16 17:44:06 ET]
Table 'VTPP NLHE 1605' 2-max (Play Money) Seat #2 is the button
Seat 1: s70n3fac3 (12563 in chips) 
Seat 2: FDIBA2009 (8287 in chips) 
FDIBA2009: posts small blind 50
s70n3fac3: posts big blind 100
*** HOLE CARDS ***
FDIBA2009: raises 200 to 300
s70n3fac3: calls 200
*** FLOP *** [8s 2h Kd]
s70n3fac3: checks 
FDIBA2009: bets 283
s70n3fac3: folds 
Uncalled bet (283) returned to FDIBA2009
FDIBA2009 collected 567 from pot
*** SUMMARY ***
Total pot 600 | Rake 33 
Board [8s 2h Kd]
Seat 1: s70n3fac3 (big blind) folded on the Flop
Seat 2: FDIBA2009 (button) (small blind) collected (567)



PokerStars Home Game Hand #226821123993: {Club #4781089}  Hold'em No Limit (50/100) - 2021/05/17 0:44:19 EET [2021/05/16 17:44:19 ET]
Table 'VTPP NLHE 1605' 2-max (Play Money) Seat #1 is the button
Seat 1: s70n3fac3 (12263 in chips) 
Seat 2: FDIBA2009 (8554 in chips) 
s70n3fac3: posts small blind 50
FDIBA2009: posts big blind 100
*** HOLE CARDS ***
s70n3fac3: raises 100 to 200
FDIBA2009: calls 100
*** FLOP *** [4h Ts 7d]
FDIBA2009: checks 
s70n3fac3: bets 200
FDIBA2009: calls 200
*** TURN *** [4h Ts 7d] [8d]
FDIBA2009: checks 
s70n3fac3: bets 400
FDIBA2009: calls 400
*** RIVER *** [4h Ts 7d 8d] [2d]
FDIBA2009: checks 
s70n3fac3: bets 800
FDIBA2009: raises 1556 to 2356
s70n3fac3: calls 1556
*** SHOW DOWN ***
FDIBA2009: shows [6d 5d] (a flush, Eight high)
s70n3fac3: shows [Qd Jd] (a flush, Queen high)
s70n3fac3 collected 5965 from pot
*** SUMMARY ***
Total pot 6312 | Rake 347 
Board [4h Ts 7d 8d 2d]
Seat 1: s70n3fac3 (button) (small blind) showed [Qd Jd] and won (5965) with a flush, Queen high
Seat 2: FDIBA2009 (big blind) showed [6d 5d] and lost with a flush, Eight high



PokerStars Home Game Hand #226821143908: {Club #4781089}  Hold'em No Limit (50/100) - 2021/05/17 0:44:56 EET [2021/05/16 17:44:56 ET]
Table 'VTPP NLHE 1605' 2-max (Play Money) Seat #2 is the button
Seat 1: s70n3fac3 (15072 in chips) 
Seat 2: FDIBA2009 (5398 in chips) 
FDIBA2009: posts small blind 50
s70n3fac3: posts big blind 100
*** HOLE CARDS ***
FDIBA2009: raises 100 to 200
s70n3fac3: raises 500 to 700
FDIBA2009: calls 500
*** FLOP *** [3d 7h 3c]
s70n3fac3: bets 700
FDIBA2009: raises 3998 to 4698 and is all-in
s70n3fac3: calls 3998
*** TURN *** [3d 7h 3c] [3s]
*** RIVER *** [3d 7h 3c 3s] [6d]
*** SHOW DOWN ***
s70n3fac3: shows [Qs Qh] (a full house, Threes full of Queens)
FDIBA2009: shows [5s 7s] (a full house, Threes full of Sevens)
s70n3fac3 collected 10202 from pot
*** SUMMARY ***
Total pot 10796 | Rake 594 
Board [3d 7h 3c 3s 6d]
Seat 1: s70n3fac3 (big blind) showed [Qs Qh] and won (10202) with a full house, Threes full of Queens
Seat 2: FDIBA2009 (button) (small blind) showed [5s 7s] and lost with a full house, Threes full of Sevens



PokerStars Home Game Hand #226821165088: {Club #4781089}  Hold'em No Limit (50/100) - 2021/05/17 0:45:35 EET [2021/05/16 17:45:35 ET]
Table 'VTPP NLHE 1605' 2-max (Play Money) Seat #1 is the button
Seat 1: s70n3fac3 (19876 in chips) 
Seat 2: FDIBA2009 (10000 in chips) 
s70n3fac3: posts small blind 50
FDIBA2009: posts big blind 100
*** HOLE CARDS ***
s70n3fac3: folds 
Uncalled bet (50) returned to FDIBA2009
FDIBA2009 collected 100 from pot
*** SUMMARY ***
Total pot 100 | Rake 0 
Seat 1: s70n3fac3 (button) (small blind) folded before Flop
Seat 2: FDIBA2009 (big blind) collected (100)



PokerStars Home Game Hand #226821167032: {Club #4781089}  Hold'em No Limit (50/100) - 2021/05/17 0:45:39 EET [2021/05/16 17:45:39 ET]
Table 'VTPP NLHE 1605' 2-max (Play Money) Seat #2 is the button
Seat 1: s70n3fac3 (19826 in chips) 
Seat 2: FDIBA2009 (10050 in chips) 
FDIBA2009: posts small blind 50
s70n3fac3: posts big blind 100
*** HOLE CARDS ***
FDIBA2009: folds 
Uncalled bet (50) returned to s70n3fac3
s70n3fac3 collected 100 from pot
s70n3fac3: doesn't show hand 
*** SUMMARY ***
Total pot 100 | Rake 0 
Seat 1: s70n3fac3 (big blind) collected (100)
Seat 2: FDIBA2009 (button) (small blind) folded before Flop



PokerStars Home Game Hand #226821171890: {Club #4781089}  Hold'em No Limit (50/100) - 2021/05/17 0:45:48 EET [2021/05/16 17:45:48 ET]
Table 'VTPP NLHE 1605' 2-max (Play Money) Seat #1 is the button
Seat 1: s70n3fac3 (19876 in chips) 
Seat 2: FDIBA2009 (10000 in chips) 
s70n3fac3: posts small blind 50
FDIBA2009: posts big blind 100
*** HOLE CARDS ***
s70n3fac3: folds 
Uncalled bet (50) returned to FDIBA2009
FDIBA2009 collected 100 from pot
*** SUMMARY ***
Total pot 100 | Rake 0 
Seat 1: s70n3fac3 (button) (small blind) folded before Flop
Seat 2: FDIBA2009 (big blind) collected (100)



PokerStars Home Game Hand #226821173872: {Club #4781089}  Hold'em No Limit (50/100) - 2021/05/17 0:45:51 EET [2021/05/16 17:45:51 ET]
Table 'VTPP NLHE 1605' 2-max (Play Money) Seat #2 is the button
Seat 1: s70n3fac3 (19826 in chips) 
Seat 2: FDIBA2009 (10050 in chips) 
FDIBA2009: posts small blind 50
s70n3fac3: posts big blind 100
*** HOLE CARDS ***
FDIBA2009: raises 100 to 200
s70n3fac3: calls 100
*** FLOP *** [Jc 3d 7s]
s70n3fac3: checks 
FDIBA2009: checks 
*** TURN *** [Jc 3d 7s] [9s]
s70n3fac3: checks 
FDIBA2009: bets 378
s70n3fac3: raises 378 to 756
FDIBA2009: calls 378
*** RIVER *** [Jc 3d 7s 9s] [9h]
s70n3fac3: checks 
FDIBA2009: checks 
*** SHOW DOWN ***
s70n3fac3: shows [Jd 7c] (two pair, Jacks and Nines)
FDIBA2009: mucks hand 
s70n3fac3 collected 1807 from pot
*** SUMMARY ***
Total pot 1912 | Rake 105 
Board [Jc 3d 7s 9s 9h]
Seat 1: s70n3fac3 (big blind) showed [Jd 7c] and won (1807) with two pair, Jacks and Nines
Seat 2: FDIBA2009 (button) (small blind) mucked [Qd Th]



PokerStars Home Game Hand #226821185631: {Club #4781089}  Hold'em No Limit (50/100) - 2021/05/17 0:46:13 EET [2021/05/16 17:46:13 ET]
Table 'VTPP NLHE 1605' 2-max (Play Money) Seat #1 is the button
Seat 1: s70n3fac3 (20677 in chips) 
Seat 2: FDIBA2009 (9094 in chips) 
s70n3fac3: posts small blind 50
FDIBA2009: posts big blind 100
*** HOLE CARDS ***
s70n3fac3: raises 100 to 200
FDIBA2009: calls 100
*** FLOP *** [5d 5c Ac]
FDIBA2009: checks 
s70n3fac3: bets 200
FDIBA2009: folds 
Uncalled bet (200) returned to s70n3fac3
s70n3fac3 collected 378 from pot
s70n3fac3: doesn't show hand 
*** SUMMARY ***
Total pot 400 | Rake 22 
Board [5d 5c Ac]
Seat 1: s70n3fac3 (button) (small blind) collected (378)
Seat 2: FDIBA2009 (big blind) folded on the Flop



PokerStars Home Game Hand #226821192220: {Club #4781089}  Hold'em No Limit (50/100) - 2021/05/17 0:46:26 EET [2021/05/16 17:46:26 ET]
Table 'VTPP NLHE 1605' 2-max (Play Money) Seat #2 is the button
Seat 1: s70n3fac3 (20855 in chips) 
Seat 2: FDIBA2009 (8894 in chips) 
FDIBA2009: posts small blind 50
s70n3fac3: posts big blind 100
*** HOLE CARDS ***
FDIBA2009: raises 100 to 200
s70n3fac3: calls 100
*** FLOP *** [3d 8c Tc]
s70n3fac3: checks 
FDIBA2009: checks 
*** TURN *** [3d 8c Tc] [4d]
s70n3fac3: bets 200
FDIBA2009: raises 778 to 978
s70n3fac3: calls 778
*** RIVER *** [3d 8c Tc 4d] [5s]
s70n3fac3: checks 
FDIBA2009: bets 7716 and is all-in
s70n3fac3: folds 
Uncalled bet (7716) returned to FDIBA2009
FDIBA2009 collected 2226 from pot
*** SUMMARY ***
Total pot 2356 | Rake 130 
Board [3d 8c Tc 4d 5s]
Seat 1: s70n3fac3 (big blind) folded on the River
Seat 2: FDIBA2009 (button) (small blind) collected (2226)



PokerStars Home Game Hand #226821207978: {Club #4781089}  Hold'em No Limit (50/100) - 2021/05/17 0:46:56 EET [2021/05/16 17:46:56 ET]
Table 'VTPP NLHE 1605' 2-max (Play Money) Seat #1 is the button
Seat 1: s70n3fac3 (19677 in chips) 
Seat 2: FDIBA2009 (9942 in chips) 
s70n3fac3: posts small blind 50
FDIBA2009: posts big blind 100
*** HOLE CARDS ***
s70n3fac3: calls 50
FDIBA2009: checks 
*** FLOP *** [Ks 7d 4h]
FDIBA2009: bets 189
s70n3fac3: calls 189
*** TURN *** [Ks 7d 4h] [Ts]
FDIBA2009: bets 273
s70n3fac3: calls 273
*** RIVER *** [Ks 7d 4h Ts] [Kd]
FDIBA2009: checks 
s70n3fac3: bets 600
FDIBA2009: raises 1131 to 1731
s70n3fac3: folds 
Uncalled bet (1131) returned to FDIBA2009
FDIBA2009 collected 2196 from pot
*** SUMMARY ***
Total pot 2324 | Rake 128 
Board [Ks 7d 4h Ts Kd]
Seat 1: s70n3fac3 (button) (small blind) folded on the River
Seat 2: FDIBA2009 (big blind) collected (2196)



PokerStars Home Game Hand #226821225178: {Club #4781089}  Hold'em No Limit (50/100) - 2021/05/17 0:47:28 EET [2021/05/16 17:47:28 ET]
Table 'VTPP NLHE 1605' 2-max (Play Money) Seat #2 is the button
Seat 1: s70n3fac3 (18515 in chips) 
Seat 2: FDIBA2009 (10976 in chips) 
FDIBA2009: posts small blind 50
s70n3fac3: posts big blind 100
*** HOLE CARDS ***
FDIBA2009: raises 100 to 200
s70n3fac3: calls 100
*** FLOP *** [8c 9h Js]
s70n3fac3: checks 
FDIBA2009: bets 378
s70n3fac3: calls 378
*** TURN *** [8c 9h Js] [3s]
s70n3fac3: checks 
FDIBA2009: bets 1092
s70n3fac3: folds 
Uncalled bet (1092) returned to FDIBA2009
FDIBA2009 collected 1092 from pot
*** SUMMARY ***
Total pot 1156 | Rake 64 
Board [8c 9h Js 3s]
Seat 1: s70n3fac3 (big blind) folded on the Turn
Seat 2: FDIBA2009 (button) (small blind) collected (1092)



PokerStars Home Game Hand #226821234589: {Club #4781089}  Hold'em No Limit (50/100) - 2021/05/17 0:47:46 EET [2021/05/16 17:47:46 ET]
Table 'VTPP NLHE 1605' 2-max (Play Money) Seat #1 is the button
Seat 1: s70n3fac3 (17937 in chips) 
Seat 2: FDIBA2009 (11490 in chips) 
s70n3fac3: posts small blind 50
FDIBA2009: posts big blind 100
*** HOLE CARDS ***
s70n3fac3: calls 50
FDIBA2009: raises 200 to 300
s70n3fac3: folds 
Uncalled bet (200) returned to FDIBA2009
FDIBA2009 collected 200 from pot
*** SUMMARY ***
Total pot 200 | Rake 0 
Seat 1: s70n3fac3 (button) (small blind) folded before Flop
Seat 2: FDIBA2009 (big blind) collected (200)



PokerStars Home Game Hand #226821238686: {Club #4781089}  Hold'em No Limit (50/100) - 2021/05/17 0:47:54 EET [2021/05/16 17:47:54 ET]
Table 'VTPP NLHE 1605' 2-max (Play Money) Seat #2 is the button
Seat 1: s70n3fac3 (17837 in chips) 
Seat 2: FDIBA2009 (11590 in chips) 
FDIBA2009: posts small blind 50
s70n3fac3: posts big blind 100
*** HOLE CARDS ***
FDIBA2009: raises 200 to 300
s70n3fac3: raises 600 to 900
FDIBA2009: raises 10690 to 11590 and is all-in
s70n3fac3: calls 10690
*** FLOP *** [2d Th 5d]
*** TURN *** [2d Th 5d] [7c]
*** RIVER *** [2d Th 5d 7c] [8c]
*** SHOW DOWN ***
s70n3fac3: shows [Qc Qs] (a pair of Queens)
FDIBA2009: shows [Td Tc] (three of a kind, Tens)
FDIBA2009 collected 21905 from pot
*** SUMMARY ***
Total pot 23180 | Rake 1275 
Board [2d Th 5d 7c 8c]
Seat 1: s70n3fac3 (big blind) showed [Qc Qs] and lost with a pair of Queens
Seat 2: FDIBA2009 (button) (small blind) showed [Td Tc] and won (21905) with three of a kind, Tens



PokerStars Home Game Hand #226821249704: {Club #4781089}  Hold'em No Limit (50/100) - 2021/05/17 0:48:15 EET [2021/05/16 17:48:15 ET]
Table 'VTPP NLHE 1605' 2-max (Play Money) Seat #1 is the button
Seat 1: s70n3fac3 (6247 in chips) 
Seat 2: FDIBA2009 (21905 in chips) 
s70n3fac3: posts small blind 50
FDIBA2009: posts big blind 100
*** HOLE CARDS ***
s70n3fac3: folds 
Uncalled bet (50) returned to FDIBA2009
FDIBA2009 collected 100 from pot
*** SUMMARY ***
Total pot 100 | Rake 0 
Seat 1: s70n3fac3 (button) (small blind) folded before Flop
Seat 2: FDIBA2009 (big blind) collected (100)



PokerStars Home Game Hand #226821251668: {Club #4781089}  Hold'em No Limit (50/100) - 2021/05/17 0:48:19 EET [2021/05/16 17:48:19 ET]
Table 'VTPP NLHE 1605' 2-max (Play Money) Seat #2 is the button
Seat 1: s70n3fac3 (6197 in chips) 
Seat 2: FDIBA2009 (21955 in chips) 
FDIBA2009: posts small blind 50
s70n3fac3: posts big blind 100
*** HOLE CARDS ***
FDIBA2009: raises 100 to 200
s70n3fac3: calls 100
*** FLOP *** [As 5c Kh]
s70n3fac3: checks 
FDIBA2009: bets 189
s70n3fac3: folds 
Uncalled bet (189) returned to FDIBA2009
FDIBA2009 collected 378 from pot
*** SUMMARY ***
Total pot 400 | Rake 22 
Board [As 5c Kh]
Seat 1: s70n3fac3 (big blind) folded on the Flop
Seat 2: FDIBA2009 (button) (small blind) collected (378)



PokerStars Home Game Hand #226821257957: {Club #4781089}  Hold'em No Limit (50/100) - 2021/05/17 0:48:31 EET [2021/05/16 17:48:31 ET]
Table 'VTPP NLHE 1605' 2-max (Play Money) Seat #1 is the button
Seat 1: s70n3fac3 (5997 in chips) 
Seat 2: FDIBA2009 (22133 in chips) 
s70n3fac3: posts small blind 50
FDIBA2009: posts big blind 100
*** HOLE CARDS ***
s70n3fac3: folds 
Uncalled bet (50) returned to FDIBA2009
FDIBA2009 collected 100 from pot
*** SUMMARY ***
Total pot 100 | Rake 0 
Seat 1: s70n3fac3 (button) (small blind) folded before Flop
Seat 2: FDIBA2009 (big blind) collected (100)



PokerStars Home Game Hand #226821260471: {Club #4781089}  Hold'em No Limit (50/100) - 2021/05/17 0:48:36 EET [2021/05/16 17:48:36 ET]
Table 'VTPP NLHE 1605' 2-max (Play Money) Seat #2 is the button
Seat 1: s70n3fac3 (5947 in chips) 
Seat 2: FDIBA2009 (22183 in chips) 
FDIBA2009: posts small blind 50
s70n3fac3: posts big blind 100
*** HOLE CARDS ***
FDIBA2009: raises 100 to 200
s70n3fac3: folds 
Uncalled bet (100) returned to FDIBA2009
FDIBA2009 collected 200 from pot
*** SUMMARY ***
Total pot 200 | Rake 0 
Seat 1: s70n3fac3 (big blind) folded before Flop
Seat 2: FDIBA2009 (button) (small blind) collected (200)



PokerStars Home Game Hand #226821263333: {Club #4781089}  Hold'em No Limit (50/100) - 2021/05/17 0:48:41 EET [2021/05/16 17:48:41 ET]
Table 'VTPP NLHE 1605' 2-max (Play Money) Seat #1 is the button
Seat 1: s70n3fac3 (5847 in chips) 
Seat 2: FDIBA2009 (22283 in chips) 
s70n3fac3: posts small blind 50
FDIBA2009: posts big blind 100
*** HOLE CARDS ***
s70n3fac3: raises 100 to 200
FDIBA2009: calls 100
*** FLOP *** [4c 2s 9c]
FDIBA2009: checks 
s70n3fac3: checks 
*** TURN *** [4c 2s 9c] [Jc]
FDIBA2009: checks 
s70n3fac3: checks 
*** RIVER *** [4c 2s 9c Jc] [Qh]
FDIBA2009: bets 100
s70n3fac3: folds 
Uncalled bet (100) returned to FDIBA2009
FDIBA2009 collected 378 from pot
*** SUMMARY ***
Total pot 400 | Rake 22 
Board [4c 2s 9c Jc Qh]
Seat 1: s70n3fac3 (button) (small blind) folded on the River
Seat 2: FDIBA2009 (big blind) collected (378)



PokerStars Home Game Hand #226821275582: {Club #4781089}  Hold'em No Limit (50/100) - 2021/05/17 0:49:05 EET [2021/05/16 17:49:05 ET]
Table 'VTPP NLHE 1605' 2-max (Play Money) Seat #2 is the button
Seat 1: s70n3fac3 (5647 in chips) 
Seat 2: FDIBA2009 (22461 in chips) 
FDIBA2009: posts small blind 50
s70n3fac3: posts big blind 100
*** HOLE CARDS ***
FDIBA2009: raises 100 to 200
s70n3fac3: folds 
Uncalled bet (100) returned to FDIBA2009
FDIBA2009 collected 200 from pot
*** SUMMARY ***
Total pot 200 | Rake 0 
Seat 1: s70n3fac3 (big blind) folded before Flop
Seat 2: FDIBA2009 (button) (small blind) collected (200)



PokerStars Home Game Hand #226821278857: {Club #4781089}  Hold'em No Limit (50/100) - 2021/05/17 0:49:11 EET [2021/05/16 17:49:11 ET]
Table 'VTPP NLHE 1605' 2-max (Play Money) Seat #1 is the button
Seat 1: s70n3fac3 (5547 in chips) 
Seat 2: FDIBA2009 (22561 in chips) 
s70n3fac3: posts small blind 50
FDIBA2009: posts big blind 100
*** HOLE CARDS ***
s70n3fac3: raises 100 to 200
FDIBA2009: calls 100
*** FLOP *** [7d Jh Ah]
FDIBA2009: checks 
s70n3fac3: checks 
*** TURN *** [7d Jh Ah] [4d]
FDIBA2009: bets 189
s70n3fac3: folds 
Uncalled bet (189) returned to FDIBA2009
FDIBA2009 collected 378 from pot
*** SUMMARY ***
Total pot 400 | Rake 22 
Board [7d Jh Ah 4d]
Seat 1: s70n3fac3 (button) (small blind) folded on the Turn
Seat 2: FDIBA2009 (big blind) collected (378)



PokerStars Home Game Hand #226821288268: {Club #4781089}  Hold'em No Limit (50/100) - 2021/05/17 0:49:29 EET [2021/05/16 17:49:29 ET]
Table 'VTPP NLHE 1605' 2-max (Play Money) Seat #2 is the button
Seat 1: s70n3fac3 (5347 in chips) 
Seat 2: FDIBA2009 (22739 in chips) 
FDIBA2009: posts small blind 50
s70n3fac3: posts big blind 100
*** HOLE CARDS ***
FDIBA2009: raises 100 to 200
s70n3fac3: calls 100
*** FLOP *** [8h 9d 3h]
s70n3fac3: checks 
FDIBA2009: checks 
*** TURN *** [8h 9d 3h] [Ah]
s70n3fac3: checks 
FDIBA2009: checks 
*** RIVER *** [8h 9d 3h Ah] [Ad]
s70n3fac3: checks 
FDIBA2009: checks 
*** SHOW DOWN ***
s70n3fac3: shows [Qs 6d] (a pair of Aces)
FDIBA2009: shows [Kd 5s] (a pair of Aces - King kicker)
FDIBA2009 collected 378 from pot
*** SUMMARY ***
Total pot 400 | Rake 22 
Board [8h 9d 3h Ah Ad]
Seat 1: s70n3fac3 (big blind) showed [Qs 6d] and lost with a pair of Aces
Seat 2: FDIBA2009 (button) (small blind) showed [Kd 5s] and won (378) with a pair of Aces



PokerStars Home Game Hand #226821299619: {Club #4781089}  Hold'em No Limit (50/100) - 2021/05/17 0:49:51 EET [2021/05/16 17:49:51 ET]
Table 'VTPP NLHE 1605' 2-max (Play Money) Seat #1 is the button
Seat 1: s70n3fac3 (5147 in chips) 
Seat 2: FDIBA2009 (22917 in chips) 
s70n3fac3: posts small blind 50
FDIBA2009: posts big blind 100
*** HOLE CARDS ***
s70n3fac3: raises 100 to 200
FDIBA2009: calls 100
*** FLOP *** [5s 8s 5d]
FDIBA2009: checks 
s70n3fac3: checks 
*** TURN *** [5s 8s 5d] [Jh]
FDIBA2009: checks 
s70n3fac3: checks 
*** RIVER *** [5s 8s 5d Jh] [7h]
FDIBA2009: bets 378
s70n3fac3: folds 
Uncalled bet (378) returned to FDIBA2009
FDIBA2009 collected 378 from pot
*** SUMMARY ***
Total pot 400 | Rake 22 
Board [5s 8s 5d Jh 7h]
Seat 1: s70n3fac3 (button) (small blind) folded on the River
Seat 2: FDIBA2009 (big blind) collected (378)



PokerStars Home Game Hand #226821309131: {Club #4781089}  Hold'em No Limit (50/100) - 2021/05/17 0:50:09 EET [2021/05/16 17:50:09 ET]
Table 'VTPP NLHE 1605' 2-max (Play Money) Seat #2 is the button
Seat 1: s70n3fac3 (4947 in chips) 
Seat 2: FDIBA2009 (23095 in chips) 
FDIBA2009: posts small blind 50
s70n3fac3: posts big blind 100
*** HOLE CARDS ***
FDIBA2009: raises 100 to 200
s70n3fac3: calls 100
*** FLOP *** [3s Qd Tc]
s70n3fac3: checks 
FDIBA2009: bets 378
s70n3fac3: folds 
Uncalled bet (378) returned to FDIBA2009
FDIBA2009 collected 378 from pot
*** SUMMARY ***
Total pot 400 | Rake 22 
Board [3s Qd Tc]
Seat 1: s70n3fac3 (big blind) folded on the Flop
Seat 2: FDIBA2009 (button) (small blind) collected (378)



PokerStars Home Game Hand #226821314637: {Club #4781089}  Hold'em No Limit (50/100) - 2021/05/17 0:50:20 EET [2021/05/16 17:50:20 ET]
Table 'VTPP NLHE 1605' 2-max (Play Money) Seat #1 is the button
Seat 1: s70n3fac3 (4747 in chips) 
Seat 2: FDIBA2009 (23273 in chips) 
s70n3fac3: posts small blind 50
FDIBA2009: posts big blind 100
*** HOLE CARDS ***
s70n3fac3: folds 
Uncalled bet (50) returned to FDIBA2009
FDIBA2009 collected 100 from pot
*** SUMMARY ***
Total pot 100 | Rake 0 
Seat 1: s70n3fac3 (button) (small blind) folded before Flop
Seat 2: FDIBA2009 (big blind) collected (100)



PokerStars Home Game Hand #226821316507: {Club #4781089}  Hold'em No Limit (50/100) - 2021/05/17 0:50:24 EET [2021/05/16 17:50:24 ET]
Table 'VTPP NLHE 1605' 2-max (Play Money) Seat #2 is the button
Seat 1: s70n3fac3 (4697 in chips) 
Seat 2: FDIBA2009 (23323 in chips) 
FDIBA2009: posts small blind 50
s70n3fac3: posts big blind 100
*** HOLE CARDS ***
FDIBA2009: calls 50
s70n3fac3: raises 200 to 300
FDIBA2009: folds 
Uncalled bet (200) returned to s70n3fac3
s70n3fac3 collected 200 from pot
s70n3fac3: doesn't show hand 
*** SUMMARY ***
Total pot 200 | Rake 0 
Seat 1: s70n3fac3 (big blind) collected (200)
Seat 2: FDIBA2009 (button) (small blind) folded before Flop



PokerStars Home Game Hand #226821320348: {Club #4781089}  Hold'em No Limit (50/100) - 2021/05/17 0:50:31 EET [2021/05/16 17:50:31 ET]
Table 'VTPP NLHE 1605' 2-max (Play Money) Seat #1 is the button
Seat 1: s70n3fac3 (4797 in chips) 
Seat 2: FDIBA2009 (23223 in chips) 
s70n3fac3: posts small blind 50
FDIBA2009: posts big blind 100
*** HOLE CARDS ***
s70n3fac3: raises 100 to 200
FDIBA2009: calls 100
*** FLOP *** [4d Ts Kh]
FDIBA2009: checks 
s70n3fac3: checks 
*** TURN *** [4d Ts Kh] [8c]
FDIBA2009: bets 100
s70n3fac3: raises 200 to 300
FDIBA2009: folds 
Uncalled bet (200) returned to s70n3fac3
s70n3fac3 collected 567 from pot
s70n3fac3: doesn't show hand 
*** SUMMARY ***
Total pot 600 | Rake 33 
Board [4d Ts Kh 8c]
Seat 1: s70n3fac3 (button) (small blind) collected (567)
Seat 2: FDIBA2009 (big blind) folded on the Turn



PokerStars Home Game Hand #226821328008: {Club #4781089}  Hold'em No Limit (50/100) - 2021/05/17 0:50:46 EET [2021/05/16 17:50:46 ET]
Table 'VTPP NLHE 1605' 2-max (Play Money) Seat #2 is the button
Seat 1: s70n3fac3 (5064 in chips) 
Seat 2: FDIBA2009 (22923 in chips) 
FDIBA2009: posts small blind 50
s70n3fac3: posts big blind 100
*** HOLE CARDS ***
FDIBA2009: raises 100 to 200
s70n3fac3: calls 100
*** FLOP *** [9d 2h 4c]
s70n3fac3: checks 
FDIBA2009: checks 
*** TURN *** [9d 2h 4c] [Th]
s70n3fac3: checks 
FDIBA2009: bets 378
s70n3fac3: calls 378
*** RIVER *** [9d 2h 4c Th] [3c]
s70n3fac3: checks 
FDIBA2009: checks 
*** SHOW DOWN ***
s70n3fac3: shows [8c 8d] (a pair of Eights)
FDIBA2009: mucks hand 
s70n3fac3 collected 1092 from pot
*** SUMMARY ***
Total pot 1156 | Rake 64 
Board [9d 2h 4c Th 3c]
Seat 1: s70n3fac3 (big blind) showed [8c 8d] and won (1092) with a pair of Eights
Seat 2: FDIBA2009 (button) (small blind) mucked [Jc Ks]



PokerStars Home Game Hand #226821344600: {Club #4781089}  Hold'em No Limit (50/100) - 2021/05/17 0:51:03 EET [2021/05/16 17:51:03 ET]
Table 'VTPP NLHE 1605' 2-max (Play Money) Seat #1 is the button
Seat 1: s70n3fac3 (5578 in chips) 
Seat 2: FDIBA2009 (22345 in chips) 
s70n3fac3: posts small blind 50
FDIBA2009: posts big blind 100
*** HOLE CARDS ***
s70n3fac3: raises 100 to 200
FDIBA2009: calls 100
*** FLOP *** [6c 2s 7d]
FDIBA2009: checks 
s70n3fac3: bets 200
FDIBA2009: folds 
Uncalled bet (200) returned to s70n3fac3
s70n3fac3 collected 378 from pot
s70n3fac3: doesn't show hand 
*** SUMMARY ***
Total pot 400 | Rake 22 
Board [6c 2s 7d]
Seat 1: s70n3fac3 (button) (small blind) collected (378)
Seat 2: FDIBA2009 (big blind) folded on the Flop



PokerStars Home Game Hand #226821349398: {Club #4781089}  Hold'em No Limit (50/100) - 2021/05/17 0:51:12 EET [2021/05/16 17:51:12 ET]
Table 'VTPP NLHE 1605' 2-max (Play Money) Seat #2 is the button
Seat 1: s70n3fac3 (5756 in chips) 
Seat 2: FDIBA2009 (22145 in chips) 
FDIBA2009: posts small blind 50
s70n3fac3: posts big blind 100
*** HOLE CARDS ***
FDIBA2009: raises 100 to 200
s70n3fac3: calls 100
*** FLOP *** [8s 7c 2h]
s70n3fac3: checks 
FDIBA2009: checks 
*** TURN *** [8s 7c 2h] [6h]
s70n3fac3: bets 200
FDIBA2009: calls 200
*** RIVER *** [8s 7c 2h 6h] [2s]
s70n3fac3: bets 400
FDIBA2009: raises 778 to 1178
s70n3fac3: folds 
Uncalled bet (778) returned to FDIBA2009
FDIBA2009 collected 1512 from pot
*** SUMMARY ***
Total pot 1600 | Rake 88 
Board [8s 7c 2h 6h 2s]
Seat 1: s70n3fac3 (big blind) folded on the River
Seat 2: FDIBA2009 (button) (small blind) collected (1512)



PokerStars Home Game Hand #226821365811: {Club #4781089}  Hold'em No Limit (50/100) - 2021/05/17 0:51:44 EET [2021/05/16 17:51:44 ET]
Table 'VTPP NLHE 1605' 2-max (Play Money) Seat #1 is the button
Seat 1: s70n3fac3 (4956 in chips) 
Seat 2: FDIBA2009 (22857 in chips) 
s70n3fac3: posts small blind 50
FDIBA2009: posts big blind 100
*** HOLE CARDS ***
s70n3fac3: raises 100 to 200
FDIBA2009: calls 100
*** FLOP *** [Jd 8s 2d]
FDIBA2009: checks 
s70n3fac3: checks 
*** TURN *** [Jd 8s 2d] [5c]
FDIBA2009: checks 
s70n3fac3: checks 
*** RIVER *** [Jd 8s 2d 5c] [Ad]
FDIBA2009: checks 
s70n3fac3: bets 200
FDIBA2009: calls 200
*** SHOW DOWN ***
s70n3fac3: shows [6s Ah] (a pair of Aces)
FDIBA2009: mucks hand 
s70n3fac3 collected 756 from pot
*** SUMMARY ***
Total pot 800 | Rake 44 
Board [Jd 8s 2d 5c Ad]
Seat 1: s70n3fac3 (button) (small blind) showed [6s Ah] and won (756) with a pair of Aces
Seat 2: FDIBA2009 (big blind) mucked [9d 9c]



PokerStars Home Game Hand #226821375423: {Club #4781089}  Hold'em No Limit (50/100) - 2021/05/17 0:52:03 EET [2021/05/16 17:52:03 ET]
Table 'VTPP NLHE 1605' 2-max (Play Money) Seat #2 is the button
Seat 1: s70n3fac3 (5312 in chips) 
Seat 2: FDIBA2009 (22457 in chips) 
FDIBA2009: posts small blind 50
s70n3fac3: posts big blind 100
*** HOLE CARDS ***
FDIBA2009: raises 100 to 200
s70n3fac3: raises 400 to 600
FDIBA2009: calls 400
*** FLOP *** [Jh 5s 8d]
s70n3fac3: checks 
FDIBA2009: checks 
*** TURN *** [Jh 5s 8d] [2h]
s70n3fac3: checks 
FDIBA2009: bets 567
s70n3fac3: folds 
Uncalled bet (567) returned to FDIBA2009
FDIBA2009 collected 1134 from pot
*** SUMMARY ***
Total pot 1200 | Rake 66 
Board [Jh 5s 8d 2h]
Seat 1: s70n3fac3 (big blind) folded on the Turn
Seat 2: FDIBA2009 (button) (small blind) collected (1134)



PokerStars Home Game Hand #226821388056: {Club #4781089}  Hold'em No Limit (50/100) - 2021/05/17 0:52:27 EET [2021/05/16 17:52:27 ET]
Table 'VTPP NLHE 1605' 2-max (Play Money) Seat #1 is the button
Seat 1: s70n3fac3 (4712 in chips) 
Seat 2: FDIBA2009 (22991 in chips) 
s70n3fac3: posts small blind 50
FDIBA2009: posts big blind 100
*** HOLE CARDS ***
s70n3fac3: folds 
Uncalled bet (50) returned to FDIBA2009
FDIBA2009 collected 100 from pot
*** SUMMARY ***
Total pot 100 | Rake 0 
Seat 1: s70n3fac3 (button) (small blind) folded before Flop
Seat 2: FDIBA2009 (big blind) collected (100)



PokerStars Home Game Hand #226821389962: {Club #4781089}  Hold'em No Limit (50/100) - 2021/05/17 0:52:31 EET [2021/05/16 17:52:31 ET]
Table 'VTPP NLHE 1605' 2-max (Play Money) Seat #2 is the button
Seat 1: s70n3fac3 (4662 in chips) 
Seat 2: FDIBA2009 (23041 in chips) 
FDIBA2009: posts small blind 50
s70n3fac3: posts big blind 100
*** HOLE CARDS ***
FDIBA2009: raises 100 to 200
s70n3fac3: raises 400 to 600
FDIBA2009: calls 400
*** FLOP *** [Qc Tc 5h]
s70n3fac3: bets 600
FDIBA2009: folds 
Uncalled bet (600) returned to s70n3fac3
s70n3fac3 collected 1134 from pot
s70n3fac3: doesn't show hand 
*** SUMMARY ***
Total pot 1200 | Rake 66 
Board [Qc Tc 5h]
Seat 1: s70n3fac3 (big blind) collected (1134)
Seat 2: FDIBA2009 (button) (small blind) folded on the Flop



PokerStars Home Game Hand #226821396261: {Club #4781089}  Hold'em No Limit (50/100) - 2021/05/17 0:52:44 EET [2021/05/16 17:52:44 ET]
Table 'VTPP NLHE 1605' 2-max (Play Money) Seat #1 is the button
Seat 1: s70n3fac3 (5196 in chips) 
Seat 2: FDIBA2009 (22441 in chips) 
s70n3fac3: posts small blind 50
FDIBA2009: posts big blind 100
*** HOLE CARDS ***
s70n3fac3: raises 100 to 200
FDIBA2009: calls 100
*** FLOP *** [4s 5h 6c]
FDIBA2009: checks 
s70n3fac3: bets 200
FDIBA2009: folds 
Uncalled bet (200) returned to s70n3fac3
s70n3fac3 collected 378 from pot
s70n3fac3: doesn't show hand 
*** SUMMARY ***
Total pot 400 | Rake 22 
Board [4s 5h 6c]
Seat 1: s70n3fac3 (button) (small blind) collected (378)
Seat 2: FDIBA2009 (big blind) folded on the Flop



PokerStars Home Game Hand #226821401369: {Club #4781089}  Hold'em No Limit (50/100) - 2021/05/17 0:52:53 EET [2021/05/16 17:52:53 ET]
Table 'VTPP NLHE 1605' 2-max (Play Money) Seat #2 is the button
Seat 1: s70n3fac3 (5374 in chips) 
Seat 2: FDIBA2009 (22241 in chips) 
FDIBA2009: posts small blind 50
s70n3fac3: posts big blind 100
*** HOLE CARDS ***
FDIBA2009: raises 100 to 200
s70n3fac3: calls 100
*** FLOP *** [7h Qh 3c]
s70n3fac3: checks 
FDIBA2009: checks 
*** TURN *** [7h Qh 3c] [Ac]
s70n3fac3: checks 
FDIBA2009: checks 
*** RIVER *** [7h Qh 3c Ac] [2d]
s70n3fac3: bets 300
FDIBA2009: folds 
Uncalled bet (300) returned to s70n3fac3
s70n3fac3 collected 378 from pot
s70n3fac3: doesn't show hand 
*** SUMMARY ***
Total pot 400 | Rake 22 
Board [7h Qh 3c Ac 2d]
Seat 1: s70n3fac3 (big blind) collected (378)
Seat 2: FDIBA2009 (button) (small blind) folded on the River



PokerStars Home Game Hand #226821408866: {Club #4781089}  Hold'em No Limit (50/100) - 2021/05/17 0:53:08 EET [2021/05/16 17:53:08 ET]
Table 'VTPP NLHE 1605' 2-max (Play Money) Seat #1 is the button
Seat 1: s70n3fac3 (5552 in chips) 
Seat 2: FDIBA2009 (22041 in chips) 
s70n3fac3: posts small blind 50
FDIBA2009: posts big blind 100
*** HOLE CARDS ***
s70n3fac3: raises 100 to 200
FDIBA2009: calls 100
*** FLOP *** [Qs Qc Qd]
FDIBA2009: checks 
s70n3fac3: checks 
*** TURN *** [Qs Qc Qd] [8d]
FDIBA2009: bets 378
s70n3fac3: folds 
Uncalled bet (378) returned to FDIBA2009
FDIBA2009 collected 378 from pot
*** SUMMARY ***
Total pot 400 | Rake 22 
Board [Qs Qc Qd 8d]
Seat 1: s70n3fac3 (button) (small blind) folded on the Turn
Seat 2: FDIBA2009 (big blind) collected (378)



PokerStars Home Game Hand #226821415947: {Club #4781089}  Hold'em No Limit (50/100) - 2021/05/17 0:53:22 EET [2021/05/16 17:53:22 ET]
Table 'VTPP NLHE 1605' 2-max (Play Money) Seat #2 is the button
Seat 1: s70n3fac3 (5352 in chips) 
Seat 2: FDIBA2009 (22219 in chips) 
FDIBA2009: posts small blind 50
s70n3fac3: posts big blind 100
*** HOLE CARDS ***
FDIBA2009: raises 100 to 200
s70n3fac3: calls 100
*** FLOP *** [Ah Ad 9c]
s70n3fac3: checks 
FDIBA2009: bets 189
s70n3fac3: folds 
Uncalled bet (189) returned to FDIBA2009
FDIBA2009 collected 378 from pot
*** SUMMARY ***
Total pot 400 | Rake 22 
Board [Ah Ad 9c]
Seat 1: s70n3fac3 (big blind) folded on the Flop
Seat 2: FDIBA2009 (button) (small blind) collected (378)



PokerStars Home Game Hand #226821421068: {Club #4781089}  Hold'em No Limit (50/100) - 2021/05/17 0:53:32 EET [2021/05/16 17:53:32 ET]
Table 'VTPP NLHE 1605' 2-max (Play Money) Seat #1 is the button
Seat 1: s70n3fac3 (5152 in chips) 
Seat 2: FDIBA2009 (22397 in chips) 
s70n3fac3: posts small blind 50
FDIBA2009: posts big blind 100
*** HOLE CARDS ***
s70n3fac3: raises 100 to 200
FDIBA2009: calls 100
*** FLOP *** [8d 5d Kh]
FDIBA2009: checks 
s70n3fac3: checks 
*** TURN *** [8d 5d Kh] [Qs]
FDIBA2009: checks 
s70n3fac3: checks 
*** RIVER *** [8d 5d Kh Qs] [5s]
FDIBA2009: checks 
s70n3fac3: checks 
*** SHOW DOWN ***
FDIBA2009: shows [Qc Jd] (two pair, Queens and Fives)
s70n3fac3: mucks hand 
FDIBA2009 collected 378 from pot
*** SUMMARY ***
Total pot 400 | Rake 22 
Board [8d 5d Kh Qs 5s]
Seat 1: s70n3fac3 (button) (small blind) mucked [9h Jh]
Seat 2: FDIBA2009 (big blind) showed [Qc Jd] and won (378) with two pair, Queens and Fives



PokerStars Home Game Hand #226821427993: {Club #4781089}  Hold'em No Limit (50/100) - 2021/05/17 0:53:45 EET [2021/05/16 17:53:45 ET]
Table 'VTPP NLHE 1605' 2-max (Play Money) Seat #2 is the button
Seat 1: s70n3fac3 (4952 in chips) 
Seat 2: FDIBA2009 (22575 in chips) 
FDIBA2009: posts small blind 50
s70n3fac3: posts big blind 100
*** HOLE CARDS ***
FDIBA2009: raises 100 to 200
s70n3fac3: calls 100
*** FLOP *** [7c 4c Kh]
s70n3fac3: checks 
FDIBA2009: checks 
*** TURN *** [7c 4c Kh] [6s]
s70n3fac3: bets 200
FDIBA2009: calls 200
*** RIVER *** [7c 4c Kh 6s] [8c]
s70n3fac3: checks 
FDIBA2009: bets 756
s70n3fac3: folds 
Uncalled bet (756) returned to FDIBA2009
FDIBA2009 collected 756 from pot
*** SUMMARY ***
Total pot 800 | Rake 44 
Board [7c 4c Kh 6s 8c]
Seat 1: s70n3fac3 (big blind) folded on the River
Seat 2: FDIBA2009 (button) (small blind) collected (756)



PokerStars Home Game Hand #226821438969: {Club #4781089}  Hold'em No Limit (50/100) - 2021/05/17 0:54:07 EET [2021/05/16 17:54:07 ET]
Table 'VTPP NLHE 1605' 2-max (Play Money) Seat #1 is the button
Seat 1: s70n3fac3 (4552 in chips) 
Seat 2: FDIBA2009 (22931 in chips) 
s70n3fac3: posts small blind 50
FDIBA2009: posts big blind 100
*** HOLE CARDS ***
s70n3fac3: raises 100 to 200
FDIBA2009: folds 
Uncalled bet (100) returned to s70n3fac3
s70n3fac3 collected 200 from pot
s70n3fac3: doesn't show hand 
*** SUMMARY ***
Total pot 200 | Rake 0 
Seat 1: s70n3fac3 (button) (small blind) collected (200)
Seat 2: FDIBA2009 (big blind) folded before Flop



PokerStars Home Game Hand #226821441305: {Club #4781089}  Hold'em No Limit (50/100) - 2021/05/17 0:54:11 EET [2021/05/16 17:54:11 ET]
Table 'VTPP NLHE 1605' 2-max (Play Money) Seat #2 is the button
Seat 1: s70n3fac3 (4652 in chips) 
Seat 2: FDIBA2009 (22831 in chips) 
FDIBA2009: posts small blind 50
s70n3fac3: posts big blind 100
*** HOLE CARDS ***
FDIBA2009: raises 100 to 200
s70n3fac3: calls 100
*** FLOP *** [Js 4d 6c]
s70n3fac3: checks 
FDIBA2009: bets 189
s70n3fac3: folds 
Uncalled bet (189) returned to FDIBA2009
FDIBA2009 collected 378 from pot
*** SUMMARY ***
Total pot 400 | Rake 22 
Board [Js 4d 6c]
Seat 1: s70n3fac3 (big blind) folded on the Flop
Seat 2: FDIBA2009 (button) (small blind) collected (378)



PokerStars Home Game Hand #226821446220: {Club #4781089}  Hold'em No Limit (50/100) - 2021/05/17 0:54:21 EET [2021/05/16 17:54:21 ET]
Table 'VTPP NLHE 1605' 2-max (Play Money) Seat #1 is the button
Seat 1: s70n3fac3 (4452 in chips) 
Seat 2: FDIBA2009 (23009 in chips) 
s70n3fac3: posts small blind 50
FDIBA2009: posts big blind 100
*** HOLE CARDS ***
s70n3fac3: raises 100 to 200
FDIBA2009: calls 100
*** FLOP *** [Kd Jd Ah]
FDIBA2009: checks 
s70n3fac3: checks 
*** TURN *** [Kd Jd Ah] [8d]
FDIBA2009: checks 
s70n3fac3: bets 200
FDIBA2009: calls 200
*** RIVER *** [Kd Jd Ah 8d] [6s]
FDIBA2009: checks 
s70n3fac3: checks 
*** SHOW DOWN ***
FDIBA2009: shows [Kh 7d] (a pair of Kings)
s70n3fac3: mucks hand 
FDIBA2009 collected 756 from pot
*** SUMMARY ***
Total pot 800 | Rake 44 
Board [Kd Jd Ah 8d 6s]
Seat 1: s70n3fac3 (button) (small blind) mucked [Js Qs]
Seat 2: FDIBA2009 (big blind) showed [Kh 7d] and won (756) with a pair of Kings



PokerStars Home Game Hand #226821453445: {Club #4781089}  Hold'em No Limit (50/100) - 2021/05/17 0:54:35 EET [2021/05/16 17:54:35 ET]
Table 'VTPP NLHE 1605' 2-max (Play Money) Seat #2 is the button
Seat 1: s70n3fac3 (4052 in chips) 
Seat 2: FDIBA2009 (23365 in chips) 
FDIBA2009: posts small blind 50
s70n3fac3: posts big blind 100
*** HOLE CARDS ***
FDIBA2009: raises 100 to 200
s70n3fac3: calls 100
*** FLOP *** [2s 3d 3s]
s70n3fac3: checks 
FDIBA2009: checks 
*** TURN *** [2s 3d 3s] [5c]
s70n3fac3: checks 
FDIBA2009: bets 189
s70n3fac3: folds 
Uncalled bet (189) returned to FDIBA2009
FDIBA2009 collected 378 from pot
*** SUMMARY ***
Total pot 400 | Rake 22 
Board [2s 3d 3s 5c]
Seat 1: s70n3fac3 (big blind) folded on the Turn
Seat 2: FDIBA2009 (button) (small blind) collected (378)



PokerStars Home Game Hand #226821459671: {Club #4781089}  Hold'em No Limit (50/100) - 2021/05/17 0:54:47 EET [2021/05/16 17:54:47 ET]
Table 'VTPP NLHE 1605' 2-max (Play Money) Seat #1 is the button
Seat 1: s70n3fac3 (3852 in chips) 
Seat 2: FDIBA2009 (23543 in chips) 
s70n3fac3: posts small blind 50
FDIBA2009: posts big blind 100
*** HOLE CARDS ***
s70n3fac3: raises 100 to 200
FDIBA2009: folds 
Uncalled bet (100) returned to s70n3fac3
s70n3fac3 collected 200 from pot
s70n3fac3: doesn't show hand 
*** SUMMARY ***
Total pot 200 | Rake 0 
Seat 1: s70n3fac3 (button) (small blind) collected (200)
Seat 2: FDIBA2009 (big blind) folded before Flop



PokerStars Home Game Hand #226821462117: {Club #4781089}  Hold'em No Limit (50/100) - 2021/05/17 0:54:52 EET [2021/05/16 17:54:52 ET]
Table 'VTPP NLHE 1605' 2-max (Play Money) Seat #2 is the button
Seat 1: s70n3fac3 (3952 in chips) 
Seat 2: FDIBA2009 (23443 in chips) 
FDIBA2009: posts small blind 50
s70n3fac3: posts big blind 100
*** HOLE CARDS ***
FDIBA2009: folds 
Uncalled bet (50) returned to s70n3fac3
s70n3fac3 collected 100 from pot
s70n3fac3: doesn't show hand 
*** SUMMARY ***
Total pot 100 | Rake 0 
Seat 1: s70n3fac3 (big blind) collected (100)
Seat 2: FDIBA2009 (button) (small blind) folded before Flop



PokerStars Home Game Hand #226821464172: {Club #4781089}  Hold'em No Limit (50/100) - 2021/05/17 0:54:56 EET [2021/05/16 17:54:56 ET]
Table 'VTPP NLHE 1605' 2-max (Play Money) Seat #1 is the button
Seat 1: s70n3fac3 (4002 in chips) 
Seat 2: FDIBA2009 (23393 in chips) 
s70n3fac3: posts small blind 50
FDIBA2009: posts big blind 100
*** HOLE CARDS ***
s70n3fac3: raises 100 to 200
FDIBA2009: folds 
Uncalled bet (100) returned to s70n3fac3
s70n3fac3 collected 200 from pot
s70n3fac3: doesn't show hand 
*** SUMMARY ***
Total pot 200 | Rake 0 
Seat 1: s70n3fac3 (button) (small blind) collected (200)
Seat 2: FDIBA2009 (big blind) folded before Flop



PokerStars Home Game Hand #226821466957: {Club #4781089}  Hold'em No Limit (50/100) - 2021/05/17 0:55:01 EET [2021/05/16 17:55:01 ET]
Table 'VTPP NLHE 1605' 2-max (Play Money) Seat #2 is the button
Seat 1: s70n3fac3 (4102 in chips) 
Seat 2: FDIBA2009 (23293 in chips) 
FDIBA2009: posts small blind 50
s70n3fac3: posts big blind 100
*** HOLE CARDS ***
FDIBA2009: raises 100 to 200
s70n3fac3: calls 100
*** FLOP *** [Qc 4h 9h]
s70n3fac3: checks 
FDIBA2009: bets 189
s70n3fac3: folds 
Uncalled bet (189) returned to FDIBA2009
FDIBA2009 collected 378 from pot
*** SUMMARY ***
Total pot 400 | Rake 22 
Board [Qc 4h 9h]
Seat 1: s70n3fac3 (big blind) folded on the Flop
Seat 2: FDIBA2009 (button) (small blind) collected (378)



PokerStars Home Game Hand #226821471591: {Club #4781089}  Hold'em No Limit (50/100) - 2021/05/17 0:55:11 EET [2021/05/16 17:55:11 ET]
Table 'VTPP NLHE 1605' 2-max (Play Money) Seat #1 is the button
Seat 1: s70n3fac3 (3902 in chips) 
Seat 2: FDIBA2009 (23471 in chips) 
s70n3fac3: posts small blind 50
FDIBA2009: posts big blind 100
*** HOLE CARDS ***
s70n3fac3: calls 50
FDIBA2009: checks 
*** FLOP *** [8s 3d 4h]
FDIBA2009: checks 
s70n3fac3: checks 
*** TURN *** [8s 3d 4h] [Jc]
FDIBA2009: bets 189
s70n3fac3: folds 
Uncalled bet (189) returned to FDIBA2009
FDIBA2009 collected 189 from pot
*** SUMMARY ***
Total pot 200 | Rake 11 
Board [8s 3d 4h Jc]
Seat 1: s70n3fac3 (button) (small blind) folded on the Turn
Seat 2: FDIBA2009 (big blind) collected (189)



PokerStars Home Game Hand #226821475610: {Club #4781089}  Hold'em No Limit (50/100) - 2021/05/17 0:55:23 EET [2021/05/16 17:55:23 ET]
Table 'VTPP NLHE 1605' 2-max (Play Money) Seat #2 is the button
Seat 1: s70n3fac3 (3802 in chips) 
Seat 2: FDIBA2009 (23560 in chips) 
FDIBA2009: posts small blind 50
s70n3fac3: posts big blind 100
*** HOLE CARDS ***
FDIBA2009: raises 100 to 200
s70n3fac3: calls 100
*** FLOP *** [Kh 5c Th]
s70n3fac3: checks 
FDIBA2009: checks 
*** TURN *** [Kh 5c Th] [8c]
s70n3fac3: checks 
FDIBA2009: bets 189
s70n3fac3: folds 
Uncalled bet (189) returned to FDIBA2009
FDIBA2009 collected 378 from pot
*** SUMMARY ***
Total pot 400 | Rake 22 
Board [Kh 5c Th 8c]
Seat 1: s70n3fac3 (big blind) folded on the Turn
Seat 2: FDIBA2009 (button) (small blind) collected (378)



PokerStars Home Game Hand #226821480069: {Club #4781089}  Hold'em No Limit (50/100) - 2021/05/17 0:55:37 EET [2021/05/16 17:55:37 ET]
Table 'VTPP NLHE 1605' 2-max (Play Money) Seat #1 is the button
Seat 1: s70n3fac3 (3602 in chips) 
Seat 2: FDIBA2009 (23738 in chips) 
s70n3fac3: posts small blind 50
FDIBA2009: posts big blind 100
*** HOLE CARDS ***
s70n3fac3: raises 100 to 200
FDIBA2009: calls 100
*** FLOP *** [7h Ac 7d]
FDIBA2009: checks 
s70n3fac3: bets 200
FDIBA2009: folds 
Uncalled bet (200) returned to s70n3fac3
s70n3fac3 collected 378 from pot
s70n3fac3: doesn't show hand 
*** SUMMARY ***
Total pot 400 | Rake 22 
Board [7h Ac 7d]
Seat 1: s70n3fac3 (button) (small blind) collected (378)
Seat 2: FDIBA2009 (big blind) folded on the Flop



PokerStars Home Game Hand #226821485110: {Club #4781089}  Hold'em No Limit (50/100) - 2021/05/17 0:55:52 EET [2021/05/16 17:55:52 ET]
Table 'VTPP NLHE 1605' 2-max (Play Money) Seat #2 is the button
Seat 1: s70n3fac3 (3780 in chips) 
Seat 2: FDIBA2009 (23538 in chips) 
FDIBA2009: posts small blind 50
s70n3fac3: posts big blind 100
*** HOLE CARDS ***
FDIBA2009: raises 100 to 200
s70n3fac3: calls 100
*** FLOP *** [Kc 2c 5s]
s70n3fac3: checks 
FDIBA2009: bets 189
s70n3fac3: raises 311 to 500
FDIBA2009: calls 311
*** TURN *** [Kc 2c 5s] [Ks]
s70n3fac3: bets 800
FDIBA2009: folds 
Uncalled bet (800) returned to s70n3fac3
s70n3fac3 collected 1323 from pot
s70n3fac3: doesn't show hand 
*** SUMMARY ***
Total pot 1400 | Rake 77 
Board [Kc 2c 5s Ks]
Seat 1: s70n3fac3 (big blind) collected (1323)
Seat 2: FDIBA2009 (button) (small blind) folded on the Turn



PokerStars Home Game Hand #226821491054: {Club #4781089}  Hold'em No Limit (50/100) - 2021/05/17 0:56:10 EET [2021/05/16 17:56:10 ET]
Table 'VTPP NLHE 1605' 2-max (Play Money) Seat #1 is the button
Seat 1: s70n3fac3 (4403 in chips) 
Seat 2: FDIBA2009 (22838 in chips) 
s70n3fac3: posts small blind 50
FDIBA2009: posts big blind 100
*** HOLE CARDS ***
s70n3fac3: raises 100 to 200
FDIBA2009: folds 
Uncalled bet (100) returned to s70n3fac3
s70n3fac3 collected 200 from pot
s70n3fac3: doesn't show hand 
*** SUMMARY ***
Total pot 200 | Rake 0 
Seat 1: s70n3fac3 (button) (small blind) collected (200)
Seat 2: FDIBA2009 (big blind) folded before Flop



PokerStars Home Game Hand #226821492502: {Club #4781089}  Hold'em No Limit (50/100) - 2021/05/17 0:56:14 EET [2021/05/16 17:56:14 ET]
Table 'VTPP NLHE 1605' 2-max (Play Money) Seat #2 is the button
Seat 1: s70n3fac3 (4503 in chips) 
Seat 2: FDIBA2009 (22738 in chips) 
FDIBA2009: posts small blind 50
s70n3fac3: posts big blind 100
*** HOLE CARDS ***
FDIBA2009: raises 100 to 200
s70n3fac3: calls 100
*** FLOP *** [7h 7d 6c]
s70n3fac3: checks 
FDIBA2009: bets 189
s70n3fac3: folds 
Uncalled bet (189) returned to FDIBA2009
FDIBA2009 collected 378 from pot
*** SUMMARY ***
Total pot 400 | Rake 22 
Board [7h 7d 6c]
Seat 1: s70n3fac3 (big blind) folded on the Flop
Seat 2: FDIBA2009 (button) (small blind) collected (378)



PokerStars Home Game Hand #226821495801: {Club #4781089}  Hold'em No Limit (50/100) - 2021/05/17 0:56:24 EET [2021/05/16 17:56:24 ET]
Table 'VTPP NLHE 1605' 2-max (Play Money) Seat #1 is the button
Seat 1: s70n3fac3 (4303 in chips) 
Seat 2: FDIBA2009 (22916 in chips) 
s70n3fac3: posts small blind 50
FDIBA2009: posts big blind 100
*** HOLE CARDS ***
s70n3fac3: raises 100 to 200
FDIBA2009: calls 100
*** FLOP *** [6c 8s 6s]
FDIBA2009: checks 
s70n3fac3: checks 
*** TURN *** [6c 8s 6s] [8d]
FDIBA2009: checks 
s70n3fac3: bets 200
FDIBA2009: calls 200
*** RIVER *** [6c 8s 6s 8d] [Kh]
FDIBA2009: checks 
s70n3fac3: bets 400
FDIBA2009: calls 400
*** SHOW DOWN ***
s70n3fac3: shows [9c Kc] (two pair, Kings and Eights)
FDIBA2009: shows [9s Ks] (two pair, Kings and Eights)
FDIBA2009 collected 756 from pot
s70n3fac3 collected 756 from pot
*** SUMMARY ***
Total pot 1600 | Rake 88 
Board [6c 8s 6s 8d Kh]
Seat 1: s70n3fac3 (button) (small blind) showed [9c Kc] and won (756) with two pair, Kings and Eights
Seat 2: FDIBA2009 (big blind) showed [9s Ks] and won (756) with two pair, Kings and Eights



PokerStars Home Game Hand #226821501886: {Club #4781089}  Hold'em No Limit (50/100) - 2021/05/17 0:56:42 EET [2021/05/16 17:56:42 ET]
Table 'VTPP NLHE 1605' 2-max (Play Money) Seat #2 is the button
Seat 1: s70n3fac3 (4259 in chips) 
Seat 2: FDIBA2009 (22872 in chips) 
FDIBA2009: posts small blind 50
s70n3fac3: posts big blind 100
*** HOLE CARDS ***
FDIBA2009: raises 100 to 200
s70n3fac3: calls 100
*** FLOP *** [8c 4s 8d]
s70n3fac3: checks 
FDIBA2009: bets 189
s70n3fac3: calls 189
*** TURN *** [8c 4s 8d] [6h]
s70n3fac3: checks 
FDIBA2009: bets 367
s70n3fac3: folds 
Uncalled bet (367) returned to FDIBA2009
FDIBA2009 collected 735 from pot
*** SUMMARY ***
Total pot 778 | Rake 43 
Board [8c 4s 8d 6h]
Seat 1: s70n3fac3 (big blind) folded on the Turn
Seat 2: FDIBA2009 (button) (small blind) collected (735)



PokerStars Home Game Hand #226821509665: {Club #4781089}  Hold'em No Limit (50/100) - 2021/05/17 0:57:05 EET [2021/05/16 17:57:05 ET]
Table 'VTPP NLHE 1605' 2-max (Play Money) Seat #1 is the button
Seat 1: s70n3fac3 (3870 in chips) 
Seat 2: FDIBA2009 (23218 in chips) 
s70n3fac3: posts small blind 50
FDIBA2009: posts big blind 100
*** HOLE CARDS ***
s70n3fac3: raises 100 to 200
FDIBA2009: folds 
Uncalled bet (100) returned to s70n3fac3
s70n3fac3 collected 200 from pot
s70n3fac3: doesn't show hand 
*** SUMMARY ***
Total pot 200 | Rake 0 
Seat 1: s70n3fac3 (button) (small blind) collected (200)
Seat 2: FDIBA2009 (big blind) folded before Flop



PokerStars Home Game Hand #226821511431: {Club #4781089}  Hold'em No Limit (50/100) - 2021/05/17 0:57:10 EET [2021/05/16 17:57:10 ET]
Table 'VTPP NLHE 1605' 2-max (Play Money) Seat #2 is the button
Seat 1: s70n3fac3 (3970 in chips) 
Seat 2: FDIBA2009 (23118 in chips) 
FDIBA2009: posts small blind 50
s70n3fac3: posts big blind 100
*** HOLE CARDS ***
FDIBA2009: raises 100 to 200
s70n3fac3: calls 100
*** FLOP *** [6c Kh Qd]
s70n3fac3: checks 
FDIBA2009: checks 
*** TURN *** [6c Kh Qd] [8s]
s70n3fac3: bets 200
FDIBA2009: calls 200
*** RIVER *** [6c Kh Qd 8s] [2h]
s70n3fac3: checks 
FDIBA2009: checks 
*** SHOW DOWN ***
s70n3fac3: shows [7d 8d] (a pair of Eights)
FDIBA2009: shows [5s Qh] (a pair of Queens)
FDIBA2009 collected 756 from pot
*** SUMMARY ***
Total pot 800 | Rake 44 
Board [6c Kh Qd 8s 2h]
Seat 1: s70n3fac3 (big blind) showed [7d 8d] and lost with a pair of Eights
Seat 2: FDIBA2009 (button) (small blind) showed [5s Qh] and won (756) with a pair of Queens



PokerStars Home Game Hand #226821516240: {Club #4781089}  Hold'em No Limit (50/100) - 2021/05/17 0:57:25 EET [2021/05/16 17:57:25 ET]
Table 'VTPP NLHE 1605' 2-max (Play Money) Seat #1 is the button
Seat 1: s70n3fac3 (3570 in chips) 
Seat 2: FDIBA2009 (23474 in chips) 
s70n3fac3: posts small blind 50
FDIBA2009: posts big blind 100
*** HOLE CARDS ***
s70n3fac3: raises 100 to 200
FDIBA2009: calls 100
*** FLOP *** [7h 4c 6c]
FDIBA2009: checks 
s70n3fac3: checks 
*** TURN *** [7h 4c 6c] [8c]
FDIBA2009: bets 189
s70n3fac3: calls 189
*** RIVER *** [7h 4c 6c 8c] [5s]
FDIBA2009: bets 735
s70n3fac3: calls 735
*** SHOW DOWN ***
FDIBA2009: shows [9c Ks] (a straight, Five to Nine)
s70n3fac3: mucks hand 
FDIBA2009 collected 2124 from pot
*** SUMMARY ***
Total pot 2248 | Rake 124 
Board [7h 4c 6c 8c 5s]
Seat 1: s70n3fac3 (button) (small blind) mucked [8d Ac]
Seat 2: FDIBA2009 (big blind) showed [9c Ks] and won (2124) with a straight, Five to Nine



PokerStars Home Game Hand #226821523578: {Club #4781089}  Hold'em No Limit (50/100) - 2021/05/17 0:57:46 EET [2021/05/16 17:57:46 ET]
Table 'VTPP NLHE 1605' 2-max (Play Money) Seat #2 is the button
Seat 1: s70n3fac3 (2446 in chips) 
Seat 2: FDIBA2009 (24474 in chips) 
FDIBA2009: posts small blind 50
s70n3fac3: posts big blind 100
*** HOLE CARDS ***
FDIBA2009: raises 100 to 200
s70n3fac3: folds 
Uncalled bet (100) returned to FDIBA2009
FDIBA2009 collected 200 from pot
*** SUMMARY ***
Total pot 200 | Rake 0 
Seat 1: s70n3fac3 (big blind) folded before Flop
Seat 2: FDIBA2009 (button) (small blind) collected (200)



PokerStars Home Game Hand #226821527035: {Club #4781089}  Hold'em No Limit (50/100) - 2021/05/17 0:57:56 EET [2021/05/16 17:57:56 ET]
Table 'VTPP NLHE 1605' 2-max (Play Money) Seat #1 is the button
Seat 1: s70n3fac3 (2346 in chips) 
Seat 2: FDIBA2009 (24574 in chips) 
s70n3fac3: posts small blind 50
FDIBA2009: posts big blind 100
*** HOLE CARDS ***
s70n3fac3: folds 
Uncalled bet (50) returned to FDIBA2009
FDIBA2009 collected 100 from pot
*** SUMMARY ***
Total pot 100 | Rake 0 
Seat 1: s70n3fac3 (button) (small blind) folded before Flop
Seat 2: FDIBA2009 (big blind) collected (100)



PokerStars Home Game Hand #226821528418: {Club #4781089}  Hold'em No Limit (50/100) - 2021/05/17 0:58:00 EET [2021/05/16 17:58:00 ET]
Table 'VTPP NLHE 1605' 2-max (Play Money) Seat #2 is the button
Seat 1: s70n3fac3 (2296 in chips) 
Seat 2: FDIBA2009 (24624 in chips) 
FDIBA2009: posts small blind 50
s70n3fac3: posts big blind 100
*** HOLE CARDS ***
FDIBA2009: calls 50
s70n3fac3: raises 200 to 300
FDIBA2009: calls 200
*** FLOP *** [2d 5h Ac]
s70n3fac3: checks 
FDIBA2009: checks 
*** TURN *** [2d 5h Ac] [Ad]
s70n3fac3: bets 300
FDIBA2009: folds 
Uncalled bet (300) returned to s70n3fac3
s70n3fac3 collected 567 from pot
s70n3fac3: doesn't show hand 
*** SUMMARY ***
Total pot 600 | Rake 33 
Board [2d 5h Ac Ad]
Seat 1: s70n3fac3 (big blind) collected (567)
Seat 2: FDIBA2009 (button) (small blind) folded on the Turn



PokerStars Home Game Hand #226821533993: {Club #4781089}  Hold'em No Limit (50/100) - 2021/05/17 0:58:17 EET [2021/05/16 17:58:17 ET]
Table 'VTPP NLHE 1605' 2-max (Play Money) Seat #1 is the button
Seat 1: s70n3fac3 (2563 in chips) 
Seat 2: FDIBA2009 (24324 in chips) 
s70n3fac3: posts small blind 50
FDIBA2009: posts big blind 100
*** HOLE CARDS ***
s70n3fac3: calls 50
FDIBA2009: checks 
*** FLOP *** [9d 7s Qs]
FDIBA2009: checks 
s70n3fac3: bets 100
FDIBA2009: folds 
Uncalled bet (100) returned to s70n3fac3
s70n3fac3 collected 189 from pot
s70n3fac3: doesn't show hand 
*** SUMMARY ***
Total pot 200 | Rake 11 
Board [9d 7s Qs]
Seat 1: s70n3fac3 (button) (small blind) collected (189)
Seat 2: FDIBA2009 (big blind) folded on the Flop



PokerStars Home Game Hand #226821537083: {Club #4781089}  Hold'em No Limit (50/100) - 2021/05/17 0:58:26 EET [2021/05/16 17:58:26 ET]
Table 'VTPP NLHE 1605' 2-max (Play Money) Seat #2 is the button
Seat 1: s70n3fac3 (2652 in chips) 
Seat 2: FDIBA2009 (24224 in chips) 
FDIBA2009: posts small blind 50
s70n3fac3: posts big blind 100
*** HOLE CARDS ***
FDIBA2009: folds 
Uncalled bet (50) returned to s70n3fac3
s70n3fac3 collected 100 from pot
s70n3fac3: doesn't show hand 
*** SUMMARY ***
Total pot 100 | Rake 0 
Seat 1: s70n3fac3 (big blind) collected (100)
Seat 2: FDIBA2009 (button) (small blind) folded before Flop



PokerStars Home Game Hand #226821538633: {Club #4781089}  Hold'em No Limit (50/100) - 2021/05/17 0:58:30 EET [2021/05/16 17:58:30 ET]
Table 'VTPP NLHE 1605' 2-max (Play Money) Seat #1 is the button
Seat 1: s70n3fac3 (2702 in chips) 
Seat 2: FDIBA2009 (24174 in chips) 
s70n3fac3: posts small blind 50
FDIBA2009: posts big blind 100
*** HOLE CARDS ***
s70n3fac3: folds 
Uncalled bet (50) returned to FDIBA2009
FDIBA2009 collected 100 from pot
*** SUMMARY ***
Total pot 100 | Rake 0 
Seat 1: s70n3fac3 (button) (small blind) folded before Flop
Seat 2: FDIBA2009 (big blind) collected (100)



PokerStars Home Game Hand #226821539956: {Club #4781089}  Hold'em No Limit (50/100) - 2021/05/17 0:58:34 EET [2021/05/16 17:58:34 ET]
Table 'VTPP NLHE 1605' 2-max (Play Money) Seat #2 is the button
Seat 1: s70n3fac3 (2652 in chips) 
Seat 2: FDIBA2009 (24224 in chips) 
FDIBA2009: posts small blind 50
s70n3fac3: posts big blind 100
*** HOLE CARDS ***
FDIBA2009: raises 100 to 200
s70n3fac3: folds 
Uncalled bet (100) returned to FDIBA2009
FDIBA2009 collected 200 from pot
*** SUMMARY ***
Total pot 200 | Rake 0 
Seat 1: s70n3fac3 (big blind) folded before Flop
Seat 2: FDIBA2009 (button) (small blind) collected (200)



PokerStars Home Game Hand #226821541855: {Club #4781089}  Hold'em No Limit (50/100) - 2021/05/17 0:58:40 EET [2021/05/16 17:58:40 ET]
Table 'VTPP NLHE 1605' 2-max (Play Money) Seat #1 is the button
Seat 1: s70n3fac3 (2552 in chips) 
Seat 2: FDIBA2009 (24324 in chips) 
s70n3fac3: posts small blind 50
FDIBA2009: posts big blind 100
*** HOLE CARDS ***
s70n3fac3: folds 
Uncalled bet (50) returned to FDIBA2009
FDIBA2009 collected 100 from pot
*** SUMMARY ***
Total pot 100 | Rake 0 
Seat 1: s70n3fac3 (button) (small blind) folded before Flop
Seat 2: FDIBA2009 (big blind) collected (100)



PokerStars Home Game Hand #226821543211: {Club #4781089}  Hold'em No Limit (50/100) - 2021/05/17 0:58:44 EET [2021/05/16 17:58:44 ET]
Table 'VTPP NLHE 1605' 2-max (Play Money) Seat #2 is the button
Seat 1: s70n3fac3 (2502 in chips) 
Seat 2: FDIBA2009 (24374 in chips) 
FDIBA2009: posts small blind 50
s70n3fac3: posts big blind 100
*** HOLE CARDS ***
FDIBA2009: raises 100 to 200
s70n3fac3: calls 100
*** FLOP *** [6s 3s 4s]
s70n3fac3: checks 
FDIBA2009: checks 
*** TURN *** [6s 3s 4s] [2c]
s70n3fac3: checks 
FDIBA2009: checks 
*** RIVER *** [6s 3s 4s 2c] [Js]
s70n3fac3: checks 
FDIBA2009: bets 378
s70n3fac3: folds 
Uncalled bet (378) returned to FDIBA2009
FDIBA2009 collected 378 from pot
*** SUMMARY ***
Total pot 400 | Rake 22 
Board [6s 3s 4s 2c Js]
Seat 1: s70n3fac3 (big blind) folded on the River
Seat 2: FDIBA2009 (button) (small blind) collected (378)



PokerStars Home Game Hand #226821549360: {Club #4781089}  Hold'em No Limit (50/100) - 2021/05/17 0:59:02 EET [2021/05/16 17:59:02 ET]
Table 'VTPP NLHE 1605' 2-max (Play Money) Seat #1 is the button
Seat 1: s70n3fac3 (2302 in chips) 
Seat 2: FDIBA2009 (24552 in chips) 
s70n3fac3: posts small blind 50
FDIBA2009: posts big blind 100
*** HOLE CARDS ***
s70n3fac3: raises 100 to 200
FDIBA2009: folds 
Uncalled bet (100) returned to s70n3fac3
s70n3fac3 collected 200 from pot
s70n3fac3: doesn't show hand 
*** SUMMARY ***
Total pot 200 | Rake 0 
Seat 1: s70n3fac3 (button) (small blind) collected (200)
Seat 2: FDIBA2009 (big blind) folded before Flop



PokerStars Home Game Hand #226821551507: {Club #4781089}  Hold'em No Limit (50/100) - 2021/05/17 0:59:08 EET [2021/05/16 17:59:08 ET]
Table 'VTPP NLHE 1605' 2-max (Play Money) Seat #2 is the button
Seat 1: s70n3fac3 (2402 in chips) 
Seat 2: FDIBA2009 (24452 in chips) 
FDIBA2009: posts small blind 50
s70n3fac3: posts big blind 100
*** HOLE CARDS ***
FDIBA2009: folds 
Uncalled bet (50) returned to s70n3fac3
s70n3fac3 collected 100 from pot
s70n3fac3: doesn't show hand 
*** SUMMARY ***
Total pot 100 | Rake 0 
Seat 1: s70n3fac3 (big blind) collected (100)
Seat 2: FDIBA2009 (button) (small blind) folded before Flop



PokerStars Home Game Hand #226821552956: {Club #4781089}  Hold'em No Limit (50/100) - 2021/05/17 0:59:12 EET [2021/05/16 17:59:12 ET]
Table 'VTPP NLHE 1605' 2-max (Play Money) Seat #1 is the button
Seat 1: s70n3fac3 (2452 in chips) 
Seat 2: FDIBA2009 (24402 in chips) 
s70n3fac3: posts small blind 50
FDIBA2009: posts big blind 100
*** HOLE CARDS ***
s70n3fac3: folds 
Uncalled bet (50) returned to FDIBA2009
FDIBA2009 collected 100 from pot
*** SUMMARY ***
Total pot 100 | Rake 0 
Seat 1: s70n3fac3 (button) (small blind) folded before Flop
Seat 2: FDIBA2009 (big blind) collected (100)



PokerStars Home Game Hand #226821554124: {Club #4781089}  Hold'em No Limit (50/100) - 2021/05/17 0:59:16 EET [2021/05/16 17:59:16 ET]
Table 'VTPP NLHE 1605' 2-max (Play Money) Seat #2 is the button
Seat 1: s70n3fac3 (2402 in chips) 
Seat 2: FDIBA2009 (24452 in chips) 
FDIBA2009: posts small blind 50
s70n3fac3: posts big blind 100
*** HOLE CARDS ***
FDIBA2009: raises 100 to 200
s70n3fac3: folds 
Uncalled bet (100) returned to FDIBA2009
FDIBA2009 collected 200 from pot
*** SUMMARY ***
Total pot 200 | Rake 0 
Seat 1: s70n3fac3 (big blind) folded before Flop
Seat 2: FDIBA2009 (button) (small blind) collected (200)



PokerStars Home Game Hand #226821556039: {Club #4781089}  Hold'em No Limit (50/100) - 2021/05/17 0:59:22 EET [2021/05/16 17:59:22 ET]
Table 'VTPP NLHE 1605' 2-max (Play Money) Seat #1 is the button
Seat 1: s70n3fac3 (2302 in chips) 
Seat 2: FDIBA2009 (24552 in chips) 
s70n3fac3: posts small blind 50
FDIBA2009: posts big blind 100
*** HOLE CARDS ***
s70n3fac3: calls 50
FDIBA2009: checks 
*** FLOP *** [4d 6h Qc]
FDIBA2009: checks 
s70n3fac3: bets 100
FDIBA2009: folds 
Uncalled bet (100) returned to s70n3fac3
s70n3fac3 collected 189 from pot
s70n3fac3: doesn't show hand 
*** SUMMARY ***
Total pot 200 | Rake 11 
Board [4d 6h Qc]
Seat 1: s70n3fac3 (button) (small blind) collected (189)
Seat 2: FDIBA2009 (big blind) folded on the Flop



PokerStars Home Game Hand #226821558996: {Club #4781089}  Hold'em No Limit (50/100) - 2021/05/17 0:59:30 EET [2021/05/16 17:59:30 ET]
Table 'VTPP NLHE 1605' 2-max (Play Money) Seat #2 is the button
Seat 1: s70n3fac3 (2391 in chips) 
Seat 2: FDIBA2009 (24452 in chips) 
FDIBA2009: posts small blind 50
s70n3fac3: posts big blind 100
*** HOLE CARDS ***
FDIBA2009: raises 100 to 200
s70n3fac3: folds 
Uncalled bet (100) returned to FDIBA2009
FDIBA2009 collected 200 from pot
*** SUMMARY ***
Total pot 200 | Rake 0 
Seat 1: s70n3fac3 (big blind) folded before Flop
Seat 2: FDIBA2009 (button) (small blind) collected (200)



PokerStars Home Game Hand #226821560711: {Club #4781089}  Hold'em No Limit (50/100) - 2021/05/17 0:59:35 EET [2021/05/16 17:59:35 ET]
Table 'VTPP NLHE 1605' 2-max (Play Money) Seat #1 is the button
Seat 1: s70n3fac3 (2291 in chips) 
Seat 2: FDIBA2009 (24552 in chips) 
s70n3fac3: posts small blind 50
FDIBA2009: posts big blind 100
*** HOLE CARDS ***
s70n3fac3: calls 50
FDIBA2009: checks 
*** FLOP *** [Qh Jh 3d]
FDIBA2009: checks 
s70n3fac3: checks 
*** TURN *** [Qh Jh 3d] [Ks]
FDIBA2009: checks 
s70n3fac3: bets 100
FDIBA2009: calls 100
*** RIVER *** [Qh Jh 3d Ks] [Td]
FDIBA2009: checks 
s70n3fac3: checks 
*** SHOW DOWN ***
FDIBA2009: shows [Qd 8c] (a pair of Queens)
s70n3fac3: mucks hand 
FDIBA2009 collected 378 from pot
*** SUMMARY ***
Total pot 400 | Rake 22 
Board [Qh Jh 3d Ks Td]
Seat 1: s70n3fac3 (button) (small blind) mucked [Ts 6s]
Seat 2: FDIBA2009 (big blind) showed [Qd 8c] and won (378) with a pair of Queens



PokerStars Home Game Hand #226821565737: {Club #4781089}  Hold'em No Limit (50/100) - 2021/05/17 0:59:50 EET [2021/05/16 17:59:50 ET]
Table 'VTPP NLHE 1605' 2-max (Play Money) Seat #2 is the button
Seat 1: s70n3fac3 (2091 in chips) 
Seat 2: FDIBA2009 (24730 in chips) 
FDIBA2009: posts small blind 50
s70n3fac3: posts big blind 100
*** HOLE CARDS ***
FDIBA2009: raises 100 to 200
s70n3fac3: calls 100
*** FLOP *** [Kc 9c 2s]
s70n3fac3: checks 
FDIBA2009: bets 189
s70n3fac3: calls 189
*** TURN *** [Kc 9c 2s] [4s]
s70n3fac3: checks 
FDIBA2009: checks 
*** RIVER *** [Kc 9c 2s 4s] [Js]
s70n3fac3: bets 300
FDIBA2009: folds 
Uncalled bet (300) returned to s70n3fac3
s70n3fac3 collected 735 from pot
s70n3fac3: doesn't show hand 
*** SUMMARY ***
Total pot 778 | Rake 43 
Board [Kc 9c 2s 4s Js]
Seat 1: s70n3fac3 (big blind) collected (735)
Seat 2: FDIBA2009 (button) (small blind) folded on the River



PokerStars Home Game Hand #226821570495: {Club #4781089}  Hold'em No Limit (50/100) - 2021/05/17 1:00:04 EET [2021/05/16 18:00:04 ET]
Table 'VTPP NLHE 1605' 2-max (Play Money) Seat #1 is the button
Seat 1: s70n3fac3 (2437 in chips) 
Seat 2: FDIBA2009 (24341 in chips) 
s70n3fac3: posts small blind 50
FDIBA2009: posts big blind 100
*** HOLE CARDS ***
s70n3fac3: raises 100 to 200
FDIBA2009: raises 24141 to 24341 and is all-in
s70n3fac3: folds 
Uncalled bet (24141) returned to FDIBA2009
FDIBA2009 collected 400 from pot
*** SUMMARY ***
Total pot 400 | Rake 0 
Seat 1: s70n3fac3 (button) (small blind) folded before Flop
Seat 2: FDIBA2009 (big blind) collected (400)



PokerStars Home Game Hand #226821573265: {Club #4781089}  Hold'em No Limit (50/100) - 2021/05/17 1:00:11 EET [2021/05/16 18:00:11 ET]
Table 'VTPP NLHE 1605' 2-max (Play Money) Seat #2 is the button
Seat 1: s70n3fac3 (2237 in chips) 
Seat 2: FDIBA2009 (24541 in chips) 
FDIBA2009: posts small blind 50
s70n3fac3: posts big blind 100
*** HOLE CARDS ***
FDIBA2009: raises 100 to 200
s70n3fac3: folds 
Uncalled bet (100) returned to FDIBA2009
FDIBA2009 collected 200 from pot
*** SUMMARY ***
Total pot 200 | Rake 0 
Seat 1: s70n3fac3 (big blind) folded before Flop
Seat 2: FDIBA2009 (button) (small blind) collected (200)



PokerStars Home Game Hand #226821575023: {Club #4781089}  Hold'em No Limit (50/100) - 2021/05/17 1:00:16 EET [2021/05/16 18:00:16 ET]
Table 'VTPP NLHE 1605' 2-max (Play Money) Seat #1 is the button
Seat 1: s70n3fac3 (2137 in chips) 
Seat 2: FDIBA2009 (24641 in chips) 
s70n3fac3: posts small blind 50
FDIBA2009: posts big blind 100
*** HOLE CARDS ***
s70n3fac3: folds 
Uncalled bet (50) returned to FDIBA2009
FDIBA2009 collected 100 from pot
*** SUMMARY ***
Total pot 100 | Rake 0 
Seat 1: s70n3fac3 (button) (small blind) folded before Flop
Seat 2: FDIBA2009 (big blind) collected (100)



PokerStars Home Game Hand #226821576448: {Club #4781089}  Hold'em No Limit (50/100) - 2021/05/17 1:00:20 EET [2021/05/16 18:00:20 ET]
Table 'VTPP NLHE 1605' 2-max (Play Money) Seat #2 is the button
Seat 1: s70n3fac3 (2087 in chips) 
Seat 2: FDIBA2009 (24691 in chips) 
FDIBA2009: posts small blind 50
s70n3fac3: posts big blind 100
*** HOLE CARDS ***
FDIBA2009: raises 100 to 200
s70n3fac3: folds 
Uncalled bet (100) returned to FDIBA2009
FDIBA2009 collected 200 from pot
*** SUMMARY ***
Total pot 200 | Rake 0 
Seat 1: s70n3fac3 (big blind) folded before Flop
Seat 2: FDIBA2009 (button) (small blind) collected (200)



PokerStars Home Game Hand #226821578321: {Club #4781089}  Hold'em No Limit (50/100) - 2021/05/17 1:00:26 EET [2021/05/16 18:00:26 ET]
Table 'VTPP NLHE 1605' 2-max (Play Money) Seat #1 is the button
Seat 1: s70n3fac3 (1987 in chips) 
Seat 2: FDIBA2009 (24791 in chips) 
s70n3fac3: posts small blind 50
FDIBA2009: posts big blind 100
*** HOLE CARDS ***
s70n3fac3: calls 50
FDIBA2009: checks 
*** FLOP *** [6h 9h 6s]
FDIBA2009: checks 
s70n3fac3: bets 100
FDIBA2009: calls 100
*** TURN *** [6h 9h 6s] [3s]
FDIBA2009: checks 
s70n3fac3: bets 200
FDIBA2009: folds 
Uncalled bet (200) returned to s70n3fac3
s70n3fac3 collected 378 from pot
s70n3fac3: doesn't show hand 
*** SUMMARY ***
Total pot 400 | Rake 22 
Board [6h 9h 6s 3s]
Seat 1: s70n3fac3 (button) (small blind) collected (378)
Seat 2: FDIBA2009 (big blind) folded on the Turn



PokerStars Home Game Hand #226821583134: {Club #4781089}  Hold'em No Limit (50/100) - 2021/05/17 1:00:39 EET [2021/05/16 18:00:39 ET]
Table 'VTPP NLHE 1605' 2-max (Play Money) Seat #2 is the button
Seat 1: s70n3fac3 (2165 in chips) 
Seat 2: FDIBA2009 (24591 in chips) 
FDIBA2009: posts small blind 50
s70n3fac3: posts big blind 100
*** HOLE CARDS ***
FDIBA2009: raises 100 to 200
s70n3fac3: raises 400 to 600
FDIBA2009: raises 23991 to 24591 and is all-in
s70n3fac3: calls 1565 and is all-in
Uncalled bet (22426) returned to FDIBA2009
*** FLOP *** [9d 8s 7h]
*** TURN *** [9d 8s 7h] [3s]
*** RIVER *** [9d 8s 7h 3s] [2d]
*** SHOW DOWN ***
s70n3fac3: shows [Ah Jc] (high card Ace)
FDIBA2009: shows [6d 6c] (a pair of Sixes)
FDIBA2009 collected 4092 from pot
*** SUMMARY ***
Total pot 4330 | Rake 238 
Board [9d 8s 7h 3s 2d]
Seat 1: s70n3fac3 (big blind) showed [Ah Jc] and lost with high card Ace
Seat 2: FDIBA2009 (button) (small blind) showed [6d 6c] and won (4092) with a pair of Sixes



PokerStars Home Game Hand #226821601828: {Club #4781089}  Hold'em No Limit (50/100) - 2021/05/17 1:01:19 EET [2021/05/16 18:01:19 ET]
Table 'VTPP NLHE 1605' 2-max (Play Money) Seat #1 is the button
Seat 1: s70n3fac3 (10000 in chips) 
Seat 2: FDIBA2009 (26518 in chips) 
s70n3fac3: posts small blind 50
FDIBA2009: posts big blind 100
*** HOLE CARDS ***
s70n3fac3: calls 50
FDIBA2009: checks 
*** FLOP *** [Qh 6s Qc]
FDIBA2009: checks 
s70n3fac3: checks 
*** TURN *** [Qh 6s Qc] [8c]
FDIBA2009: bets 189
s70n3fac3: calls 189
*** RIVER *** [Qh 6s Qc 8c] [Tc]
FDIBA2009: bets 273
s70n3fac3: raises 527 to 800
FDIBA2009: calls 527
*** SHOW DOWN ***
s70n3fac3: shows [2c 4c] (a flush, Queen high)
FDIBA2009: mucks hand 
s70n3fac3 collected 2058 from pot
*** SUMMARY ***
Total pot 2178 | Rake 120 
Board [Qh 6s Qc 8c Tc]
Seat 1: s70n3fac3 (button) (small blind) showed [2c 4c] and won (2058) with a flush, Queen high
Seat 2: FDIBA2009 (big blind) mucked [7c Qd]



PokerStars Home Game Hand #226821613511: {Club #4781089}  Hold'em No Limit (50/100) - 2021/05/17 1:01:46 EET [2021/05/16 18:01:46 ET]
Table 'VTPP NLHE 1605' 2-max (Play Money) Seat #2 is the button
Seat 1: s70n3fac3 (10969 in chips) 
Seat 2: FDIBA2009 (25429 in chips) 
FDIBA2009: posts small blind 50
s70n3fac3: posts big blind 100
*** HOLE CARDS ***
FDIBA2009: raises 100 to 200
s70n3fac3: folds 
Uncalled bet (100) returned to FDIBA2009
FDIBA2009 collected 200 from pot
*** SUMMARY ***
Total pot 200 | Rake 0 
Seat 1: s70n3fac3 (big blind) folded before Flop
Seat 2: FDIBA2009 (button) (small blind) collected (200)



PokerStars Home Game Hand #226821616012: {Club #4781089}  Hold'em No Limit (50/100) - 2021/05/17 1:01:52 EET [2021/05/16 18:01:52 ET]
Table 'VTPP NLHE 1605' 2-max (Play Money) Seat #1 is the button
Seat 1: s70n3fac3 (10869 in chips) 
Seat 2: FDIBA2009 (25529 in chips) 
s70n3fac3: posts small blind 50
FDIBA2009: posts big blind 100
*** HOLE CARDS ***
s70n3fac3: raises 100 to 200
FDIBA2009: calls 100
*** FLOP *** [Kd Ts Ah]
FDIBA2009: checks 
s70n3fac3: bets 200
FDIBA2009: folds 
Uncalled bet (200) returned to s70n3fac3
s70n3fac3 collected 378 from pot
s70n3fac3: doesn't show hand 
*** SUMMARY ***
Total pot 400 | Rake 22 
Board [Kd Ts Ah]
Seat 1: s70n3fac3 (button) (small blind) collected (378)
Seat 2: FDIBA2009 (big blind) folded on the Flop



PokerStars Home Game Hand #226821620530: {Club #4781089}  Hold'em No Limit (50/100) - 2021/05/17 1:02:02 EET [2021/05/16 18:02:02 ET]
Table 'VTPP NLHE 1605' 2-max (Play Money) Seat #2 is the button
Seat 1: s70n3fac3 (11047 in chips) 
Seat 2: FDIBA2009 (25329 in chips) 
FDIBA2009: posts small blind 50
s70n3fac3: posts big blind 100
*** HOLE CARDS ***
FDIBA2009: raises 100 to 200
s70n3fac3: folds 
Uncalled bet (100) returned to FDIBA2009
FDIBA2009 collected 200 from pot
*** SUMMARY ***
Total pot 200 | Rake 0 
Seat 1: s70n3fac3 (big blind) folded before Flop
Seat 2: FDIBA2009 (button) (small blind) collected (200)



PokerStars Home Game Hand #226821623274: {Club #4781089}  Hold'em No Limit (50/100) - 2021/05/17 1:02:08 EET [2021/05/16 18:02:08 ET]
Table 'VTPP NLHE 1605' 2-max (Play Money) Seat #1 is the button
Seat 1: s70n3fac3 (10947 in chips) 
Seat 2: FDIBA2009 (25429 in chips) 
s70n3fac3: posts small blind 50
FDIBA2009: posts big blind 100
*** HOLE CARDS ***
s70n3fac3: folds 
Uncalled bet (50) returned to FDIBA2009
FDIBA2009 collected 100 from pot
*** SUMMARY ***
Total pot 100 | Rake 0 
Seat 1: s70n3fac3 (button) (small blind) folded before Flop
Seat 2: FDIBA2009 (big blind) collected (100)



PokerStars Home Game Hand #226821625037: {Club #4781089}  Hold'em No Limit (50/100) - 2021/05/17 1:02:11 EET [2021/05/16 18:02:11 ET]
Table 'VTPP NLHE 1605' 2-max (Play Money) Seat #2 is the button
Seat 1: s70n3fac3 (10897 in chips) 
Seat 2: FDIBA2009 (25479 in chips) 
FDIBA2009: posts small blind 50
s70n3fac3: posts big blind 100
*** HOLE CARDS ***
FDIBA2009: raises 100 to 200
s70n3fac3: calls 100
*** FLOP *** [Kd Jh 4h]
s70n3fac3: checks 
FDIBA2009: bets 378
s70n3fac3: folds 
Uncalled bet (378) returned to FDIBA2009
FDIBA2009 collected 378 from pot
*** SUMMARY ***
Total pot 400 | Rake 22 
Board [Kd Jh 4h]
Seat 1: s70n3fac3 (big blind) folded on the Flop
Seat 2: FDIBA2009 (button) (small blind) collected (378)



PokerStars Home Game Hand #226821629637: {Club #4781089}  Hold'em No Limit (50/100) - 2021/05/17 1:02:21 EET [2021/05/16 18:02:21 ET]
Table 'VTPP NLHE 1605' 2-max (Play Money) Seat #1 is the button
Seat 1: s70n3fac3 (10697 in chips) 
Seat 2: FDIBA2009 (25657 in chips) 
s70n3fac3: posts small blind 50
FDIBA2009: posts big blind 100
*** HOLE CARDS ***
s70n3fac3: calls 50
FDIBA2009: raises 200 to 300
s70n3fac3: folds 
Uncalled bet (200) returned to FDIBA2009
FDIBA2009 collected 200 from pot
*** SUMMARY ***
Total pot 200 | Rake 0 
Seat 1: s70n3fac3 (button) (small blind) folded before Flop
Seat 2: FDIBA2009 (big blind) collected (200)



PokerStars Home Game Hand #226821633243: {Club #4781089}  Hold'em No Limit (50/100) - 2021/05/17 1:02:29 EET [2021/05/16 18:02:29 ET]
Table 'VTPP NLHE 1605' 2-max (Play Money) Seat #2 is the button
Seat 1: s70n3fac3 (10597 in chips) 
Seat 2: FDIBA2009 (25757 in chips) 
FDIBA2009: posts small blind 50
s70n3fac3: posts big blind 100
*** HOLE CARDS ***
FDIBA2009: raises 100 to 200
s70n3fac3: folds 
Uncalled bet (100) returned to FDIBA2009
FDIBA2009 collected 200 from pot
*** SUMMARY ***
Total pot 200 | Rake 0 
Seat 1: s70n3fac3 (big blind) folded before Flop
Seat 2: FDIBA2009 (button) (small blind) collected (200)



PokerStars Home Game Hand #226821636450: {Club #4781089}  Hold'em No Limit (50/100) - 2021/05/17 1:02:35 EET [2021/05/16 18:02:35 ET]
Table 'VTPP NLHE 1605' 2-max (Play Money) Seat #1 is the button
Seat 1: s70n3fac3 (10497 in chips) 
Seat 2: FDIBA2009 (25857 in chips) 
s70n3fac3: posts small blind 50
FDIBA2009: posts big blind 100
*** HOLE CARDS ***
s70n3fac3: raises 100 to 200
FDIBA2009: calls 100
*** FLOP *** [2c 6s Kd]
FDIBA2009: bets 189
s70n3fac3: folds 
Uncalled bet (189) returned to FDIBA2009
FDIBA2009 collected 378 from pot
*** SUMMARY ***
Total pot 400 | Rake 22 
Board [2c 6s Kd]
Seat 1: s70n3fac3 (button) (small blind) folded on the Flop
Seat 2: FDIBA2009 (big blind) collected (378)



PokerStars Home Game Hand #226821641755: {Club #4781089}  Hold'em No Limit (50/100) - 2021/05/17 1:02:45 EET [2021/05/16 18:02:45 ET]
Table 'VTPP NLHE 1605' 2-max (Play Money) Seat #2 is the button
Seat 1: s70n3fac3 (10297 in chips) 
Seat 2: FDIBA2009 (26035 in chips) 
FDIBA2009: posts small blind 50
s70n3fac3: posts big blind 100
*** HOLE CARDS ***
FDIBA2009: raises 100 to 200
s70n3fac3: folds 
Uncalled bet (100) returned to FDIBA2009
FDIBA2009 collected 200 from pot
*** SUMMARY ***
Total pot 200 | Rake 0 
Seat 1: s70n3fac3 (big blind) folded before Flop
Seat 2: FDIBA2009 (button) (small blind) collected (200)



PokerStars Home Game Hand #226821644948: {Club #4781089}  Hold'em No Limit (50/100) - 2021/05/17 1:02:51 EET [2021/05/16 18:02:51 ET]
Table 'VTPP NLHE 1605' 2-max (Play Money) Seat #1 is the button
Seat 1: s70n3fac3 (10197 in chips) 
Seat 2: FDIBA2009 (26135 in chips) 
s70n3fac3: posts small blind 50
FDIBA2009: posts big blind 100
*** HOLE CARDS ***
s70n3fac3: raises 100 to 200
FDIBA2009: calls 100
*** FLOP *** [9s 8d Ac]
FDIBA2009: checks 
s70n3fac3: bets 200
FDIBA2009: calls 200
*** TURN *** [9s 8d Ac] [Qs]
FDIBA2009: checks 
s70n3fac3: bets 400
FDIBA2009: folds 
Uncalled bet (400) returned to s70n3fac3
s70n3fac3 collected 756 from pot
s70n3fac3: doesn't show hand 
*** SUMMARY ***
Total pot 800 | Rake 44 
Board [9s 8d Ac Qs]
Seat 1: s70n3fac3 (button) (small blind) collected (756)
Seat 2: FDIBA2009 (big blind) folded on the Turn



PokerStars Home Game Hand #226821652265: {Club #4781089}  Hold'em No Limit (50/100) - 2021/05/17 1:03:06 EET [2021/05/16 18:03:06 ET]
Table 'VTPP NLHE 1605' 2-max (Play Money) Seat #2 is the button
Seat 1: s70n3fac3 (10553 in chips) 
Seat 2: FDIBA2009 (25735 in chips) 
FDIBA2009: posts small blind 50
s70n3fac3: posts big blind 100
*** HOLE CARDS ***
FDIBA2009: raises 100 to 200
s70n3fac3: folds 
Uncalled bet (100) returned to FDIBA2009
FDIBA2009 collected 200 from pot
*** SUMMARY ***
Total pot 200 | Rake 0 
Seat 1: s70n3fac3 (big blind) folded before Flop
Seat 2: FDIBA2009 (button) (small blind) collected (200)



PokerStars Home Game Hand #226821654882: {Club #4781089}  Hold'em No Limit (50/100) - 2021/05/17 1:03:11 EET [2021/05/16 18:03:11 ET]
Table 'VTPP NLHE 1605' 2-max (Play Money) Seat #1 is the button
Seat 1: s70n3fac3 (10453 in chips) 
Seat 2: FDIBA2009 (25835 in chips) 
s70n3fac3: posts small blind 50
FDIBA2009: posts big blind 100
*** HOLE CARDS ***
s70n3fac3: folds 
Uncalled bet (50) returned to FDIBA2009
FDIBA2009 collected 100 from pot
*** SUMMARY ***
Total pot 100 | Rake 0 
Seat 1: s70n3fac3 (button) (small blind) folded before Flop
Seat 2: FDIBA2009 (big blind) collected (100)



PokerStars Home Game Hand #226821656794: {Club #4781089}  Hold'em No Limit (50/100) - 2021/05/17 1:03:15 EET [2021/05/16 18:03:15 ET]
Table 'VTPP NLHE 1605' 2-max (Play Money) Seat #2 is the button
Seat 1: s70n3fac3 (10403 in chips) 
Seat 2: FDIBA2009 (25885 in chips) 
FDIBA2009: posts small blind 50
s70n3fac3: posts big blind 100
*** HOLE CARDS ***
FDIBA2009: raises 100 to 200
s70n3fac3: folds 
Uncalled bet (100) returned to FDIBA2009
FDIBA2009 collected 200 from pot
*** SUMMARY ***
Total pot 200 | Rake 0 
Seat 1: s70n3fac3 (big blind) folded before Flop
Seat 2: FDIBA2009 (button) (small blind) collected (200)



PokerStars Home Game Hand #226821659946: {Club #4781089}  Hold'em No Limit (50/100) - 2021/05/17 1:03:22 EET [2021/05/16 18:03:22 ET]
Table 'VTPP NLHE 1605' 2-max (Play Money) Seat #1 is the button
Seat 1: s70n3fac3 (10303 in chips) 
Seat 2: FDIBA2009 (25985 in chips) 
s70n3fac3: posts small blind 50
FDIBA2009: posts big blind 100
*** HOLE CARDS ***
s70n3fac3: raises 100 to 200
FDIBA2009: calls 100
*** FLOP *** [Ad 6c 9s]
FDIBA2009: checks 
s70n3fac3: checks 
*** TURN *** [Ad 6c 9s] [3s]
FDIBA2009: checks 
s70n3fac3: checks 
*** RIVER *** [Ad 6c 9s 3s] [Kh]
FDIBA2009: bets 378
s70n3fac3: folds 
Uncalled bet (378) returned to FDIBA2009
FDIBA2009 collected 378 from pot
*** SUMMARY ***
Total pot 400 | Rake 22 
Board [Ad 6c 9s 3s Kh]
Seat 1: s70n3fac3 (button) (small blind) folded on the River
Seat 2: FDIBA2009 (big blind) collected (378)



PokerStars Home Game Hand #226821671306: {Club #4781089}  Hold'em No Limit (50/100) - 2021/05/17 1:03:45 EET [2021/05/16 18:03:45 ET]
Table 'VTPP NLHE 1605' 2-max (Play Money) Seat #2 is the button
Seat 1: s70n3fac3 (10103 in chips) 
Seat 2: FDIBA2009 (26163 in chips) 
FDIBA2009: posts small blind 50
s70n3fac3: posts big blind 100
*** HOLE CARDS ***
FDIBA2009: folds 
Uncalled bet (50) returned to s70n3fac3
s70n3fac3 collected 100 from pot
s70n3fac3: doesn't show hand 
*** SUMMARY ***
Total pot 100 | Rake 0 
Seat 1: s70n3fac3 (big blind) collected (100)
Seat 2: FDIBA2009 (button) (small blind) folded before Flop



PokerStars Home Game Hand #226821673664: {Club #4781089}  Hold'em No Limit (50/100) - 2021/05/17 1:03:50 EET [2021/05/16 18:03:50 ET]
Table 'VTPP NLHE 1605' 2-max (Play Money) Seat #1 is the button
Seat 1: s70n3fac3 (10153 in chips) 
Seat 2: FDIBA2009 (26113 in chips) 
s70n3fac3: posts small blind 50
FDIBA2009: posts big blind 100
*** HOLE CARDS ***
s70n3fac3: raises 150 to 250
FDIBA2009: raises 150 to 400
s70n3fac3: calls 150
*** FLOP *** [5c Ks 2h]
FDIBA2009: checks 
s70n3fac3: bets 400
FDIBA2009: folds 
Uncalled bet (400) returned to s70n3fac3
s70n3fac3 collected 756 from pot
s70n3fac3: doesn't show hand 
*** SUMMARY ***
Total pot 800 | Rake 44 
Board [5c Ks 2h]
Seat 1: s70n3fac3 (button) (small blind) collected (756)
Seat 2: FDIBA2009 (big blind) folded on the Flop



PokerStars Home Game Hand #226821682324: {Club #4781089}  Hold'em No Limit (50/100) - 2021/05/17 1:04:07 EET [2021/05/16 18:04:07 ET]
Table 'VTPP NLHE 1605' 2-max (Play Money) Seat #2 is the button
Seat 1: s70n3fac3 (10509 in chips) 
Seat 2: FDIBA2009 (25713 in chips) 
FDIBA2009: posts small blind 50
s70n3fac3: posts big blind 100
*** HOLE CARDS ***
FDIBA2009: raises 100 to 200
s70n3fac3: calls 100
*** FLOP *** [Kd 5s 4s]
s70n3fac3: checks 
FDIBA2009: checks 
*** TURN *** [Kd 5s 4s] [9h]
s70n3fac3: checks 
FDIBA2009: checks 
*** RIVER *** [Kd 5s 4s 9h] [6s]
s70n3fac3: checks 
FDIBA2009: bets 378
s70n3fac3: calls 378
*** SHOW DOWN ***
FDIBA2009: shows [Ts 2d] (high card King)
s70n3fac3: shows [7h 6c] (a pair of Sixes)
s70n3fac3 collected 1092 from pot
*** SUMMARY ***
Total pot 1156 | Rake 64 
Board [Kd 5s 4s 9h 6s]
Seat 1: s70n3fac3 (big blind) showed [7h 6c] and won (1092) with a pair of Sixes
Seat 2: FDIBA2009 (button) (small blind) showed [Ts 2d] and lost with high card King



PokerStars Home Game Hand #226821689742: {Club #4781089}  Hold'em No Limit (50/100) - 2021/05/17 1:04:22 EET [2021/05/16 18:04:22 ET]
Table 'VTPP NLHE 1605' 2-max (Play Money) Seat #1 is the button
Seat 1: s70n3fac3 (11023 in chips) 
Seat 2: FDIBA2009 (25135 in chips) 
s70n3fac3: posts small blind 50
FDIBA2009: posts big blind 100
*** HOLE CARDS ***
s70n3fac3: raises 100 to 200
FDIBA2009: folds 
Uncalled bet (100) returned to s70n3fac3
s70n3fac3 collected 200 from pot
s70n3fac3: doesn't show hand 
*** SUMMARY ***
Total pot 200 | Rake 0 
Seat 1: s70n3fac3 (button) (small blind) collected (200)
Seat 2: FDIBA2009 (big blind) folded before Flop



PokerStars Home Game Hand #226821693918: {Club #4781089}  Hold'em No Limit (50/100) - 2021/05/17 1:04:30 EET [2021/05/16 18:04:30 ET]
Table 'VTPP NLHE 1605' 2-max (Play Money) Seat #2 is the button
Seat 1: s70n3fac3 (11123 in chips) 
Seat 2: FDIBA2009 (25035 in chips) 
FDIBA2009: posts small blind 50
s70n3fac3: posts big blind 100
*** HOLE CARDS ***
FDIBA2009: raises 200 to 300
s70n3fac3: folds 
Uncalled bet (200) returned to FDIBA2009
FDIBA2009 collected 200 from pot
*** SUMMARY ***
Total pot 200 | Rake 0 
Seat 1: s70n3fac3 (big blind) folded before Flop
Seat 2: FDIBA2009 (button) (small blind) collected (200)



PokerStars Home Game Hand #226821696755: {Club #4781089}  Hold'em No Limit (50/100) - 2021/05/17 1:04:36 EET [2021/05/16 18:04:36 ET]
Table 'VTPP NLHE 1605' 2-max (Play Money) Seat #1 is the button
Seat 1: s70n3fac3 (11023 in chips) 
Seat 2: FDIBA2009 (25135 in chips) 
s70n3fac3: posts small blind 50
FDIBA2009: posts big blind 100
*** HOLE CARDS ***
s70n3fac3: folds 
Uncalled bet (50) returned to FDIBA2009
FDIBA2009 collected 100 from pot
*** SUMMARY ***
Total pot 100 | Rake 0 
Seat 1: s70n3fac3 (button) (small blind) folded before Flop
Seat 2: FDIBA2009 (big blind) collected (100)



PokerStars Home Game Hand #226821698619: {Club #4781089}  Hold'em No Limit (50/100) - 2021/05/17 1:04:39 EET [2021/05/16 18:04:39 ET]
Table 'VTPP NLHE 1605' 2-max (Play Money) Seat #2 is the button
Seat 1: s70n3fac3 (10973 in chips) 
Seat 2: FDIBA2009 (25185 in chips) 
FDIBA2009: posts small blind 50
s70n3fac3: posts big blind 100
*** HOLE CARDS ***
FDIBA2009: raises 200 to 300
s70n3fac3: folds 
Uncalled bet (200) returned to FDIBA2009
FDIBA2009 collected 200 from pot
*** SUMMARY ***
Total pot 200 | Rake 0 
Seat 1: s70n3fac3 (big blind) folded before Flop
Seat 2: FDIBA2009 (button) (small blind) collected (200)



PokerStars Home Game Hand #226821701888: {Club #4781089}  Hold'em No Limit (50/100) - 2021/05/17 1:04:46 EET [2021/05/16 18:04:46 ET]
Table 'VTPP NLHE 1605' 2-max (Play Money) Seat #1 is the button
Seat 1: s70n3fac3 (10873 in chips) 
Seat 2: FDIBA2009 (25285 in chips) 
s70n3fac3: posts small blind 50
FDIBA2009: posts big blind 100
*** HOLE CARDS ***
s70n3fac3: raises 100 to 200
FDIBA2009: calls 100
*** FLOP *** [4d 8d Ts]
FDIBA2009: checks 
s70n3fac3: checks 
*** TURN *** [4d 8d Ts] [7h]
FDIBA2009: bets 189
s70n3fac3: calls 189
*** RIVER *** [4d 8d Ts 7h] [Ah]
FDIBA2009: bets 735
s70n3fac3: folds 
Uncalled bet (735) returned to FDIBA2009
FDIBA2009 collected 735 from pot
*** SUMMARY ***
Total pot 778 | Rake 43 
Board [4d 8d Ts 7h Ah]
Seat 1: s70n3fac3 (button) (small blind) folded on the River
Seat 2: FDIBA2009 (big blind) collected (735)



PokerStars Home Game Hand #226821713039: {Club #4781089}  Hold'em No Limit (50/100) - 2021/05/17 1:05:08 EET [2021/05/16 18:05:08 ET]
Table 'VTPP NLHE 1605' 2-max (Play Money) Seat #2 is the button
Seat 1: s70n3fac3 (10484 in chips) 
Seat 2: FDIBA2009 (25631 in chips) 
FDIBA2009: posts small blind 50
s70n3fac3: posts big blind 100
*** HOLE CARDS ***
FDIBA2009: raises 100 to 200
s70n3fac3: raises 400 to 600
FDIBA2009: folds 
Uncalled bet (400) returned to s70n3fac3
s70n3fac3 collected 400 from pot
s70n3fac3: doesn't show hand 
*** SUMMARY ***
Total pot 400 | Rake 0 
Seat 1: s70n3fac3 (big blind) collected (400)
Seat 2: FDIBA2009 (button) (small blind) folded before Flop



PokerStars Home Game Hand #226821716842: {Club #4781089}  Hold'em No Limit (50/100) - 2021/05/17 1:05:16 EET [2021/05/16 18:05:16 ET]
Table 'VTPP NLHE 1605' 2-max (Play Money) Seat #1 is the button
Seat 1: s70n3fac3 (10684 in chips) 
Seat 2: FDIBA2009 (25431 in chips) 
s70n3fac3: posts small blind 50
FDIBA2009: posts big blind 100
*** HOLE CARDS ***
s70n3fac3: raises 100 to 200
FDIBA2009: folds 
Uncalled bet (100) returned to s70n3fac3
s70n3fac3 collected 200 from pot
s70n3fac3: doesn't show hand 
*** SUMMARY ***
Total pot 200 | Rake 0 
Seat 1: s70n3fac3 (button) (small blind) collected (200)
Seat 2: FDIBA2009 (big blind) folded before Flop



PokerStars Home Game Hand #226821719401: {Club #4781089}  Hold'em No Limit (50/100) - 2021/05/17 1:05:21 EET [2021/05/16 18:05:21 ET]
Table 'VTPP NLHE 1605' 2-max (Play Money) Seat #2 is the button
Seat 1: s70n3fac3 (10784 in chips) 
Seat 2: FDIBA2009 (25331 in chips) 
FDIBA2009: posts small blind 50
s70n3fac3: posts big blind 100
*** HOLE CARDS ***
FDIBA2009: raises 100 to 200
s70n3fac3: calls 100
*** FLOP *** [2s 4h 4c]
s70n3fac3: checks 
FDIBA2009: checks 
*** TURN *** [2s 4h 4c] [As]
s70n3fac3: checks 
FDIBA2009: bets 378
s70n3fac3: folds 
Uncalled bet (378) returned to FDIBA2009
FDIBA2009 collected 378 from pot
*** SUMMARY ***
Total pot 400 | Rake 22 
Board [2s 4h 4c As]
Seat 1: s70n3fac3 (big blind) folded on the Turn
Seat 2: FDIBA2009 (button) (small blind) collected (378)



PokerStars Home Game Hand #226821724988: {Club #4781089}  Hold'em No Limit (50/100) - 2021/05/17 1:05:33 EET [2021/05/16 18:05:33 ET]
Table 'VTPP NLHE 1605' 2-max (Play Money) Seat #1 is the button
Seat 1: s70n3fac3 (10584 in chips) 
Seat 2: FDIBA2009 (25509 in chips) 
s70n3fac3: posts small blind 50
FDIBA2009: posts big blind 100
*** HOLE CARDS ***
s70n3fac3: raises 100 to 200
FDIBA2009: calls 100
*** FLOP *** [Qs 5c 3d]
FDIBA2009: checks 
s70n3fac3: checks 
*** TURN *** [Qs 5c 3d] [4s]
FDIBA2009: bets 378
s70n3fac3: folds 
Uncalled bet (378) returned to FDIBA2009
FDIBA2009 collected 378 from pot
*** SUMMARY ***
Total pot 400 | Rake 22 
Board [Qs 5c 3d 4s]
Seat 1: s70n3fac3 (button) (small blind) folded on the Turn
Seat 2: FDIBA2009 (big blind) collected (378)



PokerStars Home Game Hand #226821732552: {Club #4781089}  Hold'em No Limit (50/100) - 2021/05/17 1:05:48 EET [2021/05/16 18:05:48 ET]
Table 'VTPP NLHE 1605' 2-max (Play Money) Seat #2 is the button
Seat 1: s70n3fac3 (10384 in chips) 
Seat 2: FDIBA2009 (25687 in chips) 
FDIBA2009: posts small blind 50
s70n3fac3: posts big blind 100
*** HOLE CARDS ***
FDIBA2009: raises 100 to 200
s70n3fac3: folds 
Uncalled bet (100) returned to FDIBA2009
FDIBA2009 collected 200 from pot
*** SUMMARY ***
Total pot 200 | Rake 0 
Seat 1: s70n3fac3 (big blind) folded before Flop
Seat 2: FDIBA2009 (button) (small blind) collected (200)



PokerStars Home Game Hand #226821735227: {Club #4781089}  Hold'em No Limit (50/100) - 2021/05/17 1:05:53 EET [2021/05/16 18:05:53 ET]
Table 'VTPP NLHE 1605' 2-max (Play Money) Seat #1 is the button
Seat 1: s70n3fac3 (10284 in chips) 
Seat 2: FDIBA2009 (25787 in chips) 
s70n3fac3: posts small blind 50
FDIBA2009: posts big blind 100
*** HOLE CARDS ***
s70n3fac3: folds 
Uncalled bet (50) returned to FDIBA2009
FDIBA2009 collected 100 from pot
*** SUMMARY ***
Total pot 100 | Rake 0 
Seat 1: s70n3fac3 (button) (small blind) folded before Flop
Seat 2: FDIBA2009 (big blind) collected (100)



PokerStars Home Game Hand #226821737081: {Club #4781089}  Hold'em No Limit (50/100) - 2021/05/17 1:05:57 EET [2021/05/16 18:05:57 ET]
Table 'VTPP NLHE 1605' 2-max (Play Money) Seat #2 is the button
Seat 1: s70n3fac3 (10234 in chips) 
Seat 2: FDIBA2009 (25837 in chips) 
FDIBA2009: posts small blind 50
s70n3fac3: posts big blind 100
*** HOLE CARDS ***
FDIBA2009: raises 100 to 200
s70n3fac3: calls 100
*** FLOP *** [6c 6s 2d]
s70n3fac3: checks 
FDIBA2009: bets 189
s70n3fac3: folds 
Uncalled bet (189) returned to FDIBA2009
FDIBA2009 collected 378 from pot
*** SUMMARY ***
Total pot 400 | Rake 22 
Board [6c 6s 2d]
Seat 1: s70n3fac3 (big blind) folded on the Flop
Seat 2: FDIBA2009 (button) (small blind) collected (378)



PokerStars Home Game Hand #226821742091: {Club #4781089}  Hold'em No Limit (50/100) - 2021/05/17 1:06:08 EET [2021/05/16 18:06:08 ET]
Table 'VTPP NLHE 1605' 2-max (Play Money) Seat #1 is the button
Seat 1: s70n3fac3 (10034 in chips) 
Seat 2: FDIBA2009 (26015 in chips) 
s70n3fac3: posts small blind 50
FDIBA2009: posts big blind 100
*** HOLE CARDS ***
s70n3fac3: raises 100 to 200
FDIBA2009: calls 100
*** FLOP *** [Ac 8h Qs]
FDIBA2009: checks 
s70n3fac3: bets 200
FDIBA2009: calls 200
*** TURN *** [Ac 8h Qs] [Js]
FDIBA2009: checks 
s70n3fac3: bets 400
FDIBA2009: calls 400
*** RIVER *** [Ac 8h Qs Js] [2d]
FDIBA2009: checks 
s70n3fac3: checks 
*** SHOW DOWN ***
FDIBA2009: shows [Ad 3h] (a pair of Aces)
s70n3fac3: mucks hand 
FDIBA2009 collected 1512 from pot
*** SUMMARY ***
Total pot 1600 | Rake 88 
Board [Ac 8h Qs Js 2d]
Seat 1: s70n3fac3 (button) (small blind) mucked [Ts 2s]
Seat 2: FDIBA2009 (big blind) showed [Ad 3h] and won (1512) with a pair of Aces



PokerStars Home Game Hand #226821752367: {Club #4781089}  Hold'em No Limit (50/100) - 2021/05/17 1:06:29 EET [2021/05/16 18:06:29 ET]
Table 'VTPP NLHE 1605' 2-max (Play Money) Seat #2 is the button
Seat 1: s70n3fac3 (9234 in chips) 
Seat 2: FDIBA2009 (26727 in chips) 
FDIBA2009: posts small blind 50
s70n3fac3: posts big blind 100
*** HOLE CARDS ***
FDIBA2009: raises 100 to 200
s70n3fac3: folds 
Uncalled bet (100) returned to FDIBA2009
FDIBA2009 collected 200 from pot
*** SUMMARY ***
Total pot 200 | Rake 0 
Seat 1: s70n3fac3 (big blind) folded before Flop
Seat 2: FDIBA2009 (button) (small blind) collected (200)



PokerStars Home Game Hand #226821757020: {Club #4781089}  Hold'em No Limit (50/100) - 2021/05/17 1:06:38 EET [2021/05/16 18:06:38 ET]
Table 'VTPP NLHE 1605' 2-max (Play Money) Seat #1 is the button
Seat 1: s70n3fac3 (9134 in chips) 
Seat 2: FDIBA2009 (26827 in chips) 
s70n3fac3: posts small blind 50
FDIBA2009: posts big blind 100
*** HOLE CARDS ***
s70n3fac3: raises 100 to 200
FDIBA2009: calls 100
*** FLOP *** [4d 7d 9c]
FDIBA2009: checks 
s70n3fac3: bets 200
FDIBA2009: folds 
Uncalled bet (200) returned to s70n3fac3
s70n3fac3 collected 378 from pot
s70n3fac3: doesn't show hand 
*** SUMMARY ***
Total pot 400 | Rake 22 
Board [4d 7d 9c]
Seat 1: s70n3fac3 (button) (small blind) collected (378)
Seat 2: FDIBA2009 (big blind) folded on the Flop



PokerStars Home Game Hand #226821761645: {Club #4781089}  Hold'em No Limit (50/100) - 2021/05/17 1:06:48 EET [2021/05/16 18:06:48 ET]
Table 'VTPP NLHE 1605' 2-max (Play Money) Seat #2 is the button
Seat 1: s70n3fac3 (9312 in chips) 
Seat 2: FDIBA2009 (26627 in chips) 
FDIBA2009: posts small blind 50
s70n3fac3: posts big blind 100
*** HOLE CARDS ***
FDIBA2009: raises 100 to 200
s70n3fac3: calls 100
*** FLOP *** [2h Ad 7h]
s70n3fac3: checks 
FDIBA2009: checks 
*** TURN *** [2h Ad 7h] [Qs]
s70n3fac3: checks 
FDIBA2009: bets 378
s70n3fac3: calls 378
*** RIVER *** [2h Ad 7h Qs] [6d]
s70n3fac3: checks 
FDIBA2009: bets 1092
s70n3fac3: folds 
Uncalled bet (1092) returned to FDIBA2009
FDIBA2009 collected 1092 from pot
*** SUMMARY ***
Total pot 1156 | Rake 64 
Board [2h Ad 7h Qs 6d]
Seat 1: s70n3fac3 (big blind) folded on the River
Seat 2: FDIBA2009 (button) (small blind) collected (1092)



PokerStars Home Game Hand #226821779180: {Club #4781089}  Hold'em No Limit (50/100) - 2021/05/17 1:07:23 EET [2021/05/16 18:07:23 ET]
Table 'VTPP NLHE 1605' 2-max (Play Money) Seat #1 is the button
Seat 1: s70n3fac3 (8734 in chips) 
Seat 2: FDIBA2009 (27141 in chips) 
s70n3fac3: posts small blind 50
FDIBA2009: posts big blind 100
*** HOLE CARDS ***
s70n3fac3: raises 100 to 200
FDIBA2009: calls 100
*** FLOP *** [9h Td 7s]
FDIBA2009: checks 
s70n3fac3: bets 200
FDIBA2009: calls 200
*** TURN *** [9h Td 7s] [Th]
FDIBA2009: checks 
s70n3fac3: bets 400
FDIBA2009: calls 400
*** RIVER *** [9h Td 7s Th] [8d]
FDIBA2009: bets 756
s70n3fac3: folds 
Uncalled bet (756) returned to FDIBA2009
FDIBA2009 collected 1512 from pot
*** SUMMARY ***
Total pot 1600 | Rake 88 
Board [9h Td 7s Th 8d]
Seat 1: s70n3fac3 (button) (small blind) folded on the River
Seat 2: FDIBA2009 (big blind) collected (1512)



PokerStars Home Game Hand #226821798801: {Club #4781089}  Hold'em No Limit (50/100) - 2021/05/17 1:08:03 EET [2021/05/16 18:08:03 ET]
Table 'VTPP NLHE 1605' 2-max (Play Money) Seat #2 is the button
Seat 1: s70n3fac3 (7934 in chips) 
Seat 2: FDIBA2009 (27853 in chips) 
FDIBA2009: posts small blind 50
s70n3fac3: posts big blind 100
*** HOLE CARDS ***
FDIBA2009: raises 100 to 200
s70n3fac3: calls 100
*** FLOP *** [Ts 2s 7c]
s70n3fac3: checks 
FDIBA2009: checks 
*** TURN *** [Ts 2s 7c] [2d]
s70n3fac3: checks 
FDIBA2009: bets 100
s70n3fac3: folds 
Uncalled bet (100) returned to FDIBA2009
FDIBA2009 collected 378 from pot
*** SUMMARY ***
Total pot 400 | Rake 22 
Board [Ts 2s 7c 2d]
Seat 1: s70n3fac3 (big blind) folded on the Turn
Seat 2: FDIBA2009 (button) (small blind) collected (378)



PokerStars Home Game Hand #226821804325: {Club #4781089}  Hold'em No Limit (50/100) - 2021/05/17 1:08:15 EET [2021/05/16 18:08:15 ET]
Table 'VTPP NLHE 1605' 2-max (Play Money) Seat #1 is the button
Seat 1: s70n3fac3 (7734 in chips) 
Seat 2: FDIBA2009 (28031 in chips) 
s70n3fac3: posts small blind 50
FDIBA2009: posts big blind 100
*** HOLE CARDS ***
s70n3fac3: raises 100 to 200
FDIBA2009: calls 100
*** FLOP *** [6c 5c Ac]
FDIBA2009: checks 
s70n3fac3: checks 
*** TURN *** [6c 5c Ac] [Jd]
FDIBA2009: bets 189
s70n3fac3: calls 189
*** RIVER *** [6c 5c Ac Jd] [Qd]
FDIBA2009: checks 
s70n3fac3: bets 400
FDIBA2009: folds 
Uncalled bet (400) returned to s70n3fac3
s70n3fac3 collected 735 from pot
s70n3fac3: doesn't show hand 
*** SUMMARY ***
Total pot 778 | Rake 43 
Board [6c 5c Ac Jd Qd]
Seat 1: s70n3fac3 (button) (small blind) collected (735)
Seat 2: FDIBA2009 (big blind) folded on the River



PokerStars Home Game Hand #226821813081: {Club #4781089}  Hold'em No Limit (50/100) - 2021/05/17 1:08:33 EET [2021/05/16 18:08:33 ET]
Table 'VTPP NLHE 1605' 2-max (Play Money) Seat #2 is the button
Seat 1: s70n3fac3 (8080 in chips) 
Seat 2: FDIBA2009 (27642 in chips) 
FDIBA2009: posts small blind 50
s70n3fac3: posts big blind 100
*** HOLE CARDS ***
FDIBA2009: raises 100 to 200
s70n3fac3: calls 100
*** FLOP *** [8h Kh 9h]
s70n3fac3: checks 
FDIBA2009: bets 189
s70n3fac3: folds 
Uncalled bet (189) returned to FDIBA2009
FDIBA2009 collected 378 from pot
*** SUMMARY ***
Total pot 400 | Rake 22 
Board [8h Kh 9h]
Seat 1: s70n3fac3 (big blind) folded on the Flop
Seat 2: FDIBA2009 (button) (small blind) collected (378)



PokerStars Home Game Hand #226821817806: {Club #4781089}  Hold'em No Limit (50/100) - 2021/05/17 1:08:43 EET [2021/05/16 18:08:43 ET]
Table 'VTPP NLHE 1605' 2-max (Play Money) Seat #1 is the button
Seat 1: s70n3fac3 (7880 in chips) 
Seat 2: FDIBA2009 (27820 in chips) 
s70n3fac3: posts small blind 50
FDIBA2009: posts big blind 100
*** HOLE CARDS ***
s70n3fac3: folds 
Uncalled bet (50) returned to FDIBA2009
FDIBA2009 collected 100 from pot
*** SUMMARY ***
Total pot 100 | Rake 0 
Seat 1: s70n3fac3 (button) (small blind) folded before Flop
Seat 2: FDIBA2009 (big blind) collected (100)



PokerStars Home Game Hand #226821819565: {Club #4781089}  Hold'em No Limit (50/100) - 2021/05/17 1:08:46 EET [2021/05/16 18:08:46 ET]
Table 'VTPP NLHE 1605' 2-max (Play Money) Seat #2 is the button
Seat 1: s70n3fac3 (7830 in chips) 
Seat 2: FDIBA2009 (27870 in chips) 
FDIBA2009: posts small blind 50
s70n3fac3: posts big blind 100
*** HOLE CARDS ***
FDIBA2009: raises 100 to 200
s70n3fac3: calls 100
*** FLOP *** [7s 4c 4d]
s70n3fac3: checks 
FDIBA2009: checks 
*** TURN *** [7s 4c 4d] [Ts]
s70n3fac3: checks 
FDIBA2009: checks 
*** RIVER *** [7s 4c 4d Ts] [9s]
s70n3fac3: checks 
FDIBA2009: bets 100
s70n3fac3: calls 100
*** SHOW DOWN ***
FDIBA2009: shows [Kh 8s] (a pair of Fours)
s70n3fac3: shows [Ad 6s] (a pair of Fours - Ace kicker)
s70n3fac3 collected 567 from pot
*** SUMMARY ***
Total pot 600 | Rake 33 
Board [7s 4c 4d Ts 9s]
Seat 1: s70n3fac3 (big blind) showed [Ad 6s] and won (567) with a pair of Fours
Seat 2: FDIBA2009 (button) (small blind) showed [Kh 8s] and lost with a pair of Fours



PokerStars Home Game Hand #226821826859: {Club #4781089}  Hold'em No Limit (50/100) - 2021/05/17 1:09:01 EET [2021/05/16 18:09:01 ET]
Table 'VTPP NLHE 1605' 2-max (Play Money) Seat #1 is the button
Seat 1: s70n3fac3 (8097 in chips) 
Seat 2: FDIBA2009 (27570 in chips) 
s70n3fac3: posts small blind 50
FDIBA2009: posts big blind 100
*** HOLE CARDS ***
s70n3fac3: calls 50
FDIBA2009: checks 
*** FLOP *** [Th 7s 9h]
FDIBA2009: checks 
s70n3fac3: checks 
*** TURN *** [Th 7s 9h] [3s]
FDIBA2009: bets 189
s70n3fac3: folds 
Uncalled bet (189) returned to FDIBA2009
FDIBA2009 collected 189 from pot
*** SUMMARY ***
Total pot 200 | Rake 11 
Board [Th 7s 9h 3s]
Seat 1: s70n3fac3 (button) (small blind) folded on the Turn
Seat 2: FDIBA2009 (big blind) collected (189)



PokerStars Home Game Hand #226821835265: {Club #4781089}  Hold'em No Limit (50/100) - 2021/05/17 1:09:13 EET [2021/05/16 18:09:13 ET]
Table 'VTPP NLHE 1605' 2-max (Play Money) Seat #2 is the button
Seat 1: s70n3fac3 (7997 in chips) 
Seat 2: FDIBA2009 (27659 in chips) 
FDIBA2009: posts small blind 50
s70n3fac3: posts big blind 100
*** HOLE CARDS ***
FDIBA2009: raises 100 to 200
s70n3fac3: raises 300 to 500
FDIBA2009: calls 300
*** FLOP *** [Ah Js Qh]
s70n3fac3: bets 500
FDIBA2009: folds 
Uncalled bet (500) returned to s70n3fac3
s70n3fac3 collected 945 from pot
s70n3fac3: doesn't show hand 
*** SUMMARY ***
Total pot 1000 | Rake 55 
Board [Ah Js Qh]
Seat 1: s70n3fac3 (big blind) collected (945)
Seat 2: FDIBA2009 (button) (small blind) folded on the Flop



PokerStars Home Game Hand #226821840957: {Club #4781089}  Hold'em No Limit (50/100) - 2021/05/17 1:09:25 EET [2021/05/16 18:09:25 ET]
Table 'VTPP NLHE 1605' 2-max (Play Money) Seat #1 is the button
Seat 1: s70n3fac3 (8442 in chips) 
Seat 2: FDIBA2009 (27159 in chips) 
s70n3fac3: posts small blind 50
FDIBA2009: posts big blind 100
*** HOLE CARDS ***
s70n3fac3: folds 
Uncalled bet (50) returned to FDIBA2009
FDIBA2009 collected 100 from pot
*** SUMMARY ***
Total pot 100 | Rake 0 
Seat 1: s70n3fac3 (button) (small blind) folded before Flop
Seat 2: FDIBA2009 (big blind) collected (100)



PokerStars Home Game Hand #226821842710: {Club #4781089}  Hold'em No Limit (50/100) - 2021/05/17 1:09:28 EET [2021/05/16 18:09:28 ET]
Table 'VTPP NLHE 1605' 2-max (Play Money) Seat #2 is the button
Seat 1: s70n3fac3 (8392 in chips) 
Seat 2: FDIBA2009 (27209 in chips) 
FDIBA2009: posts small blind 50
s70n3fac3: posts big blind 100
*** HOLE CARDS ***
FDIBA2009: raises 100 to 200
s70n3fac3: folds 
Uncalled bet (100) returned to FDIBA2009
FDIBA2009 collected 200 from pot
*** SUMMARY ***
Total pot 200 | Rake 0 
Seat 1: s70n3fac3 (big blind) folded before Flop
Seat 2: FDIBA2009 (button) (small blind) collected (200)



PokerStars Home Game Hand #226821845113: {Club #4781089}  Hold'em No Limit (50/100) - 2021/05/17 1:09:33 EET [2021/05/16 18:09:33 ET]
Table 'VTPP NLHE 1605' 2-max (Play Money) Seat #1 is the button
Seat 1: s70n3fac3 (8292 in chips) 
Seat 2: FDIBA2009 (27309 in chips) 
s70n3fac3: posts small blind 50
FDIBA2009: posts big blind 100
*** HOLE CARDS ***
s70n3fac3: calls 50
FDIBA2009: checks 
*** FLOP *** [Jd Kh 9d]
FDIBA2009: checks 
s70n3fac3: checks 
*** TURN *** [Jd Kh 9d] [8s]
FDIBA2009: checks 
s70n3fac3: checks 
*** RIVER *** [Jd Kh 9d 8s] [3s]
FDIBA2009: bets 189
s70n3fac3: folds 
Uncalled bet (189) returned to FDIBA2009
FDIBA2009 collected 189 from pot
*** SUMMARY ***
Total pot 200 | Rake 11 
Board [Jd Kh 9d 8s 3s]
Seat 1: s70n3fac3 (button) (small blind) folded on the River
Seat 2: FDIBA2009 (big blind) collected (189)



PokerStars Home Game Hand #226821851726: {Club #4781089}  Hold'em No Limit (50/100) - 2021/05/17 1:09:47 EET [2021/05/16 18:09:47 ET]
Table 'VTPP NLHE 1605' 2-max (Play Money) Seat #2 is the button
Seat 1: s70n3fac3 (8192 in chips) 
Seat 2: FDIBA2009 (27398 in chips) 
FDIBA2009: posts small blind 50
s70n3fac3: posts big blind 100
*** HOLE CARDS ***
FDIBA2009: raises 100 to 200
s70n3fac3: folds 
Uncalled bet (100) returned to FDIBA2009
FDIBA2009 collected 200 from pot
*** SUMMARY ***
Total pot 200 | Rake 0 
Seat 1: s70n3fac3 (big blind) folded before Flop
Seat 2: FDIBA2009 (button) (small blind) collected (200)



PokerStars Home Game Hand #226821854050: {Club #4781089}  Hold'em No Limit (50/100) - 2021/05/17 1:09:52 EET [2021/05/16 18:09:52 ET]
Table 'VTPP NLHE 1605' 2-max (Play Money) Seat #1 is the button
Seat 1: s70n3fac3 (8092 in chips) 
Seat 2: FDIBA2009 (27498 in chips) 
s70n3fac3: posts small blind 50
FDIBA2009: posts big blind 100
*** HOLE CARDS ***
s70n3fac3: calls 50
FDIBA2009: checks 
*** FLOP *** [5d Ac Ah]
FDIBA2009: checks 
s70n3fac3: bets 200
FDIBA2009: folds 
Uncalled bet (200) returned to s70n3fac3
s70n3fac3 collected 189 from pot
s70n3fac3: doesn't show hand 
*** SUMMARY ***
Total pot 200 | Rake 11 
Board [5d Ac Ah]
Seat 1: s70n3fac3 (button) (small blind) collected (189)
Seat 2: FDIBA2009 (big blind) folded on the Flop



PokerStars Home Game Hand #226821858485: {Club #4781089}  Hold'em No Limit (50/100) - 2021/05/17 1:10:01 EET [2021/05/16 18:10:01 ET]
Table 'VTPP NLHE 1605' 2-max (Play Money) Seat #2 is the button
Seat 1: s70n3fac3 (8181 in chips) 
Seat 2: FDIBA2009 (27398 in chips) 
FDIBA2009: posts small blind 50
s70n3fac3: posts big blind 100
*** HOLE CARDS ***
FDIBA2009: raises 100 to 200
s70n3fac3: folds 
Uncalled bet (100) returned to FDIBA2009
FDIBA2009 collected 200 from pot
*** SUMMARY ***
Total pot 200 | Rake 0 
Seat 1: s70n3fac3 (big blind) folded before Flop
Seat 2: FDIBA2009 (button) (small blind) collected (200)



PokerStars Home Game Hand #226821861049: {Club #4781089}  Hold'em No Limit (50/100) - 2021/05/17 1:10:06 EET [2021/05/16 18:10:06 ET]
Table 'VTPP NLHE 1605' 2-max (Play Money) Seat #1 is the button
Seat 1: s70n3fac3 (8081 in chips) 
Seat 2: FDIBA2009 (27498 in chips) 
s70n3fac3: posts small blind 50
FDIBA2009: posts big blind 100
*** HOLE CARDS ***
s70n3fac3: raises 100 to 200
FDIBA2009: calls 100
*** FLOP *** [Qs 8c 5c]
FDIBA2009: checks 
s70n3fac3: checks 
*** TURN *** [Qs 8c 5c] [4h]
FDIBA2009: checks 
s70n3fac3: checks 
*** RIVER *** [Qs 8c 5c 4h] [5s]
FDIBA2009: checks 
s70n3fac3: checks 
*** SHOW DOWN ***
FDIBA2009: shows [2d Js] (a pair of Fives)
s70n3fac3: shows [9s Kh] (a pair of Fives - King kicker)
s70n3fac3 collected 378 from pot
*** SUMMARY ***
Total pot 400 | Rake 22 
Board [Qs 8c 5c 4h 5s]
Seat 1: s70n3fac3 (button) (small blind) showed [9s Kh] and won (378) with a pair of Fives
Seat 2: FDIBA2009 (big blind) showed [2d Js] and lost with a pair of Fives



PokerStars Home Game Hand #226821867070: {Club #4781089}  Hold'em No Limit (50/100) - 2021/05/17 1:10:18 EET [2021/05/16 18:10:18 ET]
Table 'VTPP NLHE 1605' 2-max (Play Money) Seat #2 is the button
Seat 1: s70n3fac3 (8259 in chips) 
Seat 2: FDIBA2009 (27298 in chips) 
FDIBA2009: posts small blind 50
s70n3fac3: posts big blind 100
*** HOLE CARDS ***
FDIBA2009: raises 200 to 300
s70n3fac3: calls 200
*** FLOP *** [9s Jc 3h]
s70n3fac3: checks 
FDIBA2009: checks 
*** TURN *** [9s Jc 3h] [4s]
s70n3fac3: checks 
FDIBA2009: checks 
*** RIVER *** [9s Jc 3h 4s] [2s]
s70n3fac3: bets 400
FDIBA2009: folds 
Uncalled bet (400) returned to s70n3fac3
s70n3fac3 collected 567 from pot
s70n3fac3: doesn't show hand 
*** SUMMARY ***
Total pot 600 | Rake 33 
Board [9s Jc 3h 4s 2s]
Seat 1: s70n3fac3 (big blind) collected (567)
Seat 2: FDIBA2009 (button) (small blind) folded on the River



PokerStars Home Game Hand #226821873691: {Club #4781089}  Hold'em No Limit (50/100) - 2021/05/17 1:10:32 EET [2021/05/16 18:10:32 ET]
Table 'VTPP NLHE 1605' 2-max (Play Money) Seat #1 is the button
Seat 1: s70n3fac3 (8526 in chips) 
Seat 2: FDIBA2009 (26998 in chips) 
s70n3fac3: posts small blind 50
FDIBA2009: posts big blind 100
*** HOLE CARDS ***
s70n3fac3: raises 100 to 200
FDIBA2009: calls 100
*** FLOP *** [Ad 9d 8s]
FDIBA2009: checks 
s70n3fac3: bets 200
FDIBA2009: calls 200
*** TURN *** [Ad 9d 8s] [Th]
FDIBA2009: checks 
s70n3fac3: checks 
*** RIVER *** [Ad 9d 8s Th] [8c]
FDIBA2009: bets 756
s70n3fac3: folds 
Uncalled bet (756) returned to FDIBA2009
FDIBA2009 collected 756 from pot
*** SUMMARY ***
Total pot 800 | Rake 44 
Board [Ad 9d 8s Th 8c]
Seat 1: s70n3fac3 (button) (small blind) folded on the River
Seat 2: FDIBA2009 (big blind) collected (756)



PokerStars Home Game Hand #226821882463: {Club #4781089}  Hold'em No Limit (50/100) - 2021/05/17 1:10:50 EET [2021/05/16 18:10:50 ET]
Table 'VTPP NLHE 1605' 2-max (Play Money) Seat #2 is the button
Seat 1: s70n3fac3 (8126 in chips) 
Seat 2: FDIBA2009 (27354 in chips) 
FDIBA2009: posts small blind 50
s70n3fac3: posts big blind 100
*** HOLE CARDS ***
FDIBA2009: raises 100 to 200
s70n3fac3: calls 100
*** FLOP *** [Qh As 5d]
s70n3fac3: checks 
FDIBA2009: checks 
*** TURN *** [Qh As 5d] [5s]
s70n3fac3: checks 
FDIBA2009: bets 378
s70n3fac3: calls 378
*** RIVER *** [Qh As 5d 5s] [Kh]
s70n3fac3: checks 
FDIBA2009: bets 546
s70n3fac3: calls 546
*** SHOW DOWN ***
FDIBA2009: shows [5h Jc] (three of a kind, Fives)
s70n3fac3: mucks hand 
FDIBA2009 collected 2124 from pot
*** SUMMARY ***
Total pot 2248 | Rake 124 
Board [Qh As 5d 5s Kh]
Seat 1: s70n3fac3 (big blind) mucked [Qd Ts]
Seat 2: FDIBA2009 (button) (small blind) showed [5h Jc] and won (2124) with three of a kind, Fives



PokerStars Home Game Hand #226821897210: {Club #4781089}  Hold'em No Limit (50/100) - 2021/05/17 1:11:20 EET [2021/05/16 18:11:20 ET]
Table 'VTPP NLHE 1605' 2-max (Play Money) Seat #1 is the button
Seat 1: s70n3fac3 (7002 in chips) 
Seat 2: FDIBA2009 (28354 in chips) 
s70n3fac3: posts small blind 50
FDIBA2009: posts big blind 100
*** HOLE CARDS ***
s70n3fac3: folds 
Uncalled bet (50) returned to FDIBA2009
FDIBA2009 collected 100 from pot
*** SUMMARY ***
Total pot 100 | Rake 0 
Seat 1: s70n3fac3 (button) (small blind) folded before Flop
Seat 2: FDIBA2009 (big blind) collected (100)



PokerStars Home Game Hand #226821899055: {Club #4781089}  Hold'em No Limit (50/100) - 2021/05/17 1:11:24 EET [2021/05/16 18:11:24 ET]
Table 'VTPP NLHE 1605' 2-max (Play Money) Seat #2 is the button
Seat 1: s70n3fac3 (6952 in chips) 
Seat 2: FDIBA2009 (28404 in chips) 
FDIBA2009: posts small blind 50
s70n3fac3: posts big blind 100
*** HOLE CARDS ***
FDIBA2009: raises 100 to 200
s70n3fac3: folds 
Uncalled bet (100) returned to FDIBA2009
FDIBA2009 collected 200 from pot
*** SUMMARY ***
Total pot 200 | Rake 0 
Seat 1: s70n3fac3 (big blind) folded before Flop
Seat 2: FDIBA2009 (button) (small blind) collected (200)



PokerStars Home Game Hand #226821902927: {Club #4781089}  Hold'em No Limit (50/100) - 2021/05/17 1:11:32 EET [2021/05/16 18:11:32 ET]
Table 'VTPP NLHE 1605' 2-max (Play Money) Seat #1 is the button
Seat 1: s70n3fac3 (6852 in chips) 
Seat 2: FDIBA2009 (28504 in chips) 
s70n3fac3: posts small blind 50
FDIBA2009: posts big blind 100
*** HOLE CARDS ***
s70n3fac3: raises 100 to 200
FDIBA2009: calls 100
*** FLOP *** [6s 4d 9h]
FDIBA2009: checks 
s70n3fac3: checks 
*** TURN *** [6s 4d 9h] [Qh]
FDIBA2009: checks 
s70n3fac3: checks 
*** RIVER *** [6s 4d 9h Qh] [3h]
FDIBA2009: bets 378
s70n3fac3: folds 
Uncalled bet (378) returned to FDIBA2009
FDIBA2009 collected 378 from pot
*** SUMMARY ***
Total pot 400 | Rake 22 
Board [6s 4d 9h Qh 3h]
Seat 1: s70n3fac3 (button) (small blind) folded on the River
Seat 2: FDIBA2009 (big blind) collected (378)



PokerStars Home Game Hand #226821912350: {Club #4781089}  Hold'em No Limit (50/100) - 2021/05/17 1:11:47 EET [2021/05/16 18:11:47 ET]
Table 'VTPP NLHE 1605' 2-max (Play Money) Seat #2 is the button
Seat 1: s70n3fac3 (6652 in chips) 
Seat 2: FDIBA2009 (28682 in chips) 
FDIBA2009: posts small blind 50
s70n3fac3: posts big blind 100
*** HOLE CARDS ***
FDIBA2009: raises 100 to 200
s70n3fac3: calls 100
*** FLOP *** [Td 3h Kd]
s70n3fac3: checks 
FDIBA2009: bets 189
s70n3fac3: calls 189
*** TURN *** [Td 3h Kd] [9d]
s70n3fac3: checks 
FDIBA2009: checks 
*** RIVER *** [Td 3h Kd 9d] [2h]
s70n3fac3: checks 
FDIBA2009: checks 
*** SHOW DOWN ***
s70n3fac3: shows [3s Ad] (a pair of Threes)
FDIBA2009: mucks hand 
s70n3fac3 collected 735 from pot
*** SUMMARY ***
Total pot 778 | Rake 43 
Board [Td 3h Kd 9d 2h]
Seat 1: s70n3fac3 (big blind) showed [3s Ad] and won (735) with a pair of Threes
Seat 2: FDIBA2009 (button) (small blind) mucked [7d 5s]



PokerStars Home Game Hand #226821920679: {Club #4781089}  Hold'em No Limit (50/100) - 2021/05/17 1:12:04 EET [2021/05/16 18:12:04 ET]
Table 'VTPP NLHE 1605' 2-max (Play Money) Seat #1 is the button
Seat 1: s70n3fac3 (6998 in chips) 
Seat 2: FDIBA2009 (28293 in chips) 
s70n3fac3: posts small blind 50
FDIBA2009: posts big blind 100
*** HOLE CARDS ***
s70n3fac3: folds 
Uncalled bet (50) returned to FDIBA2009
FDIBA2009 collected 100 from pot
*** SUMMARY ***
Total pot 100 | Rake 0 
Seat 1: s70n3fac3 (button) (small blind) folded before Flop
Seat 2: FDIBA2009 (big blind) collected (100)



PokerStars Home Game Hand #226821922600: {Club #4781089}  Hold'em No Limit (50/100) - 2021/05/17 1:12:08 EET [2021/05/16 18:12:08 ET]
Table 'VTPP NLHE 1605' 2-max (Play Money) Seat #2 is the button
Seat 1: s70n3fac3 (6948 in chips) 
Seat 2: FDIBA2009 (28343 in chips) 
FDIBA2009: posts small blind 50
s70n3fac3: posts big blind 100
*** HOLE CARDS ***
FDIBA2009: raises 100 to 200
s70n3fac3: calls 100
*** FLOP *** [4s 5c Jc]
s70n3fac3: checks 
FDIBA2009: bets 100
s70n3fac3: folds 
Uncalled bet (100) returned to FDIBA2009
FDIBA2009 collected 378 from pot
*** SUMMARY ***
Total pot 400 | Rake 22 
Board [4s 5c Jc]
Seat 1: s70n3fac3 (big blind) folded on the Flop
Seat 2: FDIBA2009 (button) (small blind) collected (378)



PokerStars Home Game Hand #226821926678: {Club #4781089}  Hold'em No Limit (50/100) - 2021/05/17 1:12:17 EET [2021/05/16 18:12:17 ET]
Table 'VTPP NLHE 1605' 2-max (Play Money) Seat #1 is the button
Seat 1: s70n3fac3 (6748 in chips) 
Seat 2: FDIBA2009 (28521 in chips) 
s70n3fac3: posts small blind 50
FDIBA2009: posts big blind 100
*** HOLE CARDS ***
s70n3fac3: folds 
Uncalled bet (50) returned to FDIBA2009
FDIBA2009 collected 100 from pot
*** SUMMARY ***
Total pot 100 | Rake 0 
Seat 1: s70n3fac3 (button) (small blind) folded before Flop
Seat 2: FDIBA2009 (big blind) collected (100)



PokerStars Home Game Hand #226821928377: {Club #4781089}  Hold'em No Limit (50/100) - 2021/05/17 1:12:21 EET [2021/05/16 18:12:21 ET]
Table 'VTPP NLHE 1605' 2-max (Play Money) Seat #2 is the button
Seat 1: s70n3fac3 (6698 in chips) 
Seat 2: FDIBA2009 (28571 in chips) 
FDIBA2009: posts small blind 50
s70n3fac3: posts big blind 100
*** HOLE CARDS ***
FDIBA2009: raises 100 to 200
s70n3fac3: calls 100
*** FLOP *** [8s 4s Js]
s70n3fac3: checks 
FDIBA2009: bets 189
s70n3fac3: folds 
Uncalled bet (189) returned to FDIBA2009
FDIBA2009 collected 378 from pot
*** SUMMARY ***
Total pot 400 | Rake 22 
Board [8s 4s Js]
Seat 1: s70n3fac3 (big blind) folded on the Flop
Seat 2: FDIBA2009 (button) (small blind) collected (378)



PokerStars Home Game Hand #226821933062: {Club #4781089}  Hold'em No Limit (50/100) - 2021/05/17 1:12:30 EET [2021/05/16 18:12:30 ET]
Table 'VTPP NLHE 1605' 2-max (Play Money) Seat #1 is the button
Seat 1: s70n3fac3 (6498 in chips) 
Seat 2: FDIBA2009 (28749 in chips) 
s70n3fac3: posts small blind 50
FDIBA2009: posts big blind 100
*** HOLE CARDS ***
s70n3fac3: raises 100 to 200
FDIBA2009: calls 100
*** FLOP *** [2d Qs 2c]
FDIBA2009: checks 
s70n3fac3: checks 
*** TURN *** [2d Qs 2c] [Js]
FDIBA2009: bets 189
s70n3fac3: folds 
Uncalled bet (189) returned to FDIBA2009
FDIBA2009 collected 378 from pot
*** SUMMARY ***
Total pot 400 | Rake 22 
Board [2d Qs 2c Js]
Seat 1: s70n3fac3 (button) (small blind) folded on the Turn
Seat 2: FDIBA2009 (big blind) collected (378)



PokerStars Home Game Hand #226821939097: {Club #4781089}  Hold'em No Limit (50/100) - 2021/05/17 1:12:43 EET [2021/05/16 18:12:43 ET]
Table 'VTPP NLHE 1605' 2-max (Play Money) Seat #2 is the button
Seat 1: s70n3fac3 (6298 in chips) 
Seat 2: FDIBA2009 (28927 in chips) 
FDIBA2009: posts small blind 50
s70n3fac3: posts big blind 100
*** HOLE CARDS ***
FDIBA2009: raises 100 to 200
s70n3fac3: calls 100
*** FLOP *** [As 5d Tc]
s70n3fac3: checks 
FDIBA2009: checks 
*** TURN *** [As 5d Tc] [3d]
s70n3fac3: checks 
FDIBA2009: checks 
*** RIVER *** [As 5d Tc 3d] [Kh]
s70n3fac3: checks 
FDIBA2009: checks 
*** SHOW DOWN ***
s70n3fac3: shows [7h 9h] (high card Ace)
FDIBA2009: shows [6c Qc] (high card Ace - King+Queen kicker)
FDIBA2009 collected 378 from pot
*** SUMMARY ***
Total pot 400 | Rake 22 
Board [As 5d Tc 3d Kh]
Seat 1: s70n3fac3 (big blind) showed [7h 9h] and lost with high card Ace
Seat 2: FDIBA2009 (button) (small blind) showed [6c Qc] and won (378) with high card Ace



PokerStars Home Game Hand #226821945829: {Club #4781089}  Hold'em No Limit (50/100) - 2021/05/17 1:12:55 EET [2021/05/16 18:12:55 ET]
Table 'VTPP NLHE 1605' 2-max (Play Money) Seat #1 is the button
Seat 1: s70n3fac3 (6098 in chips) 
Seat 2: FDIBA2009 (29105 in chips) 
s70n3fac3: posts small blind 50
FDIBA2009: posts big blind 100
*** HOLE CARDS ***
s70n3fac3: folds 
Uncalled bet (50) returned to FDIBA2009
FDIBA2009 collected 100 from pot
*** SUMMARY ***
Total pot 100 | Rake 0 
Seat 1: s70n3fac3 (button) (small blind) folded before Flop
Seat 2: FDIBA2009 (big blind) collected (100)



PokerStars Home Game Hand #226821947629: {Club #4781089}  Hold'em No Limit (50/100) - 2021/05/17 1:12:59 EET [2021/05/16 18:12:59 ET]
Table 'VTPP NLHE 1605' 2-max (Play Money) Seat #2 is the button
Seat 1: s70n3fac3 (6048 in chips) 
Seat 2: FDIBA2009 (29155 in chips) 
FDIBA2009: posts small blind 50
s70n3fac3: posts big blind 100
*** HOLE CARDS ***
FDIBA2009: raises 100 to 200
s70n3fac3: calls 100
*** FLOP *** [4h 3s 4d]
s70n3fac3: checks 
FDIBA2009: bets 378
s70n3fac3: folds 
Uncalled bet (378) returned to FDIBA2009
FDIBA2009 collected 378 from pot
*** SUMMARY ***
Total pot 400 | Rake 22 
Board [4h 3s 4d]
Seat 1: s70n3fac3 (big blind) folded on the Flop
Seat 2: FDIBA2009 (button) (small blind) collected (378)



PokerStars Home Game Hand #226821952086: {Club #4781089}  Hold'em No Limit (50/100) - 2021/05/17 1:13:08 EET [2021/05/16 18:13:08 ET]
Table 'VTPP NLHE 1605' 2-max (Play Money) Seat #1 is the button
Seat 1: s70n3fac3 (5848 in chips) 
Seat 2: FDIBA2009 (29333 in chips) 
s70n3fac3: posts small blind 50
FDIBA2009: posts big blind 100
*** HOLE CARDS ***
s70n3fac3: folds 
Uncalled bet (50) returned to FDIBA2009
FDIBA2009 collected 100 from pot
*** SUMMARY ***
Total pot 100 | Rake 0 
Seat 1: s70n3fac3 (button) (small blind) folded before Flop
Seat 2: FDIBA2009 (big blind) collected (100)



PokerStars Home Game Hand #226821953839: {Club #4781089}  Hold'em No Limit (50/100) - 2021/05/17 1:13:12 EET [2021/05/16 18:13:12 ET]
Table 'VTPP NLHE 1605' 2-max (Play Money) Seat #2 is the button
Seat 1: s70n3fac3 (5798 in chips) 
Seat 2: FDIBA2009 (29383 in chips) 
FDIBA2009: posts small blind 50
s70n3fac3: posts big blind 100
*** HOLE CARDS ***
FDIBA2009: raises 100 to 200
s70n3fac3: calls 100
*** FLOP *** [2h Ks 3c]
s70n3fac3: checks 
FDIBA2009: checks 
*** TURN *** [2h Ks 3c] [8c]
s70n3fac3: checks 
FDIBA2009: checks 
*** RIVER *** [2h Ks 3c 8c] [5h]
s70n3fac3: bets 100
FDIBA2009: folds 
Uncalled bet (100) returned to s70n3fac3
s70n3fac3 collected 378 from pot
s70n3fac3: doesn't show hand 
*** SUMMARY ***
Total pot 400 | Rake 22 
Board [2h Ks 3c 8c 5h]
Seat 1: s70n3fac3 (big blind) collected (378)
Seat 2: FDIBA2009 (button) (small blind) folded on the River



PokerStars Home Game Hand #226821960098: {Club #4781089}  Hold'em No Limit (50/100) - 2021/05/17 1:13:25 EET [2021/05/16 18:13:25 ET]
Table 'VTPP NLHE 1605' 2-max (Play Money) Seat #1 is the button
Seat 1: s70n3fac3 (5976 in chips) 
Seat 2: FDIBA2009 (29183 in chips) 
s70n3fac3: posts small blind 50
FDIBA2009: posts big blind 100
*** HOLE CARDS ***
s70n3fac3: calls 50
FDIBA2009: checks 
*** FLOP *** [7d 6c 6h]
FDIBA2009: bets 189
s70n3fac3: folds 
Uncalled bet (189) returned to FDIBA2009
FDIBA2009 collected 189 from pot
*** SUMMARY ***
Total pot 200 | Rake 11 
Board [7d 6c 6h]
Seat 1: s70n3fac3 (button) (small blind) folded on the Flop
Seat 2: FDIBA2009 (big blind) collected (189)



PokerStars Home Game Hand #226821964360: {Club #4781089}  Hold'em No Limit (50/100) - 2021/05/17 1:13:34 EET [2021/05/16 18:13:34 ET]
Table 'VTPP NLHE 1605' 2-max (Play Money) Seat #2 is the button
Seat 1: s70n3fac3 (5876 in chips) 
Seat 2: FDIBA2009 (29272 in chips) 
FDIBA2009: posts small blind 50
s70n3fac3: posts big blind 100
*** HOLE CARDS ***
FDIBA2009: raises 100 to 200
s70n3fac3: calls 100
*** FLOP *** [Ad 9s 3c]
s70n3fac3: checks 
FDIBA2009: bets 378
s70n3fac3: folds 
Uncalled bet (378) returned to FDIBA2009
FDIBA2009 collected 378 from pot
*** SUMMARY ***
Total pot 400 | Rake 22 
Board [Ad 9s 3c]
Seat 1: s70n3fac3 (big blind) folded on the Flop
Seat 2: FDIBA2009 (button) (small blind) collected (378)



PokerStars Home Game Hand #226821968965: {Club #4781089}  Hold'em No Limit (50/100) - 2021/05/17 1:13:43 EET [2021/05/16 18:13:43 ET]
Table 'VTPP NLHE 1605' 2-max (Play Money) Seat #1 is the button
Seat 1: s70n3fac3 (5676 in chips) 
Seat 2: FDIBA2009 (29450 in chips) 
s70n3fac3: posts small blind 50
FDIBA2009: posts big blind 100
*** HOLE CARDS ***
s70n3fac3: raises 100 to 200
FDIBA2009: folds 
Uncalled bet (100) returned to s70n3fac3
s70n3fac3 collected 200 from pot
s70n3fac3: doesn't show hand 
*** SUMMARY ***
Total pot 200 | Rake 0 
Seat 1: s70n3fac3 (button) (small blind) collected (200)
Seat 2: FDIBA2009 (big blind) folded before Flop



PokerStars Home Game Hand #226821971133: {Club #4781089}  Hold'em No Limit (50/100) - 2021/05/17 1:13:48 EET [2021/05/16 18:13:48 ET]
Table 'VTPP NLHE 1605' 2-max (Play Money) Seat #2 is the button
Seat 1: s70n3fac3 (5776 in chips) 
Seat 2: FDIBA2009 (29350 in chips) 
FDIBA2009: posts small blind 50
s70n3fac3: posts big blind 100
*** HOLE CARDS ***
FDIBA2009: raises 100 to 200
s70n3fac3: folds 
Uncalled bet (100) returned to FDIBA2009
FDIBA2009 collected 200 from pot
*** SUMMARY ***
Total pot 200 | Rake 0 
Seat 1: s70n3fac3 (big blind) folded before Flop
Seat 2: FDIBA2009 (button) (small blind) collected (200)



PokerStars Home Game Hand #226821973493: {Club #4781089}  Hold'em No Limit (50/100) - 2021/05/17 1:13:53 EET [2021/05/16 18:13:53 ET]
Table 'VTPP NLHE 1605' 2-max (Play Money) Seat #1 is the button
Seat 1: s70n3fac3 (5676 in chips) 
Seat 2: FDIBA2009 (29450 in chips) 
s70n3fac3: posts small blind 50
FDIBA2009: posts big blind 100
*** HOLE CARDS ***
s70n3fac3: raises 100 to 200
FDIBA2009: calls 100
*** FLOP *** [Tc 3c 9h]
FDIBA2009: checks 
s70n3fac3: bets 200
FDIBA2009: calls 200
*** TURN *** [Tc 3c 9h] [Jd]
FDIBA2009: checks 
s70n3fac3: bets 400
FDIBA2009: calls 400
*** RIVER *** [Tc 3c 9h Jd] [9s]
FDIBA2009: checks 
s70n3fac3: checks 
*** SHOW DOWN ***
FDIBA2009: shows [8s 8d] (two pair, Nines and Eights)
s70n3fac3: shows [7c Th] (two pair, Tens and Nines)
s70n3fac3 collected 1512 from pot
*** SUMMARY ***
Total pot 1600 | Rake 88 
Board [Tc 3c 9h Jd 9s]
Seat 1: s70n3fac3 (button) (small blind) showed [7c Th] and won (1512) with two pair, Tens and Nines
Seat 2: FDIBA2009 (big blind) showed [8s 8d] and lost with two pair, Nines and Eights



PokerStars Home Game Hand #226821983281: {Club #4781089}  Hold'em No Limit (50/100) - 2021/05/17 1:14:13 EET [2021/05/16 18:14:13 ET]
Table 'VTPP NLHE 1605' 2-max (Play Money) Seat #2 is the button
Seat 1: s70n3fac3 (6388 in chips) 
Seat 2: FDIBA2009 (28650 in chips) 
FDIBA2009: posts small blind 50
s70n3fac3: posts big blind 100
*** HOLE CARDS ***
FDIBA2009: raises 100 to 200
s70n3fac3: folds 
Uncalled bet (100) returned to FDIBA2009
FDIBA2009 collected 200 from pot
*** SUMMARY ***
Total pot 200 | Rake 0 
Seat 1: s70n3fac3 (big blind) folded before Flop
Seat 2: FDIBA2009 (button) (small blind) collected (200)



PokerStars Home Game Hand #226821986457: {Club #4781089}  Hold'em No Limit (50/100) - 2021/05/17 1:14:20 EET [2021/05/16 18:14:20 ET]
Table 'VTPP NLHE 1605' 2-max (Play Money) Seat #1 is the button
Seat 1: s70n3fac3 (6288 in chips) 
Seat 2: FDIBA2009 (28750 in chips) 
s70n3fac3: posts small blind 50
FDIBA2009: posts big blind 100
*** HOLE CARDS ***
s70n3fac3: raises 100 to 200
FDIBA2009: calls 100
*** FLOP *** [4d 9c 7h]
FDIBA2009: checks 
s70n3fac3: checks 
*** TURN *** [4d 9c 7h] [4h]
FDIBA2009: bets 378
s70n3fac3: folds 
Uncalled bet (378) returned to FDIBA2009
FDIBA2009 collected 378 from pot
*** SUMMARY ***
Total pot 400 | Rake 22 
Board [4d 9c 7h 4h]
Seat 1: s70n3fac3 (button) (small blind) folded on the Turn
Seat 2: FDIBA2009 (big blind) collected (378)



PokerStars Home Game Hand #226821993045: {Club #4781089}  Hold'em No Limit (50/100) - 2021/05/17 1:14:34 EET [2021/05/16 18:14:34 ET]
Table 'VTPP NLHE 1605' 2-max (Play Money) Seat #2 is the button
Seat 1: s70n3fac3 (6088 in chips) 
Seat 2: FDIBA2009 (28928 in chips) 
FDIBA2009: posts small blind 50
s70n3fac3: posts big blind 100
*** HOLE CARDS ***
FDIBA2009: raises 100 to 200
s70n3fac3: calls 100
*** FLOP *** [6c 7c 5d]
s70n3fac3: checks 
FDIBA2009: bets 378
s70n3fac3: calls 378
*** TURN *** [6c 7c 5d] [7s]
s70n3fac3: checks 
FDIBA2009: checks 
*** RIVER *** [6c 7c 5d 7s] [5s]
s70n3fac3: checks 
FDIBA2009: bets 1092
s70n3fac3: calls 1092
*** SHOW DOWN ***
FDIBA2009: shows [5h Jd] (a full house, Fives full of Sevens)
s70n3fac3: mucks hand 
FDIBA2009 collected 3156 from pot
*** SUMMARY ***
Total pot 3340 | Rake 184 
Board [6c 7c 5d 7s 5s]
Seat 1: s70n3fac3 (big blind) mucked [3d 6d]
Seat 2: FDIBA2009 (button) (small blind) showed [5h Jd] and won (3156) with a full house, Fives full of Sevens



PokerStars Home Game Hand #226822006505: {Club #4781089}  Hold'em No Limit (50/100) - 2021/05/17 1:15:02 EET [2021/05/16 18:15:02 ET]
Table 'VTPP NLHE 1605' 2-max (Play Money) Seat #1 is the button
Seat 1: s70n3fac3 (4418 in chips) 
Seat 2: FDIBA2009 (30414 in chips) 
s70n3fac3: posts small blind 50
FDIBA2009: posts big blind 100
*** HOLE CARDS ***
s70n3fac3: raises 100 to 200
FDIBA2009: calls 100
*** FLOP *** [4c 2c 4d]
FDIBA2009: checks 
s70n3fac3: bets 200
FDIBA2009: folds 
Uncalled bet (200) returned to s70n3fac3
s70n3fac3 collected 378 from pot
s70n3fac3: doesn't show hand 
*** SUMMARY ***
Total pot 400 | Rake 22 
Board [4c 2c 4d]
Seat 1: s70n3fac3 (button) (small blind) collected (378)
Seat 2: FDIBA2009 (big blind) folded on the Flop



PokerStars Home Game Hand #226822013582: {Club #4781089}  Hold'em No Limit (50/100) - 2021/05/17 1:15:17 EET [2021/05/16 18:15:17 ET]
Table 'VTPP NLHE 1605' 2-max (Play Money) Seat #2 is the button
Seat 1: s70n3fac3 (4596 in chips) 
Seat 2: FDIBA2009 (30214 in chips) 
FDIBA2009: posts small blind 50
s70n3fac3: posts big blind 100
*** HOLE CARDS ***
FDIBA2009: raises 100 to 200
s70n3fac3: folds 
Uncalled bet (100) returned to FDIBA2009
FDIBA2009 collected 200 from pot
*** SUMMARY ***
Total pot 200 | Rake 0 
Seat 1: s70n3fac3 (big blind) folded before Flop
Seat 2: FDIBA2009 (button) (small blind) collected (200)



PokerStars Home Game Hand #226822016584: {Club #4781089}  Hold'em No Limit (50/100) - 2021/05/17 1:15:23 EET [2021/05/16 18:15:23 ET]
Table 'VTPP NLHE 1605' 2-max (Play Money) Seat #1 is the button
Seat 1: s70n3fac3 (4496 in chips) 
Seat 2: FDIBA2009 (30314 in chips) 
s70n3fac3: posts small blind 50
FDIBA2009: posts big blind 100
*** HOLE CARDS ***
s70n3fac3: raises 100 to 200
FDIBA2009: calls 100
*** FLOP *** [Ts 9s 4d]
FDIBA2009: checks 
s70n3fac3: checks 
*** TURN *** [Ts 9s 4d] [Ac]
FDIBA2009: bets 378
s70n3fac3: folds 
Uncalled bet (378) returned to FDIBA2009
FDIBA2009 collected 378 from pot
*** SUMMARY ***
Total pot 400 | Rake 22 
Board [Ts 9s 4d Ac]
Seat 1: s70n3fac3 (button) (small blind) folded on the Turn
Seat 2: FDIBA2009 (big blind) collected (378)



PokerStars Home Game Hand #226822023336: {Club #4781089}  Hold'em No Limit (50/100) - 2021/05/17 1:15:37 EET [2021/05/16 18:15:37 ET]
Table 'VTPP NLHE 1605' 2-max (Play Money) Seat #2 is the button
Seat 1: s70n3fac3 (4296 in chips) 
Seat 2: FDIBA2009 (30492 in chips) 
FDIBA2009: posts small blind 50
s70n3fac3: posts big blind 100
*** HOLE CARDS ***
FDIBA2009: raises 100 to 200
s70n3fac3: folds 
Uncalled bet (100) returned to FDIBA2009
FDIBA2009 collected 200 from pot
*** SUMMARY ***
Total pot 200 | Rake 0 
Seat 1: s70n3fac3 (big blind) folded before Flop
Seat 2: FDIBA2009 (button) (small blind) collected (200)



PokerStars Home Game Hand #226822026133: {Club #4781089}  Hold'em No Limit (50/100) - 2021/05/17 1:15:43 EET [2021/05/16 18:15:43 ET]
Table 'VTPP NLHE 1605' 2-max (Play Money) Seat #1 is the button
Seat 1: s70n3fac3 (4196 in chips) 
Seat 2: FDIBA2009 (30592 in chips) 
s70n3fac3: posts small blind 50
FDIBA2009: posts big blind 100
*** HOLE CARDS ***
s70n3fac3: raises 100 to 200
FDIBA2009: calls 100
*** FLOP *** [9d 9h 8h]
FDIBA2009: checks 
s70n3fac3: bets 200
FDIBA2009: folds 
Uncalled bet (200) returned to s70n3fac3
s70n3fac3 collected 378 from pot
s70n3fac3: doesn't show hand 
*** SUMMARY ***
Total pot 400 | Rake 22 
Board [9d 9h 8h]
Seat 1: s70n3fac3 (button) (small blind) collected (378)
Seat 2: FDIBA2009 (big blind) folded on the Flop



PokerStars Home Game Hand #226822030798: {Club #4781089}  Hold'em No Limit (50/100) - 2021/05/17 1:15:53 EET [2021/05/16 18:15:53 ET]
Table 'VTPP NLHE 1605' 2-max (Play Money) Seat #2 is the button
Seat 1: s70n3fac3 (4374 in chips) 
Seat 2: FDIBA2009 (30392 in chips) 
FDIBA2009: posts small blind 50
s70n3fac3: posts big blind 100
*** HOLE CARDS ***
FDIBA2009: raises 100 to 200
s70n3fac3: folds 
Uncalled bet (100) returned to FDIBA2009
FDIBA2009 collected 200 from pot
*** SUMMARY ***
Total pot 200 | Rake 0 
Seat 1: s70n3fac3 (big blind) folded before Flop
Seat 2: FDIBA2009 (button) (small blind) collected (200)



PokerStars Home Game Hand #226822033208: {Club #4781089}  Hold'em No Limit (50/100) - 2021/05/17 1:15:58 EET [2021/05/16 18:15:58 ET]
Table 'VTPP NLHE 1605' 2-max (Play Money) Seat #1 is the button
Seat 1: s70n3fac3 (4274 in chips) 
Seat 2: FDIBA2009 (30492 in chips) 
s70n3fac3: posts small blind 50
FDIBA2009: posts big blind 100
*** HOLE CARDS ***
s70n3fac3: folds 
Uncalled bet (50) returned to FDIBA2009
FDIBA2009 collected 100 from pot
*** SUMMARY ***
Total pot 100 | Rake 0 
Seat 1: s70n3fac3 (button) (small blind) folded before Flop
Seat 2: FDIBA2009 (big blind) collected (100)



PokerStars Home Game Hand #226822035088: {Club #4781089}  Hold'em No Limit (50/100) - 2021/05/17 1:16:02 EET [2021/05/16 18:16:02 ET]
Table 'VTPP NLHE 1605' 2-max (Play Money) Seat #2 is the button
Seat 1: s70n3fac3 (4224 in chips) 
Seat 2: FDIBA2009 (30542 in chips) 
FDIBA2009: posts small blind 50
s70n3fac3: posts big blind 100
*** HOLE CARDS ***
FDIBA2009: raises 100 to 200
s70n3fac3: calls 100
*** FLOP *** [2s 4d Ah]
s70n3fac3: checks 
FDIBA2009: bets 189
s70n3fac3: folds 
Uncalled bet (189) returned to FDIBA2009
FDIBA2009 collected 378 from pot
*** SUMMARY ***
Total pot 400 | Rake 22 
Board [2s 4d Ah]
Seat 1: s70n3fac3 (big blind) folded on the Flop
Seat 2: FDIBA2009 (button) (small blind) collected (378)



PokerStars Home Game Hand #226822044489: {Club #4781089}  Hold'em No Limit (50/100) - 2021/05/17 1:16:12 EET [2021/05/16 18:16:12 ET]
Table 'VTPP NLHE 1605' 2-max (Play Money) Seat #1 is the button
Seat 1: s70n3fac3 (4024 in chips) 
Seat 2: FDIBA2009 (30720 in chips) 
s70n3fac3: posts small blind 50
FDIBA2009: posts big blind 100
*** HOLE CARDS ***
s70n3fac3: raises 100 to 200
FDIBA2009: calls 100
*** FLOP *** [Kd 8s Ad]
FDIBA2009: checks 
s70n3fac3: bets 200
FDIBA2009: calls 200
*** TURN *** [Kd 8s Ad] [3d]
FDIBA2009: checks 
s70n3fac3: checks 
*** RIVER *** [Kd 8s Ad 3d] [Kh]
FDIBA2009: bets 378
s70n3fac3: folds 
Uncalled bet (378) returned to FDIBA2009
FDIBA2009 collected 756 from pot
*** SUMMARY ***
Total pot 800 | Rake 44 
Board [Kd 8s Ad 3d Kh]
Seat 1: s70n3fac3 (button) (small blind) folded on the River
Seat 2: FDIBA2009 (big blind) collected (756)



PokerStars Home Game Hand #226822055209: {Club #4781089}  Hold'em No Limit (50/100) - 2021/05/17 1:16:35 EET [2021/05/16 18:16:35 ET]
Table 'VTPP NLHE 1605' 2-max (Play Money) Seat #2 is the button
Seat 1: s70n3fac3 (3624 in chips) 
Seat 2: FDIBA2009 (31076 in chips) 
FDIBA2009: posts small blind 50
s70n3fac3: posts big blind 100
*** HOLE CARDS ***
FDIBA2009: raises 100 to 200
s70n3fac3: raises 500 to 700
FDIBA2009: folds 
Uncalled bet (500) returned to s70n3fac3
s70n3fac3 collected 400 from pot
s70n3fac3: doesn't show hand 
*** SUMMARY ***
Total pot 400 | Rake 0 
Seat 1: s70n3fac3 (big blind) collected (400)
Seat 2: FDIBA2009 (button) (small blind) folded before Flop



PokerStars Home Game Hand #226822060362: {Club #4781089}  Hold'em No Limit (50/100) - 2021/05/17 1:16:42 EET [2021/05/16 18:16:42 ET]
Table 'VTPP NLHE 1605' 2-max (Play Money) Seat #1 is the button
Seat 1: s70n3fac3 (3824 in chips) 
Seat 2: FDIBA2009 (30876 in chips) 
s70n3fac3: posts small blind 50
FDIBA2009: posts big blind 100
*** HOLE CARDS ***
s70n3fac3: calls 50
FDIBA2009: checks 
*** FLOP *** [Ac 5h As]
FDIBA2009: checks 
s70n3fac3: bets 100
FDIBA2009: folds 
Uncalled bet (100) returned to s70n3fac3
s70n3fac3 collected 189 from pot
s70n3fac3: doesn't show hand 
*** SUMMARY ***
Total pot 200 | Rake 11 
Board [Ac 5h As]
Seat 1: s70n3fac3 (button) (small blind) collected (189)
Seat 2: FDIBA2009 (big blind) folded on the Flop



PokerStars Home Game Hand #226822064118: {Club #4781089}  Hold'em No Limit (50/100) - 2021/05/17 1:16:50 EET [2021/05/16 18:16:50 ET]
Table 'VTPP NLHE 1605' 2-max (Play Money) Seat #2 is the button
Seat 1: s70n3fac3 (3913 in chips) 
Seat 2: FDIBA2009 (30776 in chips) 
FDIBA2009: posts small blind 50
s70n3fac3: posts big blind 100
*** HOLE CARDS ***
FDIBA2009: raises 100 to 200
s70n3fac3: raises 500 to 700
FDIBA2009: calls 500
*** FLOP *** [3h 5d 8s]
s70n3fac3: bets 700
FDIBA2009: folds 
Uncalled bet (700) returned to s70n3fac3
s70n3fac3 collected 1323 from pot
s70n3fac3: doesn't show hand 
*** SUMMARY ***
Total pot 1400 | Rake 77 
Board [3h 5d 8s]
Seat 1: s70n3fac3 (big blind) collected (1323)
Seat 2: FDIBA2009 (button) (small blind) folded on the Flop



PokerStars Home Game Hand #226822073948: {Club #4781089}  Hold'em No Limit (50/100) - 2021/05/17 1:17:11 EET [2021/05/16 18:17:11 ET]
Table 'VTPP NLHE 1605' 2-max (Play Money) Seat #1 is the button
Seat 1: s70n3fac3 (4536 in chips) 
Seat 2: FDIBA2009 (30076 in chips) 
s70n3fac3: posts small blind 50
FDIBA2009: posts big blind 100
*** HOLE CARDS ***
s70n3fac3: calls 50
FDIBA2009: checks 
*** FLOP *** [Ad Kh 7s]
FDIBA2009: checks 
s70n3fac3: bets 100
FDIBA2009: folds 
Uncalled bet (100) returned to s70n3fac3
s70n3fac3 collected 189 from pot
s70n3fac3: doesn't show hand 
*** SUMMARY ***
Total pot 200 | Rake 11 
Board [Ad Kh 7s]
Seat 1: s70n3fac3 (button) (small blind) collected (189)
Seat 2: FDIBA2009 (big blind) folded on the Flop



PokerStars Home Game Hand #226822083588: {Club #4781089}  Hold'em No Limit (50/100) - 2021/05/17 1:17:19 EET [2021/05/16 18:17:19 ET]
Table 'VTPP NLHE 1605' 2-max (Play Money) Seat #2 is the button
Seat 1: s70n3fac3 (4625 in chips) 
Seat 2: FDIBA2009 (29976 in chips) 
FDIBA2009: posts small blind 50
s70n3fac3: posts big blind 100
*** HOLE CARDS ***
FDIBA2009: raises 100 to 200
s70n3fac3: raises 500 to 700
FDIBA2009: calls 500
*** FLOP *** [Qs 3c Td]
s70n3fac3: bets 700
FDIBA2009: folds 
Uncalled bet (700) returned to s70n3fac3
s70n3fac3 collected 1323 from pot
s70n3fac3: doesn't show hand 
*** SUMMARY ***
Total pot 1400 | Rake 77 
Board [Qs 3c Td]
Seat 1: s70n3fac3 (big blind) collected (1323)
Seat 2: FDIBA2009 (button) (small blind) folded on the Flop



PokerStars Home Game Hand #226822091029: {Club #4781089}  Hold'em No Limit (50/100) - 2021/05/17 1:17:35 EET [2021/05/16 18:17:35 ET]
Table 'VTPP NLHE 1605' 2-max (Play Money) Seat #1 is the button
Seat 1: s70n3fac3 (5248 in chips) 
Seat 2: FDIBA2009 (29276 in chips) 
s70n3fac3: posts small blind 50
FDIBA2009: posts big blind 100
*** HOLE CARDS ***
s70n3fac3: folds 
Uncalled bet (50) returned to FDIBA2009
FDIBA2009 collected 100 from pot
*** SUMMARY ***
Total pot 100 | Rake 0 
Seat 1: s70n3fac3 (button) (small blind) folded before Flop
Seat 2: FDIBA2009 (big blind) collected (100)



PokerStars Home Game Hand #226822092882: {Club #4781089}  Hold'em No Limit (50/100) - 2021/05/17 1:17:39 EET [2021/05/16 18:17:39 ET]
Table 'VTPP NLHE 1605' 2-max (Play Money) Seat #2 is the button
Seat 1: s70n3fac3 (5198 in chips) 
Seat 2: FDIBA2009 (29326 in chips) 
FDIBA2009: posts small blind 50
s70n3fac3: posts big blind 100
*** HOLE CARDS ***
FDIBA2009: raises 100 to 200
s70n3fac3: folds 
Uncalled bet (100) returned to FDIBA2009
FDIBA2009 collected 200 from pot
*** SUMMARY ***
Total pot 200 | Rake 0 
Seat 1: s70n3fac3 (big blind) folded before Flop
Seat 2: FDIBA2009 (button) (small blind) collected (200)



PokerStars Home Game Hand #226822096600: {Club #4781089}  Hold'em No Limit (50/100) - 2021/05/17 1:17:47 EET [2021/05/16 18:17:47 ET]
Table 'VTPP NLHE 1605' 2-max (Play Money) Seat #1 is the button
Seat 1: s70n3fac3 (5098 in chips) 
Seat 2: FDIBA2009 (29426 in chips) 
s70n3fac3: posts small blind 50
FDIBA2009: posts big blind 100
*** HOLE CARDS ***
s70n3fac3: calls 50
FDIBA2009: checks 
*** FLOP *** [8h 7d Tc]
FDIBA2009: checks 
s70n3fac3: checks 
*** TURN *** [8h 7d Tc] [8s]
FDIBA2009: bets 189
s70n3fac3: folds 
Uncalled bet (189) returned to FDIBA2009
FDIBA2009 collected 189 from pot
*** SUMMARY ***
Total pot 200 | Rake 11 
Board [8h 7d Tc 8s]
Seat 1: s70n3fac3 (button) (small blind) folded on the Turn
Seat 2: FDIBA2009 (big blind) collected (189)



PokerStars Home Game Hand #226822102176: {Club #4781089}  Hold'em No Limit (50/100) - 2021/05/17 1:17:58 EET [2021/05/16 18:17:58 ET]
Table 'VTPP NLHE 1605' 2-max (Play Money) Seat #2 is the button
Seat 1: s70n3fac3 (4998 in chips) 
Seat 2: FDIBA2009 (29515 in chips) 
FDIBA2009: posts small blind 50
s70n3fac3: posts big blind 100
*** HOLE CARDS ***
FDIBA2009: raises 100 to 200
s70n3fac3: folds 
Uncalled bet (100) returned to FDIBA2009
FDIBA2009 collected 200 from pot
*** SUMMARY ***
Total pot 200 | Rake 0 
Seat 1: s70n3fac3 (big blind) folded before Flop
Seat 2: FDIBA2009 (button) (small blind) collected (200)



PokerStars Home Game Hand #226822104838: {Club #4781089}  Hold'em No Limit (50/100) - 2021/05/17 1:18:04 EET [2021/05/16 18:18:04 ET]
Table 'VTPP NLHE 1605' 2-max (Play Money) Seat #1 is the button
Seat 1: s70n3fac3 (4898 in chips) 
Seat 2: FDIBA2009 (29615 in chips) 
s70n3fac3: posts small blind 50
FDIBA2009: posts big blind 100
*** HOLE CARDS ***
s70n3fac3: raises 100 to 200
FDIBA2009: folds 
Uncalled bet (100) returned to s70n3fac3
s70n3fac3 collected 200 from pot
s70n3fac3: doesn't show hand 
*** SUMMARY ***
Total pot 200 | Rake 0 
Seat 1: s70n3fac3 (button) (small blind) collected (200)
Seat 2: FDIBA2009 (big blind) folded before Flop



PokerStars Home Game Hand #226822107177: {Club #4781089}  Hold'em No Limit (50/100) - 2021/05/17 1:18:09 EET [2021/05/16 18:18:09 ET]
Table 'VTPP NLHE 1605' 2-max (Play Money) Seat #2 is the button
Seat 1: s70n3fac3 (4998 in chips) 
Seat 2: FDIBA2009 (29515 in chips) 
FDIBA2009: posts small blind 50
s70n3fac3: posts big blind 100
*** HOLE CARDS ***
FDIBA2009: raises 100 to 200
s70n3fac3: calls 100
*** FLOP *** [7c 7s 2d]
s70n3fac3: checks 
FDIBA2009: bets 378
s70n3fac3: folds 
Uncalled bet (378) returned to FDIBA2009
FDIBA2009 collected 378 from pot
*** SUMMARY ***
Total pot 400 | Rake 22 
Board [7c 7s 2d]
Seat 1: s70n3fac3 (big blind) folded on the Flop
Seat 2: FDIBA2009 (button) (small blind) collected (378)



PokerStars Home Game Hand #226822112598: {Club #4781089}  Hold'em No Limit (50/100) - 2021/05/17 1:18:21 EET [2021/05/16 18:18:21 ET]
Table 'VTPP NLHE 1605' 2-max (Play Money) Seat #1 is the button
Seat 1: s70n3fac3 (4798 in chips) 
Seat 2: FDIBA2009 (29693 in chips) 
s70n3fac3: posts small blind 50
FDIBA2009: posts big blind 100
*** HOLE CARDS ***
s70n3fac3: raises 100 to 200
FDIBA2009: calls 100
*** FLOP *** [3h 9h 2s]
FDIBA2009: checks 
s70n3fac3: checks 
*** TURN *** [3h 9h 2s] [8d]
FDIBA2009: checks 
s70n3fac3: bets 100
FDIBA2009: calls 100
*** RIVER *** [3h 9h 2s 8d] [Kh]
FDIBA2009: bets 567
s70n3fac3: calls 567
*** SHOW DOWN ***
FDIBA2009: shows [Ah 4c] (high card Ace)
s70n3fac3: shows [Qh Ks] (a pair of Kings)
s70n3fac3 collected 1639 from pot
*** SUMMARY ***
Total pot 1734 | Rake 95 
Board [3h 9h 2s 8d Kh]
Seat 1: s70n3fac3 (button) (small blind) showed [Qh Ks] and won (1639) with a pair of Kings
Seat 2: FDIBA2009 (big blind) showed [Ah 4c] and lost with high card Ace



PokerStars Home Game Hand #226822121374: {Club #4781089}  Hold'em No Limit (50/100) - 2021/05/17 1:18:39 EET [2021/05/16 18:18:39 ET]
Table 'VTPP NLHE 1605' 2-max (Play Money) Seat #2 is the button
Seat 1: s70n3fac3 (5570 in chips) 
Seat 2: FDIBA2009 (28826 in chips) 
FDIBA2009: posts small blind 50
s70n3fac3: posts big blind 100
*** HOLE CARDS ***
FDIBA2009: raises 200 to 300
s70n3fac3: folds 
Uncalled bet (200) returned to FDIBA2009
FDIBA2009 collected 200 from pot
*** SUMMARY ***
Total pot 200 | Rake 0 
Seat 1: s70n3fac3 (big blind) folded before Flop
Seat 2: FDIBA2009 (button) (small blind) collected (200)



PokerStars Home Game Hand #226822124544: {Club #4781089}  Hold'em No Limit (50/100) - 2021/05/17 1:18:46 EET [2021/05/16 18:18:46 ET]
Table 'VTPP NLHE 1605' 2-max (Play Money) Seat #1 is the button
Seat 1: s70n3fac3 (5470 in chips) 
Seat 2: FDIBA2009 (28926 in chips) 
s70n3fac3: posts small blind 50
FDIBA2009: posts big blind 100
*** HOLE CARDS ***
s70n3fac3: folds 
Uncalled bet (50) returned to FDIBA2009
FDIBA2009 collected 100 from pot
*** SUMMARY ***
Total pot 100 | Rake 0 
Seat 1: s70n3fac3 (button) (small blind) folded before Flop
Seat 2: FDIBA2009 (big blind) collected (100)



PokerStars Home Game Hand #226822126384: {Club #4781089}  Hold'em No Limit (50/100) - 2021/05/17 1:18:50 EET [2021/05/16 18:18:50 ET]
Table 'VTPP NLHE 1605' 2-max (Play Money) Seat #2 is the button
Seat 1: s70n3fac3 (5420 in chips) 
Seat 2: FDIBA2009 (28976 in chips) 
FDIBA2009: posts small blind 50
s70n3fac3: posts big blind 100
*** HOLE CARDS ***
FDIBA2009: raises 100 to 200
s70n3fac3: calls 100
*** FLOP *** [Ad 9c Qc]
s70n3fac3: checks 
FDIBA2009: checks 
*** TURN *** [Ad 9c Qc] [4d]
s70n3fac3: checks 
FDIBA2009: bets 378
s70n3fac3: calls 378
*** RIVER *** [Ad 9c Qc 4d] [Ks]
s70n3fac3: checks 
FDIBA2009: checks 
*** SHOW DOWN ***
s70n3fac3: shows [8s Qh] (a pair of Queens)
FDIBA2009: mucks hand 
s70n3fac3 collected 1092 from pot
*** SUMMARY ***
Total pot 1156 | Rake 64 
Board [Ad 9c Qc 4d Ks]
Seat 1: s70n3fac3 (big blind) showed [8s Qh] and won (1092) with a pair of Queens
Seat 2: FDIBA2009 (button) (small blind) mucked [3s Th]



PokerStars Home Game Hand #226822134911: {Club #4781089}  Hold'em No Limit (50/100) - 2021/05/17 1:19:08 EET [2021/05/16 18:19:08 ET]
Table 'VTPP NLHE 1605' 2-max (Play Money) Seat #1 is the button
Seat 1: s70n3fac3 (5934 in chips) 
Seat 2: FDIBA2009 (28398 in chips) 
s70n3fac3: posts small blind 50
FDIBA2009: posts big blind 100
*** HOLE CARDS ***
s70n3fac3: folds 
Uncalled bet (50) returned to FDIBA2009
FDIBA2009 collected 100 from pot
*** SUMMARY ***
Total pot 100 | Rake 0 
Seat 1: s70n3fac3 (button) (small blind) folded before Flop
Seat 2: FDIBA2009 (big blind) collected (100)



PokerStars Home Game Hand #226822136662: {Club #4781089}  Hold'em No Limit (50/100) - 2021/05/17 1:19:12 EET [2021/05/16 18:19:12 ET]
Table 'VTPP NLHE 1605' 2-max (Play Money) Seat #2 is the button
Seat 1: s70n3fac3 (5884 in chips) 
Seat 2: FDIBA2009 (28448 in chips) 
FDIBA2009: posts small blind 50
s70n3fac3: posts big blind 100
*** HOLE CARDS ***
FDIBA2009: raises 100 to 200
s70n3fac3: calls 100
*** FLOP *** [8s 2d 3s]
s70n3fac3: checks 
FDIBA2009: checks 
*** TURN *** [8s 2d 3s] [3d]
s70n3fac3: checks 
FDIBA2009: checks 
*** RIVER *** [8s 2d 3s 3d] [9h]
s70n3fac3: bets 200
FDIBA2009: folds 
Uncalled bet (200) returned to s70n3fac3
s70n3fac3 collected 378 from pot
s70n3fac3: doesn't show hand 
*** SUMMARY ***
Total pot 400 | Rake 22 
Board [8s 2d 3s 3d 9h]
Seat 1: s70n3fac3 (big blind) collected (378)
Seat 2: FDIBA2009 (button) (small blind) folded on the River



PokerStars Home Game Hand #226822142625: {Club #4781089}  Hold'em No Limit (50/100) - 2021/05/17 1:19:25 EET [2021/05/16 18:19:25 ET]
Table 'VTPP NLHE 1605' 2-max (Play Money) Seat #1 is the button
Seat 1: s70n3fac3 (6062 in chips) 
Seat 2: FDIBA2009 (28248 in chips) 
s70n3fac3: posts small blind 50
FDIBA2009: posts big blind 100
*** HOLE CARDS ***
s70n3fac3: raises 100 to 200
FDIBA2009: calls 100
*** FLOP *** [6s 6c 8h]
FDIBA2009: checks 
s70n3fac3: checks 
*** TURN *** [6s 6c 8h] [4s]
FDIBA2009: bets 378
s70n3fac3: folds 
Uncalled bet (378) returned to FDIBA2009
FDIBA2009 collected 378 from pot
*** SUMMARY ***
Total pot 400 | Rake 22 
Board [6s 6c 8h 4s]
Seat 1: s70n3fac3 (button) (small blind) folded on the Turn
Seat 2: FDIBA2009 (big blind) collected (378)



PokerStars Home Game Hand #226822149890: {Club #4781089}  Hold'em No Limit (50/100) - 2021/05/17 1:19:40 EET [2021/05/16 18:19:40 ET]
Table 'VTPP NLHE 1605' 2-max (Play Money) Seat #2 is the button
Seat 1: s70n3fac3 (5862 in chips) 
Seat 2: FDIBA2009 (28426 in chips) 
FDIBA2009: posts small blind 50
s70n3fac3: posts big blind 100
*** HOLE CARDS ***
FDIBA2009: raises 100 to 200
s70n3fac3: calls 100
*** FLOP *** [Jh 5d Td]
s70n3fac3: checks 
FDIBA2009: bets 189
s70n3fac3: calls 189
*** TURN *** [Jh 5d Td] [2h]
s70n3fac3: checks 
FDIBA2009: checks 
*** RIVER *** [Jh 5d Td 2h] [8h]
s70n3fac3: checks 
FDIBA2009: bets 735
s70n3fac3: folds 
Uncalled bet (735) returned to FDIBA2009
FDIBA2009 collected 735 from pot
*** SUMMARY ***
Total pot 778 | Rake 43 
Board [Jh 5d Td 2h 8h]
Seat 1: s70n3fac3 (big blind) folded on the River
Seat 2: FDIBA2009 (button) (small blind) collected (735)



PokerStars Home Game Hand #226822163808: {Club #4781089}  Hold'em No Limit (50/100) - 2021/05/17 1:20:10 EET [2021/05/16 18:20:10 ET]
Table 'VTPP NLHE 1605' 2-max (Play Money) Seat #1 is the button
Seat 1: s70n3fac3 (5473 in chips) 
Seat 2: FDIBA2009 (28772 in chips) 
s70n3fac3: posts small blind 50
FDIBA2009: posts big blind 100
*** HOLE CARDS ***
s70n3fac3: folds 
Uncalled bet (50) returned to FDIBA2009
FDIBA2009 collected 100 from pot
*** SUMMARY ***
Total pot 100 | Rake 0 
Seat 1: s70n3fac3 (button) (small blind) folded before Flop
Seat 2: FDIBA2009 (big blind) collected (100)



PokerStars Home Game Hand #226822165627: {Club #4781089}  Hold'em No Limit (50/100) - 2021/05/17 1:20:14 EET [2021/05/16 18:20:14 ET]
Table 'VTPP NLHE 1605' 2-max (Play Money) Seat #2 is the button
Seat 1: s70n3fac3 (5423 in chips) 
Seat 2: FDIBA2009 (28822 in chips) 
FDIBA2009: posts small blind 50
s70n3fac3: posts big blind 100
*** HOLE CARDS ***
FDIBA2009: raises 100 to 200
s70n3fac3: calls 100
*** FLOP *** [Ac Ts 4c]
s70n3fac3: checks 
FDIBA2009: bets 189
s70n3fac3: folds 
Uncalled bet (189) returned to FDIBA2009
FDIBA2009 collected 378 from pot
*** SUMMARY ***
Total pot 400 | Rake 22 
Board [Ac Ts 4c]
Seat 1: s70n3fac3 (big blind) folded on the Flop
Seat 2: FDIBA2009 (button) (small blind) collected (378)



PokerStars Home Game Hand #226822170305: {Club #4781089}  Hold'em No Limit (50/100) - 2021/05/17 1:20:24 EET [2021/05/16 18:20:24 ET]
Table 'VTPP NLHE 1605' 2-max (Play Money) Seat #1 is the button
Seat 1: s70n3fac3 (5223 in chips) 
Seat 2: FDIBA2009 (29000 in chips) 
s70n3fac3: posts small blind 50
FDIBA2009: posts big blind 100
*** HOLE CARDS ***
s70n3fac3: calls 50
FDIBA2009: checks 
*** FLOP *** [Qs 6c 4c]
FDIBA2009: checks 
s70n3fac3: bets 100
FDIBA2009: folds 
Uncalled bet (100) returned to s70n3fac3
s70n3fac3 collected 189 from pot
s70n3fac3: doesn't show hand 
*** SUMMARY ***
Total pot 200 | Rake 11 
Board [Qs 6c 4c]
Seat 1: s70n3fac3 (button) (small blind) collected (189)
Seat 2: FDIBA2009 (big blind) folded on the Flop



PokerStars Home Game Hand #226822175029: {Club #4781089}  Hold'em No Limit (50/100) - 2021/05/17 1:20:34 EET [2021/05/16 18:20:34 ET]
Table 'VTPP NLHE 1605' 2-max (Play Money) Seat #2 is the button
Seat 1: s70n3fac3 (5312 in chips) 
Seat 2: FDIBA2009 (28900 in chips) 
FDIBA2009: posts small blind 50
s70n3fac3: posts big blind 100
*** HOLE CARDS ***
FDIBA2009: raises 100 to 200
s70n3fac3: calls 100
*** FLOP *** [3d 5d Ac]
s70n3fac3: checks 
FDIBA2009: checks 
*** TURN *** [3d 5d Ac] [4s]
s70n3fac3: bets 200
FDIBA2009: calls 200
*** RIVER *** [3d 5d Ac 4s] [Jc]
s70n3fac3: bets 400
FDIBA2009: calls 400
*** SHOW DOWN ***
s70n3fac3: shows [5c 6d] (a pair of Fives)
FDIBA2009: shows [Ks Kd] (a pair of Kings)
FDIBA2009 collected 1512 from pot
*** SUMMARY ***
Total pot 1600 | Rake 88 
Board [3d 5d Ac 4s Jc]
Seat 1: s70n3fac3 (big blind) showed [5c 6d] and lost with a pair of Fives
Seat 2: FDIBA2009 (button) (small blind) showed [Ks Kd] and won (1512) with a pair of Kings



PokerStars Home Game Hand #226822183745: {Club #4781089}  Hold'em No Limit (50/100) - 2021/05/17 1:20:50 EET [2021/05/16 18:20:50 ET]
Table 'VTPP NLHE 1605' 2-max (Play Money) Seat #1 is the button
Seat 1: s70n3fac3 (4512 in chips) 
Seat 2: FDIBA2009 (29612 in chips) 
s70n3fac3: posts small blind 50
FDIBA2009: posts big blind 100
*** HOLE CARDS ***
s70n3fac3: folds 
Uncalled bet (50) returned to FDIBA2009
FDIBA2009 collected 100 from pot
*** SUMMARY ***
Total pot 100 | Rake 0 
Seat 1: s70n3fac3 (button) (small blind) folded before Flop
Seat 2: FDIBA2009 (big blind) collected (100)



PokerStars Home Game Hand #226822185614: {Club #4781089}  Hold'em No Limit (50/100) - 2021/05/17 1:20:54 EET [2021/05/16 18:20:54 ET]
Table 'VTPP NLHE 1605' 2-max (Play Money) Seat #2 is the button
Seat 1: s70n3fac3 (4462 in chips) 
Seat 2: FDIBA2009 (29662 in chips) 
FDIBA2009: posts small blind 50
s70n3fac3: posts big blind 100
*** HOLE CARDS ***
FDIBA2009: raises 100 to 200
s70n3fac3: folds 
Uncalled bet (100) returned to FDIBA2009
FDIBA2009 collected 200 from pot
*** SUMMARY ***
Total pot 200 | Rake 0 
Seat 1: s70n3fac3 (big blind) folded before Flop
Seat 2: FDIBA2009 (button) (small blind) collected (200)



PokerStars Home Game Hand #226822188331: {Club #4781089}  Hold'em No Limit (50/100) - 2021/05/17 1:21:00 EET [2021/05/16 18:21:00 ET]
Table 'VTPP NLHE 1605' 2-max (Play Money) Seat #1 is the button
Seat 1: s70n3fac3 (4362 in chips) 
Seat 2: FDIBA2009 (29762 in chips) 
s70n3fac3: posts small blind 50
FDIBA2009: posts big blind 100
*** HOLE CARDS ***
s70n3fac3: calls 50
FDIBA2009: checks 
*** FLOP *** [Qc 2h Ad]
FDIBA2009: checks 
s70n3fac3: checks 
*** TURN *** [Qc 2h Ad] [5h]
FDIBA2009: checks 
s70n3fac3: bets 100
FDIBA2009: folds 
Uncalled bet (100) returned to s70n3fac3
s70n3fac3 collected 189 from pot
s70n3fac3: doesn't show hand 
*** SUMMARY ***
Total pot 200 | Rake 11 
Board [Qc 2h Ad 5h]
Seat 1: s70n3fac3 (button) (small blind) collected (189)
Seat 2: FDIBA2009 (big blind) folded on the Turn



PokerStars Home Game Hand #226822193256: {Club #4781089}  Hold'em No Limit (50/100) - 2021/05/17 1:21:11 EET [2021/05/16 18:21:11 ET]
Table 'VTPP NLHE 1605' 2-max (Play Money) Seat #2 is the button
Seat 1: s70n3fac3 (4451 in chips) 
Seat 2: FDIBA2009 (29662 in chips) 
FDIBA2009: posts small blind 50
s70n3fac3: posts big blind 100
*** HOLE CARDS ***
FDIBA2009: raises 100 to 200
s70n3fac3: folds 
Uncalled bet (100) returned to FDIBA2009
FDIBA2009 collected 200 from pot
*** SUMMARY ***
Total pot 200 | Rake 0 
Seat 1: s70n3fac3 (big blind) folded before Flop
Seat 2: FDIBA2009 (button) (small blind) collected (200)



PokerStars Home Game Hand #226822195557: {Club #4781089}  Hold'em No Limit (50/100) - 2021/05/17 1:21:16 EET [2021/05/16 18:21:16 ET]
Table 'VTPP NLHE 1605' 2-max (Play Money) Seat #1 is the button
Seat 1: s70n3fac3 (4351 in chips) 
Seat 2: FDIBA2009 (29762 in chips) 
s70n3fac3: posts small blind 50
FDIBA2009: posts big blind 100
*** HOLE CARDS ***
s70n3fac3: folds 
Uncalled bet (50) returned to FDIBA2009
FDIBA2009 collected 100 from pot
*** SUMMARY ***
Total pot 100 | Rake 0 
Seat 1: s70n3fac3 (button) (small blind) folded before Flop
Seat 2: FDIBA2009 (big blind) collected (100)



PokerStars Home Game Hand #226822197178: {Club #4781089}  Hold'em No Limit (50/100) - 2021/05/17 1:21:20 EET [2021/05/16 18:21:20 ET]
Table 'VTPP NLHE 1605' 2-max (Play Money) Seat #2 is the button
Seat 1: s70n3fac3 (4301 in chips) 
Seat 2: FDIBA2009 (29812 in chips) 
FDIBA2009: posts small blind 50
s70n3fac3: posts big blind 100
*** HOLE CARDS ***
FDIBA2009: raises 100 to 200
s70n3fac3: calls 100
*** FLOP *** [6h Jh As]
s70n3fac3: checks 
FDIBA2009: checks 
*** TURN *** [6h Jh As] [Th]
s70n3fac3: checks 
FDIBA2009: bets 378
s70n3fac3: folds 
Uncalled bet (378) returned to FDIBA2009
FDIBA2009 collected 378 from pot
*** SUMMARY ***
Total pot 400 | Rake 22 
Board [6h Jh As Th]
Seat 1: s70n3fac3 (big blind) folded on the Turn
Seat 2: FDIBA2009 (button) (small blind) collected (378)



PokerStars Home Game Hand #226822204302: {Club #4781089}  Hold'em No Limit (50/100) - 2021/05/17 1:21:35 EET [2021/05/16 18:21:35 ET]
Table 'VTPP NLHE 1605' 2-max (Play Money) Seat #1 is the button
Seat 1: s70n3fac3 (4101 in chips) 
Seat 2: FDIBA2009 (29990 in chips) 
s70n3fac3: posts small blind 50
FDIBA2009: posts big blind 100
*** HOLE CARDS ***
s70n3fac3: calls 50
FDIBA2009: checks 
*** FLOP *** [7d Th Jh]
FDIBA2009: checks 
s70n3fac3: checks 
*** TURN *** [7d Th Jh] [7c]
FDIBA2009: checks 
s70n3fac3: checks 
*** RIVER *** [7d Th Jh 7c] [Td]
FDIBA2009: bets 189
s70n3fac3: folds 
Uncalled bet (189) returned to FDIBA2009
FDIBA2009 collected 189 from pot
*** SUMMARY ***
Total pot 200 | Rake 11 
Board [7d Th Jh 7c Td]
Seat 1: s70n3fac3 (button) (small blind) folded on the River
Seat 2: FDIBA2009 (big blind) collected (189)



PokerStars Home Game Hand #226822210939: {Club #4781089}  Hold'em No Limit (50/100) - 2021/05/17 1:21:49 EET [2021/05/16 18:21:49 ET]
Table 'VTPP NLHE 1605' 2-max (Play Money) Seat #2 is the button
Seat 1: s70n3fac3 (4001 in chips) 
Seat 2: FDIBA2009 (30079 in chips) 
FDIBA2009: posts small blind 50
s70n3fac3: posts big blind 100
*** HOLE CARDS ***
FDIBA2009: raises 100 to 200
s70n3fac3: folds 
Uncalled bet (100) returned to FDIBA2009
FDIBA2009 collected 200 from pot
*** SUMMARY ***
Total pot 200 | Rake 0 
Seat 1: s70n3fac3 (big blind) folded before Flop
Seat 2: FDIBA2009 (button) (small blind) collected (200)



PokerStars Home Game Hand #226822213233: {Club #4781089}  Hold'em No Limit (50/100) - 2021/05/17 1:21:54 EET [2021/05/16 18:21:54 ET]
Table 'VTPP NLHE 1605' 2-max (Play Money) Seat #1 is the button
Seat 1: s70n3fac3 (3901 in chips) 
Seat 2: FDIBA2009 (30179 in chips) 
s70n3fac3: posts small blind 50
FDIBA2009: posts big blind 100
*** HOLE CARDS ***
s70n3fac3: folds 
Uncalled bet (50) returned to FDIBA2009
FDIBA2009 collected 100 from pot
*** SUMMARY ***
Total pot 100 | Rake 0 
Seat 1: s70n3fac3 (button) (small blind) folded before Flop
Seat 2: FDIBA2009 (big blind) collected (100)



PokerStars Home Game Hand #226822215044: {Club #4781089}  Hold'em No Limit (50/100) - 2021/05/17 1:21:58 EET [2021/05/16 18:21:58 ET]
Table 'VTPP NLHE 1605' 2-max (Play Money) Seat #2 is the button
Seat 1: s70n3fac3 (3851 in chips) 
Seat 2: FDIBA2009 (30229 in chips) 
FDIBA2009: posts small blind 50
s70n3fac3: posts big blind 100
*** HOLE CARDS ***
FDIBA2009: raises 100 to 200
s70n3fac3: folds 
Uncalled bet (100) returned to FDIBA2009
FDIBA2009 collected 200 from pot
*** SUMMARY ***
Total pot 200 | Rake 0 
Seat 1: s70n3fac3 (big blind) folded before Flop
Seat 2: FDIBA2009 (button) (small blind) collected (200)



PokerStars Home Game Hand #226822218172: {Club #4781089}  Hold'em No Limit (50/100) - 2021/05/17 1:22:05 EET [2021/05/16 18:22:05 ET]
Table 'VTPP NLHE 1605' 2-max (Play Money) Seat #1 is the button
Seat 1: s70n3fac3 (3751 in chips) 
Seat 2: FDIBA2009 (30329 in chips) 
s70n3fac3: posts small blind 50
FDIBA2009: posts big blind 100
*** HOLE CARDS ***
s70n3fac3: folds 
Uncalled bet (50) returned to FDIBA2009
FDIBA2009 collected 100 from pot
*** SUMMARY ***
Total pot 100 | Rake 0 
Seat 1: s70n3fac3 (button) (small blind) folded before Flop
Seat 2: FDIBA2009 (big blind) collected (100)



PokerStars Home Game Hand #226822219963: {Club #4781089}  Hold'em No Limit (50/100) - 2021/05/17 1:22:09 EET [2021/05/16 18:22:09 ET]
Table 'VTPP NLHE 1605' 2-max (Play Money) Seat #2 is the button
Seat 1: s70n3fac3 (3701 in chips) 
Seat 2: FDIBA2009 (30379 in chips) 
FDIBA2009: posts small blind 50
s70n3fac3: posts big blind 100
*** HOLE CARDS ***
FDIBA2009: raises 100 to 200
s70n3fac3: calls 100
*** FLOP *** [7h 8d 2s]
s70n3fac3: checks 
FDIBA2009: checks 
*** TURN *** [7h 8d 2s] [Kc]
s70n3fac3: checks 
FDIBA2009: bets 189
s70n3fac3: raises 189 to 378
FDIBA2009: folds 
Uncalled bet (189) returned to s70n3fac3
s70n3fac3 collected 735 from pot
s70n3fac3: doesn't show hand 
*** SUMMARY ***
Total pot 778 | Rake 43 
Board [7h 8d 2s Kc]
Seat 1: s70n3fac3 (big blind) collected (735)
Seat 2: FDIBA2009 (button) (small blind) folded on the Turn



PokerStars Home Game Hand #226822226864: {Club #4781089}  Hold'em No Limit (50/100) - 2021/05/17 1:22:24 EET [2021/05/16 18:22:24 ET]
Table 'VTPP NLHE 1605' 2-max (Play Money) Seat #1 is the button
Seat 1: s70n3fac3 (4047 in chips) 
Seat 2: FDIBA2009 (29990 in chips) 
s70n3fac3: posts small blind 50
FDIBA2009: posts big blind 100
*** HOLE CARDS ***
s70n3fac3: folds 
Uncalled bet (50) returned to FDIBA2009
FDIBA2009 collected 100 from pot
*** SUMMARY ***
Total pot 100 | Rake 0 
Seat 1: s70n3fac3 (button) (small blind) folded before Flop
Seat 2: FDIBA2009 (big blind) collected (100)



PokerStars Home Game Hand #226822228588: {Club #4781089}  Hold'em No Limit (50/100) - 2021/05/17 1:22:28 EET [2021/05/16 18:22:28 ET]
Table 'VTPP NLHE 1605' 2-max (Play Money) Seat #2 is the button
Seat 1: s70n3fac3 (3997 in chips) 
Seat 2: FDIBA2009 (30040 in chips) 
FDIBA2009: posts small blind 50
s70n3fac3: posts big blind 100
*** HOLE CARDS ***
FDIBA2009: raises 100 to 200
s70n3fac3: calls 100
*** FLOP *** [5h 8d Th]
s70n3fac3: checks 
FDIBA2009: bets 189
s70n3fac3: calls 189
*** TURN *** [5h 8d Th] [6s]
s70n3fac3: checks 
FDIBA2009: bets 367
s70n3fac3: folds 
Uncalled bet (367) returned to FDIBA2009
FDIBA2009 collected 735 from pot
*** SUMMARY ***
Total pot 778 | Rake 43 
Board [5h 8d Th 6s]
Seat 1: s70n3fac3 (big blind) folded on the Turn
Seat 2: FDIBA2009 (button) (small blind) collected (735)



PokerStars Home Game Hand #226822236938: {Club #4781089}  Hold'em No Limit (50/100) - 2021/05/17 1:22:47 EET [2021/05/16 18:22:47 ET]
Table 'VTPP NLHE 1605' 2-max (Play Money) Seat #1 is the button
Seat 1: s70n3fac3 (3608 in chips) 
Seat 2: FDIBA2009 (30386 in chips) 
s70n3fac3: posts small blind 50
FDIBA2009: posts big blind 100
*** HOLE CARDS ***
s70n3fac3: calls 50
FDIBA2009: checks 
*** FLOP *** [4c Td 7h]
FDIBA2009: checks 
s70n3fac3: bets 100
FDIBA2009: calls 100
*** TURN *** [4c Td 7h] [4h]
FDIBA2009: checks 
s70n3fac3: bets 200
FDIBA2009: calls 200
*** RIVER *** [4c Td 7h 4h] [Tc]
FDIBA2009: checks 
s70n3fac3: checks 
*** SHOW DOWN ***
FDIBA2009: shows [6s 7d] (two pair, Tens and Sevens)
s70n3fac3: shows [8h 8s] (two pair, Tens and Eights)
s70n3fac3 collected 756 from pot
*** SUMMARY ***
Total pot 800 | Rake 44 
Board [4c Td 7h 4h Tc]
Seat 1: s70n3fac3 (button) (small blind) showed [8h 8s] and won (756) with two pair, Tens and Eights
Seat 2: FDIBA2009 (big blind) showed [6s 7d] and lost with two pair, Tens and Sevens



PokerStars Home Game Hand #226822245399: {Club #4781089}  Hold'em No Limit (50/100) - 2021/05/17 1:23:05 EET [2021/05/16 18:23:05 ET]
Table 'VTPP NLHE 1605' 2-max (Play Money) Seat #2 is the button
Seat 1: s70n3fac3 (3964 in chips) 
Seat 2: FDIBA2009 (29986 in chips) 
FDIBA2009: posts small blind 50
s70n3fac3: posts big blind 100
*** HOLE CARDS ***
FDIBA2009: raises 100 to 200
s70n3fac3: folds 
Uncalled bet (100) returned to FDIBA2009
FDIBA2009 collected 200 from pot
*** SUMMARY ***
Total pot 200 | Rake 0 
Seat 1: s70n3fac3 (big blind) folded before Flop
Seat 2: FDIBA2009 (button) (small blind) collected (200)



PokerStars Home Game Hand #226822251962: {Club #4781089}  Hold'em No Limit (50/100) - 2021/05/17 1:23:11 EET [2021/05/16 18:23:11 ET]
Table 'VTPP NLHE 1605' 2-max (Play Money) Seat #1 is the button
Seat 1: s70n3fac3 (3864 in chips) 
Seat 2: FDIBA2009 (30086 in chips) 
s70n3fac3: posts small blind 50
FDIBA2009: posts big blind 100
*** HOLE CARDS ***
s70n3fac3: calls 50
FDIBA2009: checks 
*** FLOP *** [Kh 3c 4s]
FDIBA2009: bets 100
s70n3fac3: calls 100
*** TURN *** [Kh 3c 4s] [7d]
FDIBA2009: bets 189
s70n3fac3: folds 
Uncalled bet (189) returned to FDIBA2009
FDIBA2009 collected 378 from pot
*** SUMMARY ***
Total pot 400 | Rake 22 
Board [Kh 3c 4s 7d]
Seat 1: s70n3fac3 (button) (small blind) folded on the Turn
Seat 2: FDIBA2009 (big blind) collected (378)



PokerStars Home Game Hand #226822258000: {Club #4781089}  Hold'em No Limit (50/100) - 2021/05/17 1:23:25 EET [2021/05/16 18:23:25 ET]
Table 'VTPP NLHE 1605' 2-max (Play Money) Seat #2 is the button
Seat 1: s70n3fac3 (3664 in chips) 
Seat 2: FDIBA2009 (30264 in chips) 
FDIBA2009: posts small blind 50
s70n3fac3: posts big blind 100
*** HOLE CARDS ***
FDIBA2009: raises 100 to 200
s70n3fac3: calls 100
*** FLOP *** [Td 7s 6d]
s70n3fac3: checks 
FDIBA2009: bets 189
s70n3fac3: calls 189
*** TURN *** [Td 7s 6d] [4h]
s70n3fac3: checks 
FDIBA2009: bets 367
s70n3fac3: calls 367
*** RIVER *** [Td 7s 6d 4h] [As]
s70n3fac3: checks 
FDIBA2009: bets 714
s70n3fac3: folds 
Uncalled bet (714) returned to FDIBA2009
FDIBA2009 collected 1429 from pot
*** SUMMARY ***
Total pot 1512 | Rake 83 
Board [Td 7s 6d 4h As]
Seat 1: s70n3fac3 (big blind) folded on the River
Seat 2: FDIBA2009 (button) (small blind) collected (1429)



PokerStars Home Game Hand #226822271356: {Club #4781089}  Hold'em No Limit (50/100) - 2021/05/17 1:23:54 EET [2021/05/16 18:23:54 ET]
Table 'VTPP NLHE 1605' 2-max (Play Money) Seat #1 is the button
Seat 1: s70n3fac3 (2908 in chips) 
Seat 2: FDIBA2009 (30937 in chips) 
s70n3fac3: posts small blind 50
FDIBA2009: posts big blind 100
*** HOLE CARDS ***
s70n3fac3: raises 100 to 200
FDIBA2009: calls 100
*** FLOP *** [7h 2s 3c]
FDIBA2009: checks 
s70n3fac3: checks 
*** TURN *** [7h 2s 3c] [2c]
FDIBA2009: bets 100
s70n3fac3: raises 200 to 300
FDIBA2009: folds 
Uncalled bet (200) returned to s70n3fac3
s70n3fac3 collected 567 from pot
s70n3fac3: doesn't show hand 
*** SUMMARY ***
Total pot 600 | Rake 33 
Board [7h 2s 3c 2c]
Seat 1: s70n3fac3 (button) (small blind) collected (567)
Seat 2: FDIBA2009 (big blind) folded on the Turn



PokerStars Home Game Hand #226822277566: {Club #4781089}  Hold'em No Limit (50/100) - 2021/05/17 1:24:08 EET [2021/05/16 18:24:08 ET]
Table 'VTPP NLHE 1605' 2-max (Play Money) Seat #2 is the button
Seat 1: s70n3fac3 (3175 in chips) 
Seat 2: FDIBA2009 (30637 in chips) 
FDIBA2009: posts small blind 50
s70n3fac3: posts big blind 100
*** HOLE CARDS ***
FDIBA2009: raises 100 to 200
s70n3fac3: raises 500 to 700
FDIBA2009: folds 
Uncalled bet (500) returned to s70n3fac3
s70n3fac3 collected 400 from pot
s70n3fac3: doesn't show hand 
*** SUMMARY ***
Total pot 400 | Rake 0 
Seat 1: s70n3fac3 (big blind) collected (400)
Seat 2: FDIBA2009 (button) (small blind) folded before Flop



PokerStars Home Game Hand #226822280751: {Club #4781089}  Hold'em No Limit (50/100) - 2021/05/17 1:24:15 EET [2021/05/16 18:24:15 ET]
Table 'VTPP NLHE 1605' 2-max (Play Money) Seat #1 is the button
Seat 1: s70n3fac3 (3375 in chips) 
Seat 2: FDIBA2009 (30437 in chips) 
s70n3fac3: posts small blind 50
FDIBA2009: posts big blind 100
*** HOLE CARDS ***
s70n3fac3: raises 100 to 200
FDIBA2009: folds 
Uncalled bet (100) returned to s70n3fac3
s70n3fac3 collected 200 from pot
s70n3fac3: doesn't show hand 
*** SUMMARY ***
Total pot 200 | Rake 0 
Seat 1: s70n3fac3 (button) (small blind) collected (200)
Seat 2: FDIBA2009 (big blind) folded before Flop



PokerStars Home Game Hand #226822282876: {Club #4781089}  Hold'em No Limit (50/100) - 2021/05/17 1:24:19 EET [2021/05/16 18:24:19 ET]
Table 'VTPP NLHE 1605' 2-max (Play Money) Seat #2 is the button
Seat 1: s70n3fac3 (3475 in chips) 
Seat 2: FDIBA2009 (30337 in chips) 
FDIBA2009: posts small blind 50
s70n3fac3: posts big blind 100
*** HOLE CARDS ***
FDIBA2009: raises 100 to 200
s70n3fac3: calls 100
*** FLOP *** [Ks 6s 7s]
s70n3fac3: checks 
FDIBA2009: checks 
*** TURN *** [Ks 6s 7s] [Jh]
s70n3fac3: checks 
FDIBA2009: checks 
*** RIVER *** [Ks 6s 7s Jh] [4d]
s70n3fac3: checks 
FDIBA2009: bets 100
s70n3fac3: calls 100
*** SHOW DOWN ***
FDIBA2009: shows [Td Tc] (a pair of Tens)
s70n3fac3: mucks hand 
FDIBA2009 collected 567 from pot
*** SUMMARY ***
Total pot 600 | Rake 33 
Board [Ks 6s 7s Jh 4d]
Seat 1: s70n3fac3 (big blind) mucked [Qh 4h]
Seat 2: FDIBA2009 (button) (small blind) showed [Td Tc] and won (567) with a pair of Tens



PokerStars Home Game Hand #226822288837: {Club #4781089}  Hold'em No Limit (50/100) - 2021/05/17 1:24:33 EET [2021/05/16 18:24:33 ET]
Table 'VTPP NLHE 1605' 2-max (Play Money) Seat #1 is the button
Seat 1: s70n3fac3 (3175 in chips) 
Seat 2: FDIBA2009 (30604 in chips) 
s70n3fac3: posts small blind 50
FDIBA2009: posts big blind 100
*** HOLE CARDS ***
s70n3fac3: calls 50
FDIBA2009: checks 
*** FLOP *** [2c 9h 7h]
FDIBA2009: bets 189
s70n3fac3: folds 
Uncalled bet (189) returned to FDIBA2009
FDIBA2009 collected 189 from pot
*** SUMMARY ***
Total pot 200 | Rake 11 
Board [2c 9h 7h]
Seat 1: s70n3fac3 (button) (small blind) folded on the Flop
Seat 2: FDIBA2009 (big blind) collected (189)



PokerStars Home Game Hand #226822292874: {Club #4781089}  Hold'em No Limit (50/100) - 2021/05/17 1:24:42 EET [2021/05/16 18:24:42 ET]
Table 'VTPP NLHE 1605' 2-max (Play Money) Seat #2 is the button
Seat 1: s70n3fac3 (3075 in chips) 
Seat 2: FDIBA2009 (30693 in chips) 
FDIBA2009: posts small blind 50
s70n3fac3: posts big blind 100
*** HOLE CARDS ***
FDIBA2009: raises 100 to 200
s70n3fac3: calls 100
*** FLOP *** [Td Jc 7h]
s70n3fac3: checks 
FDIBA2009: checks 
*** TURN *** [Td Jc 7h] [4h]
s70n3fac3: bets 100
FDIBA2009: folds 
Uncalled bet (100) returned to s70n3fac3
s70n3fac3 collected 378 from pot
s70n3fac3: doesn't show hand 
*** SUMMARY ***
Total pot 400 | Rake 22 
Board [Td Jc 7h 4h]
Seat 1: s70n3fac3 (big blind) collected (378)
Seat 2: FDIBA2009 (button) (small blind) folded on the Turn



PokerStars Home Game Hand #226822297457: {Club #4781089}  Hold'em No Limit (50/100) - 2021/05/17 1:24:52 EET [2021/05/16 18:24:52 ET]
Table 'VTPP NLHE 1605' 2-max (Play Money) Seat #1 is the button
Seat 1: s70n3fac3 (3253 in chips) 
Seat 2: FDIBA2009 (30493 in chips) 
s70n3fac3: posts small blind 50
FDIBA2009: posts big blind 100
*** HOLE CARDS ***
s70n3fac3: calls 50
FDIBA2009: raises 100 to 200
s70n3fac3: raises 600 to 800
FDIBA2009: calls 600
*** FLOP *** [Jd 2d Kc]
FDIBA2009: checks 
s70n3fac3: checks 
*** TURN *** [Jd 2d Kc] [2h]
FDIBA2009: checks 
s70n3fac3: bets 600
FDIBA2009: raises 600 to 1200
s70n3fac3: calls 600
*** RIVER *** [Jd 2d Kc 2h] [5h]
FDIBA2009: bets 1890
s70n3fac3: calls 1253 and is all-in
Uncalled bet (637) returned to FDIBA2009
*** SHOW DOWN ***
FDIBA2009: shows [Kh Jh] (two pair, Kings and Jacks)
s70n3fac3: shows [Kd Ad] (two pair, Kings and Deuces)
FDIBA2009 collected 6148 from pot
*** SUMMARY ***
Total pot 6506 | Rake 358 
Board [Jd 2d Kc 2h 5h]
Seat 1: s70n3fac3 (button) (small blind) showed [Kd Ad] and lost with two pair, Kings and Deuces
Seat 2: FDIBA2009 (big blind) showed [Kh Jh] and won (6148) with two pair, Kings and Jacks



