PokerStars Home Game Hand #227140264275: {Club #4781089}  Hold'em No Limit (50/100) - 2021/05/28 22:45:37 EET [2021/05/28 15:45:37 ET]
Table 'VTPP NLHE 2805' 2-max (Play Money) Seat #2 is the button
Seat 1: s70n3fac3 (10000 in chips) 
Seat 2: FDIBA2009 (10000 in chips) 
FDIBA2009: posts small blind 50
s70n3fac3: posts big blind 100
*** HOLE CARDS ***
FDIBA2009: raises 100 to 200
s70n3fac3: folds 
Uncalled bet (100) returned to FDIBA2009
FDIBA2009 collected 200 from pot
FDIBA2009: doesn't show hand 
*** SUMMARY ***
Total pot 200 | Rake 0 
Seat 1: s70n3fac3 (big blind) folded before Flop
Seat 2: FDIBA2009 (button) (small blind) collected (200)



PokerStars Home Game Hand #227140269370: {Club #4781089}  Hold'em No Limit (50/100) - 2021/05/28 22:45:47 EET [2021/05/28 15:45:47 ET]
Table 'VTPP NLHE 2805' 2-max (Play Money) Seat #1 is the button
Seat 1: s70n3fac3 (9900 in chips) 
Seat 2: FDIBA2009 (10100 in chips) 
s70n3fac3: posts small blind 50
FDIBA2009: posts big blind 100
*** HOLE CARDS ***
s70n3fac3: raises 150 to 250
FDIBA2009: calls 150
*** FLOP *** [Ah 6d Td]
FDIBA2009: checks 
s70n3fac3: bets 250
FDIBA2009: calls 250
*** TURN *** [Ah 6d Td] [3h]
FDIBA2009: checks 
s70n3fac3: bets 550
FDIBA2009: calls 550
*** RIVER *** [Ah 6d Td 3h] [Js]
FDIBA2009: bets 1800
s70n3fac3: calls 1800
*** SHOW DOWN ***
FDIBA2009: shows [5d 9d] (high card Ace)
s70n3fac3: shows [7s Ac] (a pair of Aces)
s70n3fac3 collected 5386 from pot
*** SUMMARY ***
Total pot 5700 | Rake 314 
Board [Ah 6d Td 3h Js]
Seat 1: s70n3fac3 (button) (small blind) showed [7s Ac] and won (5386) with a pair of Aces
Seat 2: FDIBA2009 (big blind) showed [5d 9d] and lost with high card Ace



PokerStars Home Game Hand #227140300981: {Club #4781089}  Hold'em No Limit (50/100) - 2021/05/28 22:46:46 EET [2021/05/28 15:46:46 ET]
Table 'VTPP NLHE 2805' 2-max (Play Money) Seat #2 is the button
Seat 1: s70n3fac3 (12436 in chips) 
Seat 2: FDIBA2009 (7250 in chips) 
FDIBA2009: posts small blind 50
s70n3fac3: posts big blind 100
*** HOLE CARDS ***
FDIBA2009: raises 100 to 200
s70n3fac3: calls 100
*** FLOP *** [Ad 9d 3s]
s70n3fac3: checks 
FDIBA2009: bets 189
s70n3fac3: calls 189
*** TURN *** [Ad 9d 3s] [4s]
s70n3fac3: checks 
FDIBA2009: bets 600
s70n3fac3: folds 
Uncalled bet (600) returned to FDIBA2009
FDIBA2009 collected 735 from pot
FDIBA2009: doesn't show hand 
*** SUMMARY ***
Total pot 778 | Rake 43 
Board [Ad 9d 3s 4s]
Seat 1: s70n3fac3 (big blind) folded on the Turn
Seat 2: FDIBA2009 (button) (small blind) collected (735)



PokerStars Home Game Hand #227140320300: {Club #4781089}  Hold'em No Limit (50/100) - 2021/05/28 22:47:23 EET [2021/05/28 15:47:23 ET]
Table 'VTPP NLHE 2805' 2-max (Play Money) Seat #1 is the button
Seat 1: s70n3fac3 (12047 in chips) 
Seat 2: FDIBA2009 (7596 in chips) 
s70n3fac3: posts small blind 50
FDIBA2009: posts big blind 100
*** HOLE CARDS ***
s70n3fac3: folds 
Uncalled bet (50) returned to FDIBA2009
FDIBA2009 collected 100 from pot
FDIBA2009: doesn't show hand 
*** SUMMARY ***
Total pot 100 | Rake 0 
Seat 1: s70n3fac3 (button) (small blind) folded before Flop
Seat 2: FDIBA2009 (big blind) collected (100)



PokerStars Home Game Hand #227140322801: {Club #4781089}  Hold'em No Limit (50/100) - 2021/05/28 22:47:27 EET [2021/05/28 15:47:27 ET]
Table 'VTPP NLHE 2805' 2-max (Play Money) Seat #2 is the button
Seat 1: s70n3fac3 (11997 in chips) 
Seat 2: FDIBA2009 (7646 in chips) 
FDIBA2009: posts small blind 50
s70n3fac3: posts big blind 100
*** HOLE CARDS ***
FDIBA2009: raises 100 to 200
s70n3fac3: raises 450 to 650
FDIBA2009: folds 
Uncalled bet (450) returned to s70n3fac3
s70n3fac3 collected 400 from pot
s70n3fac3: doesn't show hand 
*** SUMMARY ***
Total pot 400 | Rake 0 
Seat 1: s70n3fac3 (big blind) collected (400)
Seat 2: FDIBA2009 (button) (small blind) folded before Flop



PokerStars Home Game Hand #227140330492: {Club #4781089}  Hold'em No Limit (50/100) - 2021/05/28 22:47:42 EET [2021/05/28 15:47:42 ET]
Table 'VTPP NLHE 2805' 2-max (Play Money) Seat #1 is the button
Seat 1: s70n3fac3 (12197 in chips) 
Seat 2: FDIBA2009 (7446 in chips) 
s70n3fac3: posts small blind 50
FDIBA2009: posts big blind 100
*** HOLE CARDS ***
s70n3fac3: folds 
Uncalled bet (50) returned to FDIBA2009
FDIBA2009 collected 100 from pot
FDIBA2009: doesn't show hand 
*** SUMMARY ***
Total pot 100 | Rake 0 
Seat 1: s70n3fac3 (button) (small blind) folded before Flop
Seat 2: FDIBA2009 (big blind) collected (100)



PokerStars Home Game Hand #227140333527: {Club #4781089}  Hold'em No Limit (50/100) - 2021/05/28 22:47:48 EET [2021/05/28 15:47:48 ET]
Table 'VTPP NLHE 2805' 2-max (Play Money) Seat #2 is the button
Seat 1: s70n3fac3 (12147 in chips) 
Seat 2: FDIBA2009 (7496 in chips) 
FDIBA2009: posts small blind 50
s70n3fac3: posts big blind 100
*** HOLE CARDS ***
FDIBA2009: raises 100 to 200
s70n3fac3: calls 100
*** FLOP *** [9d 6h 7h]
s70n3fac3: checks 
FDIBA2009: bets 189
s70n3fac3: calls 189
*** TURN *** [9d 6h 7h] [3c]
s70n3fac3: checks 
FDIBA2009: bets 400
s70n3fac3: calls 400
*** RIVER *** [9d 6h 7h 3c] [Jh]
s70n3fac3: checks 
FDIBA2009: checks 
*** SHOW DOWN ***
s70n3fac3: shows [Jc Td] (a pair of Jacks)
FDIBA2009: mucks hand 
s70n3fac3 collected 1491 from pot
*** SUMMARY ***
Total pot 1578 | Rake 87 
Board [9d 6h 7h 3c Jh]
Seat 1: s70n3fac3 (big blind) showed [Jc Td] and won (1491) with a pair of Jacks
Seat 2: FDIBA2009 (button) (small blind) mucked [8s 2d]



PokerStars Home Game Hand #227140354917: {Club #4781089}  Hold'em No Limit (50/100) - 2021/05/28 22:48:28 EET [2021/05/28 15:48:28 ET]
Table 'VTPP NLHE 2805' 2-max (Play Money) Seat #1 is the button
Seat 1: s70n3fac3 (12849 in chips) 
Seat 2: FDIBA2009 (6707 in chips) 
s70n3fac3: posts small blind 50
FDIBA2009: posts big blind 100
*** HOLE CARDS ***
s70n3fac3: raises 150 to 250
FDIBA2009: folds 
Uncalled bet (150) returned to s70n3fac3
s70n3fac3 collected 200 from pot
s70n3fac3: doesn't show hand 
*** SUMMARY ***
Total pot 200 | Rake 0 
Seat 1: s70n3fac3 (button) (small blind) collected (200)
Seat 2: FDIBA2009 (big blind) folded before Flop



PokerStars Home Game Hand #227140360458: {Club #4781089}  Hold'em No Limit (50/100) - 2021/05/28 22:48:39 EET [2021/05/28 15:48:39 ET]
Table 'VTPP NLHE 2805' 2-max (Play Money) Seat #2 is the button
Seat 1: s70n3fac3 (12949 in chips) 
Seat 2: FDIBA2009 (6607 in chips) 
FDIBA2009: posts small blind 50
s70n3fac3: posts big blind 100
*** HOLE CARDS ***
FDIBA2009: folds 
Uncalled bet (50) returned to s70n3fac3
s70n3fac3 collected 100 from pot
s70n3fac3: doesn't show hand 
*** SUMMARY ***
Total pot 100 | Rake 0 
Seat 1: s70n3fac3 (big blind) collected (100)
Seat 2: FDIBA2009 (button) (small blind) folded before Flop



PokerStars Home Game Hand #227140363114: {Club #4781089}  Hold'em No Limit (50/100) - 2021/05/28 22:48:44 EET [2021/05/28 15:48:44 ET]
Table 'VTPP NLHE 2805' 2-max (Play Money) Seat #1 is the button
Seat 1: s70n3fac3 (12999 in chips) 
Seat 2: FDIBA2009 (6557 in chips) 
s70n3fac3: posts small blind 50
FDIBA2009: posts big blind 100
*** HOLE CARDS ***
s70n3fac3: folds 
Uncalled bet (50) returned to FDIBA2009
FDIBA2009 collected 100 from pot
FDIBA2009: doesn't show hand 
*** SUMMARY ***
Total pot 100 | Rake 0 
Seat 1: s70n3fac3 (button) (small blind) folded before Flop
Seat 2: FDIBA2009 (big blind) collected (100)



PokerStars Home Game Hand #227140365524: {Club #4781089}  Hold'em No Limit (50/100) - 2021/05/28 22:48:48 EET [2021/05/28 15:48:48 ET]
Table 'VTPP NLHE 2805' 2-max (Play Money) Seat #2 is the button
Seat 1: s70n3fac3 (12949 in chips) 
Seat 2: FDIBA2009 (6607 in chips) 
FDIBA2009: posts small blind 50
s70n3fac3: posts big blind 100
*** HOLE CARDS ***
FDIBA2009: raises 100 to 200
s70n3fac3: calls 100
*** FLOP *** [5d 9d 3c]
s70n3fac3: checks 
FDIBA2009: bets 200
s70n3fac3: calls 200
*** TURN *** [5d 9d 3c] [6c]
s70n3fac3: checks 
FDIBA2009: bets 450
s70n3fac3: calls 450
*** RIVER *** [5d 9d 3c 6c] [Qc]
s70n3fac3: checks 
FDIBA2009: bets 1650
s70n3fac3: folds 
Uncalled bet (1650) returned to FDIBA2009
FDIBA2009 collected 1606 from pot
FDIBA2009: doesn't show hand 
*** SUMMARY ***
Total pot 1700 | Rake 94 
Board [5d 9d 3c 6c Qc]
Seat 1: s70n3fac3 (big blind) folded on the River
Seat 2: FDIBA2009 (button) (small blind) collected (1606)



PokerStars Home Game Hand #227140399945: {Club #4781089}  Hold'em No Limit (50/100) - 2021/05/28 22:49:53 EET [2021/05/28 15:49:53 ET]
Table 'VTPP NLHE 2805' 2-max (Play Money) Seat #1 is the button
Seat 1: s70n3fac3 (12099 in chips) 
Seat 2: FDIBA2009 (7363 in chips) 
s70n3fac3: posts small blind 50
FDIBA2009: posts big blind 100
*** HOLE CARDS ***
s70n3fac3: raises 150 to 250
FDIBA2009: folds 
Uncalled bet (150) returned to s70n3fac3
s70n3fac3 collected 200 from pot
s70n3fac3: doesn't show hand 
*** SUMMARY ***
Total pot 200 | Rake 0 
Seat 1: s70n3fac3 (button) (small blind) collected (200)
Seat 2: FDIBA2009 (big blind) folded before Flop



PokerStars Home Game Hand #227140403965: {Club #4781089}  Hold'em No Limit (50/100) - 2021/05/28 22:50:01 EET [2021/05/28 15:50:01 ET]
Table 'VTPP NLHE 2805' 2-max (Play Money) Seat #2 is the button
Seat 1: s70n3fac3 (12199 in chips) 
Seat 2: FDIBA2009 (7263 in chips) 
FDIBA2009: posts small blind 50
s70n3fac3: posts big blind 100
*** HOLE CARDS ***
FDIBA2009: raises 100 to 200
s70n3fac3: calls 100
*** FLOP *** [9s Kd 5d]
s70n3fac3: bets 200
FDIBA2009: calls 200
*** TURN *** [9s Kd 5d] [5h]
s70n3fac3: checks 
FDIBA2009: checks 
*** RIVER *** [9s Kd 5d 5h] [As]
s70n3fac3: bets 400
FDIBA2009: raises 500 to 900
s70n3fac3: folds 
Uncalled bet (500) returned to FDIBA2009
FDIBA2009 collected 1512 from pot
FDIBA2009: doesn't show hand 
*** SUMMARY ***
Total pot 1600 | Rake 88 
Board [9s Kd 5d 5h As]
Seat 1: s70n3fac3 (big blind) folded on the River
Seat 2: FDIBA2009 (button) (small blind) collected (1512)



PokerStars Home Game Hand #227140434125: {Club #4781089}  Hold'em No Limit (50/100) - 2021/05/28 22:50:47 EET [2021/05/28 15:50:47 ET]
Table 'VTPP NLHE 2805' 2-max (Play Money) Seat #1 is the button
Seat 1: s70n3fac3 (11399 in chips) 
Seat 2: FDIBA2009 (7975 in chips) 
s70n3fac3: posts small blind 50
FDIBA2009: posts big blind 100
*** HOLE CARDS ***
s70n3fac3: raises 150 to 250
FDIBA2009: folds 
Uncalled bet (150) returned to s70n3fac3
s70n3fac3 collected 200 from pot
s70n3fac3: doesn't show hand 
*** SUMMARY ***
Total pot 200 | Rake 0 
Seat 1: s70n3fac3 (button) (small blind) collected (200)
Seat 2: FDIBA2009 (big blind) folded before Flop



PokerStars Home Game Hand #227140437434: {Club #4781089}  Hold'em No Limit (50/100) - 2021/05/28 22:50:54 EET [2021/05/28 15:50:54 ET]
Table 'VTPP NLHE 2805' 2-max (Play Money) Seat #2 is the button
Seat 1: s70n3fac3 (11499 in chips) 
Seat 2: FDIBA2009 (7875 in chips) 
FDIBA2009: posts small blind 50
s70n3fac3: posts big blind 100
*** HOLE CARDS ***
FDIBA2009: raises 100 to 200
s70n3fac3: calls 100
*** FLOP *** [3c 4d 7h]
s70n3fac3: checks 
FDIBA2009: checks 
*** TURN *** [3c 4d 7h] [Kd]
s70n3fac3: bets 200
FDIBA2009: calls 200
*** RIVER *** [3c 4d 7h Kd] [7c]
s70n3fac3: bets 550
FDIBA2009: calls 550
*** SHOW DOWN ***
s70n3fac3: shows [7s Td] (three of a kind, Sevens)
FDIBA2009: mucks hand 
s70n3fac3 collected 1795 from pot
*** SUMMARY ***
Total pot 1900 | Rake 105 
Board [3c 4d 7h Kd 7c]
Seat 1: s70n3fac3 (big blind) showed [7s Td] and won (1795) with three of a kind, Sevens
Seat 2: FDIBA2009 (button) (small blind) mucked [Kc 5h]



PokerStars Home Game Hand #227140452926: {Club #4781089}  Hold'em No Limit (50/100) - 2021/05/28 22:51:23 EET [2021/05/28 15:51:23 ET]
Table 'VTPP NLHE 2805' 2-max (Play Money) Seat #1 is the button
Seat 1: s70n3fac3 (12344 in chips) 
Seat 2: FDIBA2009 (6925 in chips) 
s70n3fac3: posts small blind 50
FDIBA2009: posts big blind 100
*** HOLE CARDS ***
s70n3fac3: folds 
Uncalled bet (50) returned to FDIBA2009
FDIBA2009 collected 100 from pot
FDIBA2009: doesn't show hand 
*** SUMMARY ***
Total pot 100 | Rake 0 
Seat 1: s70n3fac3 (button) (small blind) folded before Flop
Seat 2: FDIBA2009 (big blind) collected (100)



PokerStars Home Game Hand #227140456453: {Club #4781089}  Hold'em No Limit (50/100) - 2021/05/28 22:51:30 EET [2021/05/28 15:51:30 ET]
Table 'VTPP NLHE 2805' 2-max (Play Money) Seat #2 is the button
Seat 1: s70n3fac3 (12294 in chips) 
Seat 2: FDIBA2009 (6975 in chips) 
FDIBA2009: posts small blind 50
s70n3fac3: posts big blind 100
*** HOLE CARDS ***
FDIBA2009: raises 100 to 200
s70n3fac3: calls 100
*** FLOP *** [9c 6h 6d]
s70n3fac3: checks 
FDIBA2009: bets 200
s70n3fac3: calls 200
*** TURN *** [9c 6h 6d] [Jc]
s70n3fac3: checks 
FDIBA2009: bets 400
s70n3fac3: calls 400
*** RIVER *** [9c 6h 6d Jc] [4s]
s70n3fac3: checks 
FDIBA2009: checks 
*** SHOW DOWN ***
s70n3fac3: shows [6s Kd] (three of a kind, Sixes)
FDIBA2009: mucks hand 
s70n3fac3 collected 1512 from pot
*** SUMMARY ***
Total pot 1600 | Rake 88 
Board [9c 6h 6d Jc 4s]
Seat 1: s70n3fac3 (big blind) showed [6s Kd] and won (1512) with three of a kind, Sixes
Seat 2: FDIBA2009 (button) (small blind) mucked [Jh Kc]



PokerStars Home Game Hand #227140487236: {Club #4781089}  Hold'em No Limit (50/100) - 2021/05/28 22:52:28 EET [2021/05/28 15:52:28 ET]
Table 'VTPP NLHE 2805' 2-max (Play Money) Seat #1 is the button
Seat 1: s70n3fac3 (13006 in chips) 
Seat 2: FDIBA2009 (6175 in chips) 
s70n3fac3: posts small blind 50
FDIBA2009: posts big blind 100
*** HOLE CARDS ***
s70n3fac3: raises 100 to 200
FDIBA2009: raises 400 to 600
s70n3fac3: folds 
Uncalled bet (400) returned to FDIBA2009
FDIBA2009 collected 400 from pot
FDIBA2009: doesn't show hand 
*** SUMMARY ***
Total pot 400 | Rake 0 
Seat 1: s70n3fac3 (button) (small blind) folded before Flop
Seat 2: FDIBA2009 (big blind) collected (400)



PokerStars Home Game Hand #227140498205: {Club #4781089}  Hold'em No Limit (50/100) - 2021/05/28 22:52:49 EET [2021/05/28 15:52:49 ET]
Table 'VTPP NLHE 2805' 2-max (Play Money) Seat #2 is the button
Seat 1: s70n3fac3 (12806 in chips) 
Seat 2: FDIBA2009 (6375 in chips) 
FDIBA2009: posts small blind 50
s70n3fac3: posts big blind 100
*** HOLE CARDS ***
FDIBA2009: raises 100 to 200
s70n3fac3: calls 100
*** FLOP *** [Ks 4c Ts]
s70n3fac3: checks 
FDIBA2009: bets 200
s70n3fac3: calls 200
*** TURN *** [Ks 4c Ts] [7d]
s70n3fac3: bets 400
FDIBA2009: calls 400
*** RIVER *** [Ks 4c Ts 7d] [As]
s70n3fac3: bets 950
FDIBA2009: folds 
Uncalled bet (950) returned to s70n3fac3
s70n3fac3 collected 1512 from pot
s70n3fac3: doesn't show hand 
*** SUMMARY ***
Total pot 1600 | Rake 88 
Board [Ks 4c Ts 7d As]
Seat 1: s70n3fac3 (big blind) collected (1512)
Seat 2: FDIBA2009 (button) (small blind) folded on the River



PokerStars Home Game Hand #227140525331: {Club #4781089}  Hold'em No Limit (50/100) - 2021/05/28 22:53:41 EET [2021/05/28 15:53:41 ET]
Table 'VTPP NLHE 2805' 2-max (Play Money) Seat #1 is the button
Seat 1: s70n3fac3 (13518 in chips) 
Seat 2: FDIBA2009 (5575 in chips) 
s70n3fac3: posts small blind 50
FDIBA2009: posts big blind 100
*** HOLE CARDS ***
s70n3fac3: folds 
Uncalled bet (50) returned to FDIBA2009
FDIBA2009 collected 100 from pot
FDIBA2009: doesn't show hand 
*** SUMMARY ***
Total pot 100 | Rake 0 
Seat 1: s70n3fac3 (button) (small blind) folded before Flop
Seat 2: FDIBA2009 (big blind) collected (100)



PokerStars Home Game Hand #227140527673: {Club #4781089}  Hold'em No Limit (50/100) - 2021/05/28 22:53:45 EET [2021/05/28 15:53:45 ET]
Table 'VTPP NLHE 2805' 2-max (Play Money) Seat #2 is the button
Seat 1: s70n3fac3 (13468 in chips) 
Seat 2: FDIBA2009 (5625 in chips) 
FDIBA2009: posts small blind 50
s70n3fac3: posts big blind 100
*** HOLE CARDS ***
FDIBA2009: raises 100 to 200
s70n3fac3: calls 100
*** FLOP *** [9c Js Kd]
s70n3fac3: checks 
FDIBA2009: bets 200
s70n3fac3: folds 
Uncalled bet (200) returned to FDIBA2009
FDIBA2009 collected 378 from pot
FDIBA2009: doesn't show hand 
*** SUMMARY ***
Total pot 400 | Rake 22 
Board [9c Js Kd]
Seat 1: s70n3fac3 (big blind) folded on the Flop
Seat 2: FDIBA2009 (button) (small blind) collected (378)



PokerStars Home Game Hand #227140538312: {Club #4781089}  Hold'em No Limit (50/100) - 2021/05/28 22:54:06 EET [2021/05/28 15:54:06 ET]
Table 'VTPP NLHE 2805' 2-max (Play Money) Seat #1 is the button
Seat 1: s70n3fac3 (13268 in chips) 
Seat 2: FDIBA2009 (5803 in chips) 
s70n3fac3: posts small blind 50
FDIBA2009: posts big blind 100
*** HOLE CARDS ***
s70n3fac3: raises 150 to 250
FDIBA2009: calls 150
*** FLOP *** [9c 7d 9h]
FDIBA2009: checks 
s70n3fac3: bets 260
FDIBA2009: calls 260
*** TURN *** [9c 7d 9h] [Td]
FDIBA2009: checks 
s70n3fac3: bets 495
FDIBA2009: folds 
Uncalled bet (495) returned to s70n3fac3
s70n3fac3 collected 964 from pot
s70n3fac3: doesn't show hand 
*** SUMMARY ***
Total pot 1020 | Rake 56 
Board [9c 7d 9h Td]
Seat 1: s70n3fac3 (button) (small blind) collected (964)
Seat 2: FDIBA2009 (big blind) folded on the Turn



PokerStars Home Game Hand #227140558391: {Club #4781089}  Hold'em No Limit (50/100) - 2021/05/28 22:54:44 EET [2021/05/28 15:54:44 ET]
Table 'VTPP NLHE 2805' 2-max (Play Money) Seat #2 is the button
Seat 1: s70n3fac3 (13722 in chips) 
Seat 2: FDIBA2009 (5293 in chips) 
FDIBA2009: posts small blind 50
s70n3fac3: posts big blind 100
*** HOLE CARDS ***
FDIBA2009: raises 100 to 200
s70n3fac3: folds 
Uncalled bet (100) returned to FDIBA2009
FDIBA2009 collected 200 from pot
FDIBA2009: doesn't show hand 
*** SUMMARY ***
Total pot 200 | Rake 0 
Seat 1: s70n3fac3 (big blind) folded before Flop
Seat 2: FDIBA2009 (button) (small blind) collected (200)



PokerStars Home Game Hand #227140562897: {Club #4781089}  Hold'em No Limit (50/100) - 2021/05/28 22:54:53 EET [2021/05/28 15:54:53 ET]
Table 'VTPP NLHE 2805' 2-max (Play Money) Seat #1 is the button
Seat 1: s70n3fac3 (13622 in chips) 
Seat 2: FDIBA2009 (5393 in chips) 
s70n3fac3: posts small blind 50
FDIBA2009: posts big blind 100
*** HOLE CARDS ***
s70n3fac3: raises 150 to 250
FDIBA2009: calls 150
*** FLOP *** [9h 7c 4d]
FDIBA2009: checks 
s70n3fac3: bets 255
FDIBA2009: calls 255
*** TURN *** [9h 7c 4d] [4c]
FDIBA2009: checks 
s70n3fac3: checks 
*** RIVER *** [9h 7c 4d 4c] [3s]
FDIBA2009: bets 650
s70n3fac3: folds 
Uncalled bet (650) returned to FDIBA2009
FDIBA2009 collected 954 from pot
FDIBA2009: doesn't show hand 
*** SUMMARY ***
Total pot 1010 | Rake 56 
Board [9h 7c 4d 4c 3s]
Seat 1: s70n3fac3 (button) (small blind) folded on the River
Seat 2: FDIBA2009 (big blind) collected (954)



PokerStars Home Game Hand #227140585449: {Club #4781089}  Hold'em No Limit (50/100) - 2021/05/28 22:55:45 EET [2021/05/28 15:55:45 ET]
Table 'VTPP NLHE 2805' 2-max (Play Money) Seat #2 is the button
Seat 1: s70n3fac3 (13117 in chips) 
Seat 2: FDIBA2009 (5842 in chips) 
FDIBA2009: posts small blind 50
s70n3fac3: posts big blind 100
*** HOLE CARDS ***
FDIBA2009: raises 100 to 200
s70n3fac3: folds 
Uncalled bet (100) returned to FDIBA2009
FDIBA2009 collected 200 from pot
FDIBA2009: doesn't show hand 
*** SUMMARY ***
Total pot 200 | Rake 0 
Seat 1: s70n3fac3 (big blind) folded before Flop
Seat 2: FDIBA2009 (button) (small blind) collected (200)



PokerStars Home Game Hand #227140588354: {Club #4781089}  Hold'em No Limit (50/100) - 2021/05/28 22:55:53 EET [2021/05/28 15:55:53 ET]
Table 'VTPP NLHE 2805' 2-max (Play Money) Seat #1 is the button
Seat 1: s70n3fac3 (13017 in chips) 
Seat 2: FDIBA2009 (5942 in chips) 
s70n3fac3: posts small blind 50
FDIBA2009: posts big blind 100
*** HOLE CARDS ***
s70n3fac3: raises 150 to 250
FDIBA2009: raises 400 to 650
s70n3fac3: calls 400
*** FLOP *** [Jc 4h 5h]
FDIBA2009: bets 850
s70n3fac3: folds 
Uncalled bet (850) returned to FDIBA2009
FDIBA2009 collected 1228 from pot
FDIBA2009: doesn't show hand 
*** SUMMARY ***
Total pot 1300 | Rake 72 
Board [Jc 4h 5h]
Seat 1: s70n3fac3 (button) (small blind) folded on the Flop
Seat 2: FDIBA2009 (big blind) collected (1228)



PokerStars Home Game Hand #227140600424: {Club #4781089}  Hold'em No Limit (50/100) - 2021/05/28 22:56:25 EET [2021/05/28 15:56:25 ET]
Table 'VTPP NLHE 2805' 2-max (Play Money) Seat #2 is the button
Seat 1: s70n3fac3 (12367 in chips) 
Seat 2: FDIBA2009 (6520 in chips) 
FDIBA2009: posts small blind 50
s70n3fac3: posts big blind 100
*** HOLE CARDS ***
FDIBA2009: raises 100 to 200
s70n3fac3: calls 100
*** FLOP *** [9c Ah Kh]
s70n3fac3: checks 
FDIBA2009: checks 
*** TURN *** [9c Ah Kh] [3c]
s70n3fac3: checks 
FDIBA2009: bets 300
s70n3fac3: calls 300
*** RIVER *** [9c Ah Kh 3c] [6d]
s70n3fac3: bets 750
FDIBA2009: folds 
Uncalled bet (750) returned to s70n3fac3
s70n3fac3 collected 945 from pot
s70n3fac3: doesn't show hand 
*** SUMMARY ***
Total pot 1000 | Rake 55 
Board [9c Ah Kh 3c 6d]
Seat 1: s70n3fac3 (big blind) collected (945)
Seat 2: FDIBA2009 (button) (small blind) folded on the River



PokerStars Home Game Hand #227140618073: {Club #4781089}  Hold'em No Limit (50/100) - 2021/05/28 22:57:12 EET [2021/05/28 15:57:12 ET]
Table 'VTPP NLHE 2805' 2-max (Play Money) Seat #1 is the button
Seat 1: s70n3fac3 (12812 in chips) 
Seat 2: FDIBA2009 (6020 in chips) 
s70n3fac3: posts small blind 50
FDIBA2009: posts big blind 100
*** HOLE CARDS ***
s70n3fac3: folds 
Uncalled bet (50) returned to FDIBA2009
FDIBA2009 collected 100 from pot
FDIBA2009: doesn't show hand 
*** SUMMARY ***
Total pot 100 | Rake 0 
Seat 1: s70n3fac3 (button) (small blind) folded before Flop
Seat 2: FDIBA2009 (big blind) collected (100)



PokerStars Home Game Hand #227140619885: {Club #4781089}  Hold'em No Limit (50/100) - 2021/05/28 22:57:17 EET [2021/05/28 15:57:17 ET]
Table 'VTPP NLHE 2805' 2-max (Play Money) Seat #2 is the button
Seat 1: s70n3fac3 (12762 in chips) 
Seat 2: FDIBA2009 (6070 in chips) 
FDIBA2009: posts small blind 50
s70n3fac3: posts big blind 100
*** HOLE CARDS ***
FDIBA2009: raises 100 to 200
s70n3fac3: calls 100
*** FLOP *** [2d 9d 5c]
s70n3fac3: checks 
FDIBA2009: checks 
*** TURN *** [2d 9d 5c] [8s]
s70n3fac3: checks 
FDIBA2009: bets 250
s70n3fac3: folds 
Uncalled bet (250) returned to FDIBA2009
FDIBA2009 collected 378 from pot
FDIBA2009: doesn't show hand 
*** SUMMARY ***
Total pot 400 | Rake 22 
Board [2d 9d 5c 8s]
Seat 1: s70n3fac3 (big blind) folded on the Turn
Seat 2: FDIBA2009 (button) (small blind) collected (378)



PokerStars Home Game Hand #227140632165: {Club #4781089}  Hold'em No Limit (50/100) - 2021/05/28 22:57:50 EET [2021/05/28 15:57:50 ET]
Table 'VTPP NLHE 2805' 2-max (Play Money) Seat #1 is the button
Seat 1: s70n3fac3 (12562 in chips) 
Seat 2: FDIBA2009 (6248 in chips) 
s70n3fac3: posts small blind 50
FDIBA2009: posts big blind 100
*** HOLE CARDS ***
s70n3fac3: raises 100 to 200
FDIBA2009: raises 100 to 300
s70n3fac3: calls 100
*** FLOP *** [6d Ks 5s]
FDIBA2009: checks 
s70n3fac3: checks 
*** TURN *** [6d Ks 5s] [Qh]
FDIBA2009: checks 
s70n3fac3: checks 
*** RIVER *** [6d Ks 5s Qh] [As]
FDIBA2009: checks 
s70n3fac3: checks 
*** SHOW DOWN ***
FDIBA2009: shows [7d Jc] (high card Ace)
s70n3fac3: shows [7s Jh] (high card Ace)
FDIBA2009 collected 284 from pot
s70n3fac3 collected 283 from pot
*** SUMMARY ***
Total pot 600 | Rake 33 
Board [6d Ks 5s Qh As]
Seat 1: s70n3fac3 (button) (small blind) showed [7s Jh] and won (283) with high card Ace
Seat 2: FDIBA2009 (big blind) showed [7d Jc] and won (284) with high card Ace



PokerStars Home Game Hand #227140645284: {Club #4781089}  Hold'em No Limit (50/100) - 2021/05/28 22:58:24 EET [2021/05/28 15:58:24 ET]
Table 'VTPP NLHE 2805' 2-max (Play Money) Seat #2 is the button
Seat 1: s70n3fac3 (12545 in chips) 
Seat 2: FDIBA2009 (6232 in chips) 
FDIBA2009: posts small blind 50
s70n3fac3: posts big blind 100
*** HOLE CARDS ***
FDIBA2009: raises 100 to 200
s70n3fac3: calls 100
*** FLOP *** [Td 3c Jh]
s70n3fac3: checks 
FDIBA2009: bets 200
s70n3fac3: raises 450 to 650
FDIBA2009: folds 
Uncalled bet (450) returned to s70n3fac3
s70n3fac3 collected 756 from pot
s70n3fac3: doesn't show hand 
*** SUMMARY ***
Total pot 800 | Rake 44 
Board [Td 3c Jh]
Seat 1: s70n3fac3 (big blind) collected (756)
Seat 2: FDIBA2009 (button) (small blind) folded on the Flop



PokerStars Home Game Hand #227140655534: {Club #4781089}  Hold'em No Limit (50/100) - 2021/05/28 22:58:51 EET [2021/05/28 15:58:51 ET]
Table 'VTPP NLHE 2805' 2-max (Play Money) Seat #1 is the button
Seat 1: s70n3fac3 (12901 in chips) 
Seat 2: FDIBA2009 (5832 in chips) 
s70n3fac3: posts small blind 50
FDIBA2009: posts big blind 100
*** HOLE CARDS ***
s70n3fac3: raises 150 to 250
FDIBA2009: raises 150 to 400
s70n3fac3: calls 150
*** FLOP *** [9s 3d 8s]
FDIBA2009: bets 450
s70n3fac3: raises 1000 to 1450
FDIBA2009: calls 1000
*** TURN *** [9s 3d 8s] [2s]
FDIBA2009: checks 
s70n3fac3: bets 3982
FDIBA2009: folds 
Uncalled bet (3982) returned to s70n3fac3
s70n3fac3 collected 3496 from pot
s70n3fac3: doesn't show hand 
*** SUMMARY ***
Total pot 3700 | Rake 204 
Board [9s 3d 8s 2s]
Seat 1: s70n3fac3 (button) (small blind) collected (3496)
Seat 2: FDIBA2009 (big blind) folded on the Turn



PokerStars Home Game Hand #227140673362: {Club #4781089}  Hold'em No Limit (50/100) - 2021/05/28 22:59:37 EET [2021/05/28 15:59:37 ET]
Table 'VTPP NLHE 2805' 2-max (Play Money) Seat #2 is the button
Seat 1: s70n3fac3 (14547 in chips) 
Seat 2: FDIBA2009 (3982 in chips) 
FDIBA2009: posts small blind 50
s70n3fac3: posts big blind 100
*** HOLE CARDS ***
FDIBA2009: folds 
Uncalled bet (50) returned to s70n3fac3
s70n3fac3 collected 100 from pot
s70n3fac3: doesn't show hand 
*** SUMMARY ***
Total pot 100 | Rake 0 
Seat 1: s70n3fac3 (big blind) collected (100)
Seat 2: FDIBA2009 (button) (small blind) folded before Flop



PokerStars Home Game Hand #227140675268: {Club #4781089}  Hold'em No Limit (50/100) - 2021/05/28 22:59:43 EET [2021/05/28 15:59:43 ET]
Table 'VTPP NLHE 2805' 2-max (Play Money) Seat #1 is the button
Seat 1: s70n3fac3 (14597 in chips) 
Seat 2: FDIBA2009 (3932 in chips) 
s70n3fac3: posts small blind 50
FDIBA2009: posts big blind 100
*** HOLE CARDS ***
s70n3fac3: raises 150 to 250
FDIBA2009: raises 150 to 400
s70n3fac3: calls 150
*** FLOP *** [5c 7d 8d]
FDIBA2009: bets 250
s70n3fac3: folds 
Uncalled bet (250) returned to FDIBA2009
FDIBA2009 collected 756 from pot
FDIBA2009: doesn't show hand 
*** SUMMARY ***
Total pot 800 | Rake 44 
Board [5c 7d 8d]
Seat 1: s70n3fac3 (button) (small blind) folded on the Flop
Seat 2: FDIBA2009 (big blind) collected (756)



PokerStars Home Game Hand #227140685066: {Club #4781089}  Hold'em No Limit (50/100) - 2021/05/28 23:00:08 EET [2021/05/28 16:00:08 ET]
Table 'VTPP NLHE 2805' 2-max (Play Money) Seat #2 is the button
Seat 1: s70n3fac3 (14197 in chips) 
Seat 2: FDIBA2009 (4288 in chips) 
FDIBA2009: posts small blind 50
s70n3fac3: posts big blind 100
*** HOLE CARDS ***
FDIBA2009: raises 100 to 200
s70n3fac3: calls 100
*** FLOP *** [Ac 6c Jd]
s70n3fac3: checks 
FDIBA2009: checks 
*** TURN *** [Ac 6c Jd] [9s]
s70n3fac3: bets 200
FDIBA2009: folds 
Uncalled bet (200) returned to s70n3fac3
s70n3fac3 collected 378 from pot
s70n3fac3: doesn't show hand 
*** SUMMARY ***
Total pot 400 | Rake 22 
Board [Ac 6c Jd 9s]
Seat 1: s70n3fac3 (big blind) collected (378)
Seat 2: FDIBA2009 (button) (small blind) folded on the Turn



PokerStars Home Game Hand #227140695479: {Club #4781089}  Hold'em No Limit (50/100) - 2021/05/28 23:00:33 EET [2021/05/28 16:00:33 ET]
Table 'VTPP NLHE 2805' 2-max (Play Money) Seat #1 is the button
Seat 1: s70n3fac3 (14375 in chips) 
Seat 2: FDIBA2009 (4088 in chips) 
s70n3fac3: posts small blind 50
FDIBA2009: posts big blind 100
*** HOLE CARDS ***
s70n3fac3: raises 150 to 250
FDIBA2009: folds 
Uncalled bet (150) returned to s70n3fac3
s70n3fac3 collected 200 from pot
s70n3fac3: doesn't show hand 
*** SUMMARY ***
Total pot 200 | Rake 0 
Seat 1: s70n3fac3 (button) (small blind) collected (200)
Seat 2: FDIBA2009 (big blind) folded before Flop



PokerStars Home Game Hand #227140700381: {Club #4781089}  Hold'em No Limit (50/100) - 2021/05/28 23:00:43 EET [2021/05/28 16:00:43 ET]
Table 'VTPP NLHE 2805' 2-max (Play Money) Seat #2 is the button
Seat 1: s70n3fac3 (14475 in chips) 
Seat 2: FDIBA2009 (3988 in chips) 
FDIBA2009: posts small blind 50
s70n3fac3: posts big blind 100
*** HOLE CARDS ***
FDIBA2009: raises 100 to 200
s70n3fac3: folds 
Uncalled bet (100) returned to FDIBA2009
FDIBA2009 collected 200 from pot
FDIBA2009: doesn't show hand 
*** SUMMARY ***
Total pot 200 | Rake 0 
Seat 1: s70n3fac3 (big blind) folded before Flop
Seat 2: FDIBA2009 (button) (small blind) collected (200)



PokerStars Home Game Hand #227140703957: {Club #4781089}  Hold'em No Limit (50/100) - 2021/05/28 23:00:51 EET [2021/05/28 16:00:51 ET]
Table 'VTPP NLHE 2805' 2-max (Play Money) Seat #1 is the button
Seat 1: s70n3fac3 (14375 in chips) 
Seat 2: FDIBA2009 (4088 in chips) 
s70n3fac3: posts small blind 50
FDIBA2009: posts big blind 100
*** HOLE CARDS ***
s70n3fac3: raises 150 to 250
FDIBA2009: folds 
Uncalled bet (150) returned to s70n3fac3
s70n3fac3 collected 200 from pot
s70n3fac3: doesn't show hand 
*** SUMMARY ***
Total pot 200 | Rake 0 
Seat 1: s70n3fac3 (button) (small blind) collected (200)
Seat 2: FDIBA2009 (big blind) folded before Flop



PokerStars Home Game Hand #227140707239: {Club #4781089}  Hold'em No Limit (50/100) - 2021/05/28 23:00:58 EET [2021/05/28 16:00:58 ET]
Table 'VTPP NLHE 2805' 2-max (Play Money) Seat #2 is the button
Seat 1: s70n3fac3 (14475 in chips) 
Seat 2: FDIBA2009 (3988 in chips) 
FDIBA2009: posts small blind 50
s70n3fac3: posts big blind 100
*** HOLE CARDS ***
FDIBA2009: folds 
Uncalled bet (50) returned to s70n3fac3
s70n3fac3 collected 100 from pot
s70n3fac3: doesn't show hand 
*** SUMMARY ***
Total pot 100 | Rake 0 
Seat 1: s70n3fac3 (big blind) collected (100)
Seat 2: FDIBA2009 (button) (small blind) folded before Flop



PokerStars Home Game Hand #227140709594: {Club #4781089}  Hold'em No Limit (50/100) - 2021/05/28 23:01:03 EET [2021/05/28 16:01:03 ET]
Table 'VTPP NLHE 2805' 2-max (Play Money) Seat #1 is the button
Seat 1: s70n3fac3 (14525 in chips) 
Seat 2: FDIBA2009 (3938 in chips) 
s70n3fac3: posts small blind 50
FDIBA2009: posts big blind 100
*** HOLE CARDS ***
s70n3fac3: folds 
Uncalled bet (50) returned to FDIBA2009
FDIBA2009 collected 100 from pot
FDIBA2009: doesn't show hand 
*** SUMMARY ***
Total pot 100 | Rake 0 
Seat 1: s70n3fac3 (button) (small blind) folded before Flop
Seat 2: FDIBA2009 (big blind) collected (100)



PokerStars Home Game Hand #227140715539: {Club #4781089}  Hold'em No Limit (50/100) - 2021/05/28 23:01:16 EET [2021/05/28 16:01:16 ET]
Table 'VTPP NLHE 2805' 2-max (Play Money) Seat #2 is the button
Seat 1: s70n3fac3 (14475 in chips) 
Seat 2: FDIBA2009 (3988 in chips) 
FDIBA2009: posts small blind 50
s70n3fac3: posts big blind 100
*** HOLE CARDS ***
FDIBA2009: raises 100 to 200
s70n3fac3: calls 100
*** FLOP *** [Td 5h 7s]
s70n3fac3: checks 
FDIBA2009: bets 250
s70n3fac3: folds 
Uncalled bet (250) returned to FDIBA2009
FDIBA2009 collected 378 from pot
FDIBA2009: doesn't show hand 
*** SUMMARY ***
Total pot 400 | Rake 22 
Board [Td 5h 7s]
Seat 1: s70n3fac3 (big blind) folded on the Flop
Seat 2: FDIBA2009 (button) (small blind) collected (378)



PokerStars Home Game Hand #227140726351: {Club #4781089}  Hold'em No Limit (50/100) - 2021/05/28 23:01:39 EET [2021/05/28 16:01:39 ET]
Table 'VTPP NLHE 2805' 2-max (Play Money) Seat #1 is the button
Seat 1: s70n3fac3 (14275 in chips) 
Seat 2: FDIBA2009 (4166 in chips) 
s70n3fac3: posts small blind 50
FDIBA2009: posts big blind 100
*** HOLE CARDS ***
s70n3fac3: raises 100 to 200
FDIBA2009: calls 100
*** FLOP *** [7h 7c Td]
FDIBA2009: checks 
s70n3fac3: bets 220
FDIBA2009: raises 930 to 1150
s70n3fac3: folds 
Uncalled bet (930) returned to FDIBA2009
FDIBA2009 collected 794 from pot
FDIBA2009: doesn't show hand 
*** SUMMARY ***
Total pot 840 | Rake 46 
Board [7h 7c Td]
Seat 1: s70n3fac3 (button) (small blind) folded on the Flop
Seat 2: FDIBA2009 (big blind) collected (794)



PokerStars Home Game Hand #227140742573: {Club #4781089}  Hold'em No Limit (50/100) - 2021/05/28 23:02:11 EET [2021/05/28 16:02:11 ET]
Table 'VTPP NLHE 2805' 2-max (Play Money) Seat #2 is the button
Seat 1: s70n3fac3 (13855 in chips) 
Seat 2: FDIBA2009 (4540 in chips) 
FDIBA2009: posts small blind 50
s70n3fac3: posts big blind 100
*** HOLE CARDS ***
FDIBA2009: raises 100 to 200
s70n3fac3: calls 100
*** FLOP *** [Qc 7d 2s]
s70n3fac3: checks 
FDIBA2009: bets 250
s70n3fac3: folds 
Uncalled bet (250) returned to FDIBA2009
FDIBA2009 collected 378 from pot
FDIBA2009: doesn't show hand 
*** SUMMARY ***
Total pot 400 | Rake 22 
Board [Qc 7d 2s]
Seat 1: s70n3fac3 (big blind) folded on the Flop
Seat 2: FDIBA2009 (button) (small blind) collected (378)



PokerStars Home Game Hand #227140750548: {Club #4781089}  Hold'em No Limit (50/100) - 2021/05/28 23:02:27 EET [2021/05/28 16:02:27 ET]
Table 'VTPP NLHE 2805' 2-max (Play Money) Seat #1 is the button
Seat 1: s70n3fac3 (13655 in chips) 
Seat 2: FDIBA2009 (4718 in chips) 
s70n3fac3: posts small blind 50
FDIBA2009: posts big blind 100
*** HOLE CARDS ***
s70n3fac3: raises 150 to 250
FDIBA2009: calls 150
*** FLOP *** [9c Qd 6d]
FDIBA2009: checks 
s70n3fac3: bets 265
FDIBA2009: calls 265
*** TURN *** [9c Qd 6d] [9h]
FDIBA2009: checks 
s70n3fac3: checks 
*** RIVER *** [9c Qd 6d 9h] [Th]
FDIBA2009: bets 500
s70n3fac3: raises 1150 to 1650
FDIBA2009: raises 2553 to 4203 and is all-in
s70n3fac3: calls 2553
*** SHOW DOWN ***
FDIBA2009: shows [Ts 9s] (a full house, Nines full of Tens)
s70n3fac3: shows [8c Jd] (a straight, Eight to Queen)
FDIBA2009 collected 8917 from pot
*** SUMMARY ***
Total pot 9436 | Rake 519 
Board [9c Qd 6d 9h Th]
Seat 1: s70n3fac3 (button) (small blind) showed [8c Jd] and lost with a straight, Eight to Queen
Seat 2: FDIBA2009 (big blind) showed [Ts 9s] and won (8917) with a full house, Nines full of Tens



PokerStars Home Game Hand #227140781506: {Club #4781089}  Hold'em No Limit (50/100) - 2021/05/28 23:03:22 EET [2021/05/28 16:03:22 ET]
Table 'VTPP NLHE 2805' 2-max (Play Money) Seat #2 is the button
Seat 1: s70n3fac3 (8937 in chips) 
Seat 2: FDIBA2009 (8917 in chips) 
FDIBA2009: posts small blind 50
s70n3fac3: posts big blind 100
*** HOLE CARDS ***
FDIBA2009: raises 100 to 200
s70n3fac3: calls 100
*** FLOP *** [Td 7s 4s]
s70n3fac3: checks 
FDIBA2009: bets 200
s70n3fac3: folds 
Uncalled bet (200) returned to FDIBA2009
FDIBA2009 collected 378 from pot
FDIBA2009: doesn't show hand 
*** SUMMARY ***
Total pot 400 | Rake 22 
Board [Td 7s 4s]
Seat 1: s70n3fac3 (big blind) folded on the Flop
Seat 2: FDIBA2009 (button) (small blind) collected (378)



PokerStars Home Game Hand #227140793407: {Club #4781089}  Hold'em No Limit (50/100) - 2021/05/28 23:03:45 EET [2021/05/28 16:03:45 ET]
Table 'VTPP NLHE 2805' 2-max (Play Money) Seat #1 is the button
Seat 1: s70n3fac3 (8737 in chips) 
Seat 2: FDIBA2009 (9095 in chips) 
s70n3fac3: posts small blind 50
FDIBA2009: posts big blind 100
*** HOLE CARDS ***
s70n3fac3: folds 
Uncalled bet (50) returned to FDIBA2009
FDIBA2009 collected 100 from pot
FDIBA2009: doesn't show hand 
*** SUMMARY ***
Total pot 100 | Rake 0 
Seat 1: s70n3fac3 (button) (small blind) folded before Flop
Seat 2: FDIBA2009 (big blind) collected (100)



PokerStars Home Game Hand #227140796694: {Club #4781089}  Hold'em No Limit (50/100) - 2021/05/28 23:03:51 EET [2021/05/28 16:03:51 ET]
Table 'VTPP NLHE 2805' 2-max (Play Money) Seat #2 is the button
Seat 1: s70n3fac3 (8687 in chips) 
Seat 2: FDIBA2009 (9145 in chips) 
FDIBA2009: posts small blind 50
s70n3fac3: posts big blind 100
*** HOLE CARDS ***
FDIBA2009: raises 100 to 200
s70n3fac3: calls 100
*** FLOP *** [8c Qh 9s]
s70n3fac3: checks 
FDIBA2009: bets 200
s70n3fac3: calls 200
*** TURN *** [8c Qh 9s] [3d]
s70n3fac3: checks 
FDIBA2009: checks 
*** RIVER *** [8c Qh 9s 3d] [5h]
s70n3fac3: checks 
FDIBA2009: bets 200
s70n3fac3: folds 
Uncalled bet (200) returned to FDIBA2009
FDIBA2009 collected 756 from pot
FDIBA2009: doesn't show hand 
*** SUMMARY ***
Total pot 800 | Rake 44 
Board [8c Qh 9s 3d 5h]
Seat 1: s70n3fac3 (big blind) folded on the River
Seat 2: FDIBA2009 (button) (small blind) collected (756)



PokerStars Home Game Hand #227140824675: {Club #4781089}  Hold'em No Limit (50/100) - 2021/05/28 23:04:30 EET [2021/05/28 16:04:30 ET]
Table 'VTPP NLHE 2805' 2-max (Play Money) Seat #1 is the button
Seat 1: s70n3fac3 (8287 in chips) 
Seat 2: FDIBA2009 (9501 in chips) 
s70n3fac3: posts small blind 50
FDIBA2009: posts big blind 100
*** HOLE CARDS ***
s70n3fac3: folds 
Uncalled bet (50) returned to FDIBA2009
FDIBA2009 collected 100 from pot
FDIBA2009: doesn't show hand 
*** SUMMARY ***
Total pot 100 | Rake 0 
Seat 1: s70n3fac3 (button) (small blind) folded before Flop
Seat 2: FDIBA2009 (big blind) collected (100)



PokerStars Home Game Hand #227140826839: {Club #4781089}  Hold'em No Limit (50/100) - 2021/05/28 23:04:34 EET [2021/05/28 16:04:34 ET]
Table 'VTPP NLHE 2805' 2-max (Play Money) Seat #2 is the button
Seat 1: s70n3fac3 (8237 in chips) 
Seat 2: FDIBA2009 (9551 in chips) 
FDIBA2009: posts small blind 50
s70n3fac3: posts big blind 100
*** HOLE CARDS ***
FDIBA2009: raises 100 to 200
s70n3fac3: raises 450 to 650
FDIBA2009: folds 
Uncalled bet (450) returned to s70n3fac3
s70n3fac3 collected 400 from pot
s70n3fac3: doesn't show hand 
*** SUMMARY ***
Total pot 400 | Rake 0 
Seat 1: s70n3fac3 (big blind) collected (400)
Seat 2: FDIBA2009 (button) (small blind) folded before Flop



PokerStars Home Game Hand #227140832021: {Club #4781089}  Hold'em No Limit (50/100) - 2021/05/28 23:04:44 EET [2021/05/28 16:04:44 ET]
Table 'VTPP NLHE 2805' 2-max (Play Money) Seat #1 is the button
Seat 1: s70n3fac3 (8437 in chips) 
Seat 2: FDIBA2009 (9351 in chips) 
s70n3fac3: posts small blind 50
FDIBA2009: posts big blind 100
*** HOLE CARDS ***
s70n3fac3: folds 
Uncalled bet (50) returned to FDIBA2009
FDIBA2009 collected 100 from pot
FDIBA2009: doesn't show hand 
*** SUMMARY ***
Total pot 100 | Rake 0 
Seat 1: s70n3fac3 (button) (small blind) folded before Flop
Seat 2: FDIBA2009 (big blind) collected (100)



PokerStars Home Game Hand #227140834280: {Club #4781089}  Hold'em No Limit (50/100) - 2021/05/28 23:04:48 EET [2021/05/28 16:04:48 ET]
Table 'VTPP NLHE 2805' 2-max (Play Money) Seat #2 is the button
Seat 1: s70n3fac3 (8387 in chips) 
Seat 2: FDIBA2009 (9401 in chips) 
FDIBA2009: posts small blind 50
s70n3fac3: posts big blind 100
*** HOLE CARDS ***
FDIBA2009: raises 100 to 200
s70n3fac3: calls 100
*** FLOP *** [6h 6s 3d]
s70n3fac3: checks 
FDIBA2009: checks 
*** TURN *** [6h 6s 3d] [As]
s70n3fac3: bets 200
FDIBA2009: calls 200
*** RIVER *** [6h 6s 3d As] [8s]
s70n3fac3: checks 
FDIBA2009: bets 200
s70n3fac3: calls 200
*** SHOW DOWN ***
FDIBA2009: shows [Ac Qh] (two pair, Aces and Sixes)
s70n3fac3: mucks hand 
FDIBA2009 collected 1134 from pot
*** SUMMARY ***
Total pot 1200 | Rake 66 
Board [6h 6s 3d As 8s]
Seat 1: s70n3fac3 (big blind) mucked [5d 8h]
Seat 2: FDIBA2009 (button) (small blind) showed [Ac Qh] and won (1134) with two pair, Aces and Sixes



PokerStars Home Game Hand #227140852373: {Club #4781089}  Hold'em No Limit (50/100) - 2021/05/28 23:05:22 EET [2021/05/28 16:05:22 ET]
Table 'VTPP NLHE 2805' 2-max (Play Money) Seat #1 is the button
Seat 1: s70n3fac3 (7787 in chips) 
Seat 2: FDIBA2009 (9935 in chips) 
s70n3fac3: posts small blind 50
FDIBA2009: posts big blind 100
*** HOLE CARDS ***
s70n3fac3: calls 50
FDIBA2009: checks 
*** FLOP *** [7h Qs Jd]
FDIBA2009: checks 
s70n3fac3: bets 189
FDIBA2009: calls 189
*** TURN *** [7h Qs Jd] [3c]
FDIBA2009: checks 
s70n3fac3: bets 355
FDIBA2009: calls 355
*** RIVER *** [7h Qs Jd 3c] [Td]
FDIBA2009: checks 
s70n3fac3: bets 840
FDIBA2009: calls 840
*** SHOW DOWN ***
s70n3fac3: shows [7d 3d] (two pair, Sevens and Threes)
FDIBA2009: mucks hand 
s70n3fac3 collected 2805 from pot
*** SUMMARY ***
Total pot 2968 | Rake 163 
Board [7h Qs Jd 3c Td]
Seat 1: s70n3fac3 (button) (small blind) showed [7d 3d] and won (2805) with two pair, Sevens and Threes
Seat 2: FDIBA2009 (big blind) mucked [Ks Kd]



PokerStars Home Game Hand #227140877423: {Club #4781089}  Hold'em No Limit (50/100) - 2021/05/28 23:06:09 EET [2021/05/28 16:06:09 ET]
Table 'VTPP NLHE 2805' 2-max (Play Money) Seat #2 is the button
Seat 1: s70n3fac3 (9108 in chips) 
Seat 2: FDIBA2009 (8451 in chips) 
FDIBA2009: posts small blind 50
s70n3fac3: posts big blind 100
*** HOLE CARDS ***
FDIBA2009: raises 100 to 200
s70n3fac3: folds 
Uncalled bet (100) returned to FDIBA2009
FDIBA2009 collected 200 from pot
FDIBA2009: doesn't show hand 
*** SUMMARY ***
Total pot 200 | Rake 0 
Seat 1: s70n3fac3 (big blind) folded before Flop
Seat 2: FDIBA2009 (button) (small blind) collected (200)



PokerStars Home Game Hand #227140883298: {Club #4781089}  Hold'em No Limit (50/100) - 2021/05/28 23:06:20 EET [2021/05/28 16:06:20 ET]
Table 'VTPP NLHE 2805' 2-max (Play Money) Seat #1 is the button
Seat 1: s70n3fac3 (9008 in chips) 
Seat 2: FDIBA2009 (8551 in chips) 
s70n3fac3: posts small blind 50
FDIBA2009: posts big blind 100
*** HOLE CARDS ***
s70n3fac3: raises 150 to 250
FDIBA2009: folds 
Uncalled bet (150) returned to s70n3fac3
s70n3fac3 collected 200 from pot
s70n3fac3: doesn't show hand 
*** SUMMARY ***
Total pot 200 | Rake 0 
Seat 1: s70n3fac3 (button) (small blind) collected (200)
Seat 2: FDIBA2009 (big blind) folded before Flop



PokerStars Home Game Hand #227140886248: {Club #4781089}  Hold'em No Limit (50/100) - 2021/05/28 23:06:26 EET [2021/05/28 16:06:26 ET]
Table 'VTPP NLHE 2805' 2-max (Play Money) Seat #2 is the button
Seat 1: s70n3fac3 (9108 in chips) 
Seat 2: FDIBA2009 (8451 in chips) 
FDIBA2009: posts small blind 50
s70n3fac3: posts big blind 100
*** HOLE CARDS ***
FDIBA2009: folds 
Uncalled bet (50) returned to s70n3fac3
s70n3fac3 collected 100 from pot
s70n3fac3: doesn't show hand 
*** SUMMARY ***
Total pot 100 | Rake 0 
Seat 1: s70n3fac3 (big blind) collected (100)
Seat 2: FDIBA2009 (button) (small blind) folded before Flop



PokerStars Home Game Hand #227140889389: {Club #4781089}  Hold'em No Limit (50/100) - 2021/05/28 23:06:32 EET [2021/05/28 16:06:32 ET]
Table 'VTPP NLHE 2805' 2-max (Play Money) Seat #1 is the button
Seat 1: s70n3fac3 (9158 in chips) 
Seat 2: FDIBA2009 (8401 in chips) 
s70n3fac3: posts small blind 50
FDIBA2009: posts big blind 100
*** HOLE CARDS ***
s70n3fac3: folds 
Uncalled bet (50) returned to FDIBA2009
FDIBA2009 collected 100 from pot
FDIBA2009: doesn't show hand 
*** SUMMARY ***
Total pot 100 | Rake 0 
Seat 1: s70n3fac3 (button) (small blind) folded before Flop
Seat 2: FDIBA2009 (big blind) collected (100)



PokerStars Home Game Hand #227140891444: {Club #4781089}  Hold'em No Limit (50/100) - 2021/05/28 23:06:35 EET [2021/05/28 16:06:35 ET]
Table 'VTPP NLHE 2805' 2-max (Play Money) Seat #2 is the button
Seat 1: s70n3fac3 (9108 in chips) 
Seat 2: FDIBA2009 (8451 in chips) 
FDIBA2009: posts small blind 50
s70n3fac3: posts big blind 100
*** HOLE CARDS ***
FDIBA2009: raises 100 to 200
s70n3fac3: calls 100
*** FLOP *** [Js Ac 4d]
s70n3fac3: checks 
FDIBA2009: bets 200
s70n3fac3: calls 200
*** TURN *** [Js Ac 4d] [8h]
s70n3fac3: checks 
FDIBA2009: checks 
*** RIVER *** [Js Ac 4d 8h] [5h]
s70n3fac3: bets 500
FDIBA2009: calls 500
*** SHOW DOWN ***
s70n3fac3: shows [7c Jc] (a pair of Jacks)
FDIBA2009: mucks hand 
s70n3fac3 collected 1701 from pot
*** SUMMARY ***
Total pot 1800 | Rake 99 
Board [Js Ac 4d 8h 5h]
Seat 1: s70n3fac3 (big blind) showed [7c Jc] and won (1701) with a pair of Jacks
Seat 2: FDIBA2009 (button) (small blind) mucked [8d 9h]



PokerStars Home Game Hand #227140913891: {Club #4781089}  Hold'em No Limit (50/100) - 2021/05/28 23:07:09 EET [2021/05/28 16:07:09 ET]
Table 'VTPP NLHE 2805' 2-max (Play Money) Seat #1 is the button
Seat 1: s70n3fac3 (9909 in chips) 
Seat 2: FDIBA2009 (7551 in chips) 
s70n3fac3: posts small blind 50
FDIBA2009: posts big blind 100
*** HOLE CARDS ***
s70n3fac3: raises 150 to 250
FDIBA2009: calls 150
*** FLOP *** [6d Jh 5h]
FDIBA2009: checks 
s70n3fac3: checks 
*** TURN *** [6d Jh 5h] [2s]
FDIBA2009: checks 
s70n3fac3: checks 
*** RIVER *** [6d Jh 5h 2s] [9c]
FDIBA2009: checks 
s70n3fac3: checks 
*** SHOW DOWN ***
FDIBA2009: shows [8s Ks] (high card King)
s70n3fac3: mucks hand 
FDIBA2009 collected 472 from pot
*** SUMMARY ***
Total pot 500 | Rake 28 
Board [6d Jh 5h 2s 9c]
Seat 1: s70n3fac3 (button) (small blind) mucked [8c Td]
Seat 2: FDIBA2009 (big blind) showed [8s Ks] and won (472) with high card King



PokerStars Home Game Hand #227140930981: {Club #4781089}  Hold'em No Limit (50/100) - 2021/05/28 23:07:41 EET [2021/05/28 16:07:41 ET]
Table 'VTPP NLHE 2805' 2-max (Play Money) Seat #2 is the button
Seat 1: s70n3fac3 (9659 in chips) 
Seat 2: FDIBA2009 (7773 in chips) 
FDIBA2009: posts small blind 50
s70n3fac3: posts big blind 100
*** HOLE CARDS ***
FDIBA2009: raises 100 to 200
s70n3fac3: calls 100
*** FLOP *** [5s 5d 8d]
s70n3fac3: checks 
FDIBA2009: bets 200
s70n3fac3: folds 
Uncalled bet (200) returned to FDIBA2009
FDIBA2009 collected 378 from pot
FDIBA2009: doesn't show hand 
*** SUMMARY ***
Total pot 400 | Rake 22 
Board [5s 5d 8d]
Seat 1: s70n3fac3 (big blind) folded on the Flop
Seat 2: FDIBA2009 (button) (small blind) collected (378)



PokerStars Home Game Hand #227140940239: {Club #4781089}  Hold'em No Limit (50/100) - 2021/05/28 23:07:58 EET [2021/05/28 16:07:58 ET]
Table 'VTPP NLHE 2805' 2-max (Play Money) Seat #1 is the button
Seat 1: s70n3fac3 (9459 in chips) 
Seat 2: FDIBA2009 (7951 in chips) 
s70n3fac3: posts small blind 50
FDIBA2009: posts big blind 100
*** HOLE CARDS ***
s70n3fac3: raises 150 to 250
FDIBA2009: raises 250 to 500
s70n3fac3: calls 250
*** FLOP *** [Qd Kd Js]
FDIBA2009: bets 500
s70n3fac3: calls 500
*** TURN *** [Qd Kd Js] [Ac]
FDIBA2009: checks 
s70n3fac3: checks 
*** RIVER *** [Qd Kd Js Ac] [Ad]
FDIBA2009: checks 
s70n3fac3: checks 
*** SHOW DOWN ***
FDIBA2009: shows [Jc Tc] (a straight, Ten to Ace)
s70n3fac3: mucks hand 
FDIBA2009 collected 1890 from pot
*** SUMMARY ***
Total pot 2000 | Rake 110 
Board [Qd Kd Js Ac Ad]
Seat 1: s70n3fac3 (button) (small blind) mucked [7h Ks]
Seat 2: FDIBA2009 (big blind) showed [Jc Tc] and won (1890) with a straight, Ten to Ace



PokerStars Home Game Hand #227140961878: {Club #4781089}  Hold'em No Limit (50/100) - 2021/05/28 23:08:39 EET [2021/05/28 16:08:39 ET]
Table 'VTPP NLHE 2805' 2-max (Play Money) Seat #2 is the button
Seat 1: s70n3fac3 (8459 in chips) 
Seat 2: FDIBA2009 (8841 in chips) 
FDIBA2009: posts small blind 50
s70n3fac3: posts big blind 100
*** HOLE CARDS ***
FDIBA2009: raises 100 to 200
s70n3fac3: calls 100
*** FLOP *** [3s 5c 4h]
s70n3fac3: checks 
FDIBA2009: bets 200
s70n3fac3: folds 
Uncalled bet (200) returned to FDIBA2009
FDIBA2009 collected 378 from pot
FDIBA2009: doesn't show hand 
*** SUMMARY ***
Total pot 400 | Rake 22 
Board [3s 5c 4h]
Seat 1: s70n3fac3 (big blind) folded on the Flop
Seat 2: FDIBA2009 (button) (small blind) collected (378)



PokerStars Home Game Hand #227140975147: {Club #4781089}  Hold'em No Limit (50/100) - 2021/05/28 23:09:04 EET [2021/05/28 16:09:04 ET]
Table 'VTPP NLHE 2805' 2-max (Play Money) Seat #1 is the button
Seat 1: s70n3fac3 (8259 in chips) 
Seat 2: FDIBA2009 (9019 in chips) 
s70n3fac3: posts small blind 50
FDIBA2009: posts big blind 100
*** HOLE CARDS ***
s70n3fac3: raises 150 to 250
FDIBA2009: folds 
Uncalled bet (150) returned to s70n3fac3
s70n3fac3 collected 200 from pot
s70n3fac3: doesn't show hand 
*** SUMMARY ***
Total pot 200 | Rake 0 
Seat 1: s70n3fac3 (button) (small blind) collected (200)
Seat 2: FDIBA2009 (big blind) folded before Flop



PokerStars Home Game Hand #227140979476: {Club #4781089}  Hold'em No Limit (50/100) - 2021/05/28 23:09:12 EET [2021/05/28 16:09:12 ET]
Table 'VTPP NLHE 2805' 2-max (Play Money) Seat #2 is the button
Seat 1: s70n3fac3 (8359 in chips) 
Seat 2: FDIBA2009 (8919 in chips) 
FDIBA2009: posts small blind 50
s70n3fac3: posts big blind 100
*** HOLE CARDS ***
FDIBA2009: raises 100 to 200
s70n3fac3: raises 400 to 600
FDIBA2009: calls 400
*** FLOP *** [Ah 5d Jc]
s70n3fac3: bets 600
FDIBA2009: calls 600
*** TURN *** [Ah 5d Jc] [As]
s70n3fac3: bets 1450
FDIBA2009: folds 
Uncalled bet (1450) returned to s70n3fac3
s70n3fac3 collected 2268 from pot
s70n3fac3: doesn't show hand 
*** SUMMARY ***
Total pot 2400 | Rake 132 
Board [Ah 5d Jc As]
Seat 1: s70n3fac3 (big blind) collected (2268)
Seat 2: FDIBA2009 (button) (small blind) folded on the Turn



PokerStars Home Game Hand #227141002707: {Club #4781089}  Hold'em No Limit (50/100) - 2021/05/28 23:09:56 EET [2021/05/28 16:09:56 ET]
Table 'VTPP NLHE 2805' 2-max (Play Money) Seat #1 is the button
Seat 1: s70n3fac3 (9427 in chips) 
Seat 2: FDIBA2009 (7719 in chips) 
s70n3fac3: posts small blind 50
FDIBA2009: posts big blind 100
*** HOLE CARDS ***
s70n3fac3: raises 150 to 250
FDIBA2009: folds 
Uncalled bet (150) returned to s70n3fac3
s70n3fac3 collected 200 from pot
s70n3fac3: doesn't show hand 
*** SUMMARY ***
Total pot 200 | Rake 0 
Seat 1: s70n3fac3 (button) (small blind) collected (200)
Seat 2: FDIBA2009 (big blind) folded before Flop



PokerStars Home Game Hand #227141006487: {Club #4781089}  Hold'em No Limit (50/100) - 2021/05/28 23:10:03 EET [2021/05/28 16:10:03 ET]
Table 'VTPP NLHE 2805' 2-max (Play Money) Seat #2 is the button
Seat 1: s70n3fac3 (9527 in chips) 
Seat 2: FDIBA2009 (7619 in chips) 
FDIBA2009: posts small blind 50
s70n3fac3: posts big blind 100
*** HOLE CARDS ***
FDIBA2009: raises 100 to 200
s70n3fac3: calls 100
*** FLOP *** [4h 5d Qs]
s70n3fac3: checks 
FDIBA2009: checks 
*** TURN *** [4h 5d Qs] [7d]
s70n3fac3: checks 
FDIBA2009: bets 200
s70n3fac3: folds 
Uncalled bet (200) returned to FDIBA2009
FDIBA2009 collected 378 from pot
FDIBA2009: doesn't show hand 
*** SUMMARY ***
Total pot 400 | Rake 22 
Board [4h 5d Qs 7d]
Seat 1: s70n3fac3 (big blind) folded on the Turn
Seat 2: FDIBA2009 (button) (small blind) collected (378)



PokerStars Home Game Hand #227141023791: {Club #4781089}  Hold'em No Limit (50/100) - 2021/05/28 23:10:36 EET [2021/05/28 16:10:36 ET]
Table 'VTPP NLHE 2805' 2-max (Play Money) Seat #1 is the button
Seat 1: s70n3fac3 (9327 in chips) 
Seat 2: FDIBA2009 (7797 in chips) 
s70n3fac3: posts small blind 50
FDIBA2009: posts big blind 100
*** HOLE CARDS ***
s70n3fac3: raises 100 to 200
FDIBA2009: raises 100 to 300
s70n3fac3: calls 100
*** FLOP *** [6d 6h Kc]
FDIBA2009: checks 
s70n3fac3: checks 
*** TURN *** [6d 6h Kc] [Td]
FDIBA2009: bets 300
s70n3fac3: folds 
Uncalled bet (300) returned to FDIBA2009
FDIBA2009 collected 567 from pot
FDIBA2009: doesn't show hand 
*** SUMMARY ***
Total pot 600 | Rake 33 
Board [6d 6h Kc Td]
Seat 1: s70n3fac3 (button) (small blind) folded on the Turn
Seat 2: FDIBA2009 (big blind) collected (567)



PokerStars Home Game Hand #227141041590: {Club #4781089}  Hold'em No Limit (50/100) - 2021/05/28 23:11:10 EET [2021/05/28 16:11:10 ET]
Table 'VTPP NLHE 2805' 2-max (Play Money) Seat #2 is the button
Seat 1: s70n3fac3 (9027 in chips) 
Seat 2: FDIBA2009 (8064 in chips) 
FDIBA2009: posts small blind 50
s70n3fac3: posts big blind 100
*** HOLE CARDS ***
FDIBA2009: raises 100 to 200
s70n3fac3: folds 
Uncalled bet (100) returned to FDIBA2009
FDIBA2009 collected 200 from pot
FDIBA2009: doesn't show hand 
*** SUMMARY ***
Total pot 200 | Rake 0 
Seat 1: s70n3fac3 (big blind) folded before Flop
Seat 2: FDIBA2009 (button) (small blind) collected (200)



PokerStars Home Game Hand #227141045914: {Club #4781089}  Hold'em No Limit (50/100) - 2021/05/28 23:11:18 EET [2021/05/28 16:11:18 ET]
Table 'VTPP NLHE 2805' 2-max (Play Money) Seat #1 is the button
Seat 1: s70n3fac3 (8927 in chips) 
Seat 2: FDIBA2009 (8164 in chips) 
s70n3fac3: posts small blind 50
FDIBA2009: posts big blind 100
*** HOLE CARDS ***
s70n3fac3: raises 150 to 250
FDIBA2009: calls 150
*** FLOP *** [Ah 4c Ad]
FDIBA2009: checks 
s70n3fac3: bets 250
FDIBA2009: calls 250
*** TURN *** [Ah 4c Ad] [2h]
FDIBA2009: checks 
s70n3fac3: bets 550
FDIBA2009: raises 550 to 1100
s70n3fac3: calls 550
*** RIVER *** [Ah 4c Ad 2h] [8h]
FDIBA2009: bets 2000
s70n3fac3: raises 5327 to 7327 and is all-in
FDIBA2009: calls 4564 and is all-in
Uncalled bet (763) returned to s70n3fac3
*** SHOW DOWN ***
s70n3fac3: shows [9h 9s] (two pair, Aces and Nines)
FDIBA2009: shows [4d Ac] (a full house, Aces full of Fours)
FDIBA2009 collected 15430 from pot
*** SUMMARY ***
Total pot 16328 | Rake 898 
Board [Ah 4c Ad 2h 8h]
Seat 1: s70n3fac3 (button) (small blind) showed [9h 9s] and lost with two pair, Aces and Nines
Seat 2: FDIBA2009 (big blind) showed [4d Ac] and won (15430) with a full house, Aces full of Fours



PokerStars Home Game Hand #227141083629: {Club #4781089}  Hold'em No Limit (50/100) - 2021/05/28 23:12:29 EET [2021/05/28 16:12:29 ET]
Table 'VTPP NLHE 2805' 2-max (Play Money) Seat #2 is the button
Seat 1: s70n3fac3 (763 in chips) 
Seat 2: FDIBA2009 (15430 in chips) 
FDIBA2009: posts small blind 50
s70n3fac3: posts big blind 100
*** HOLE CARDS ***
FDIBA2009: raises 100 to 200
s70n3fac3: raises 563 to 763 and is all-in
FDIBA2009: calls 563
*** FLOP *** [8s 7c 3h]
*** TURN *** [8s 7c 3h] [9c]
*** RIVER *** [8s 7c 3h 9c] [7h]
*** SHOW DOWN ***
s70n3fac3: shows [Qc 8h] (two pair, Eights and Sevens)
FDIBA2009: shows [Js Qs] (a pair of Sevens)
s70n3fac3 collected 1442 from pot
*** SUMMARY ***
Total pot 1526 | Rake 84 
Board [8s 7c 3h 9c 7h]
Seat 1: s70n3fac3 (big blind) showed [Qc 8h] and won (1442) with two pair, Eights and Sevens
Seat 2: FDIBA2009 (button) (small blind) showed [Js Qs] and lost with a pair of Sevens



PokerStars Home Game Hand #227141103254: {Club #4781089}  Hold'em No Limit (50/100) - 2021/05/28 23:13:06 EET [2021/05/28 16:13:06 ET]
Table 'VTPP NLHE 2805' 2-max (Play Money) Seat #1 is the button
Seat 1: s70n3fac3 (8442 in chips) 
Seat 2: FDIBA2009 (14667 in chips) 
s70n3fac3: posts small blind 50
FDIBA2009: posts big blind 100
*** HOLE CARDS ***
s70n3fac3: raises 150 to 250
FDIBA2009: folds 
Uncalled bet (150) returned to s70n3fac3
s70n3fac3 collected 200 from pot
s70n3fac3: doesn't show hand 
*** SUMMARY ***
Total pot 200 | Rake 0 
Seat 1: s70n3fac3 (button) (small blind) collected (200)
Seat 2: FDIBA2009 (big blind) folded before Flop



PokerStars Home Game Hand #227141109948: {Club #4781089}  Hold'em No Limit (50/100) - 2021/05/28 23:13:18 EET [2021/05/28 16:13:18 ET]
Table 'VTPP NLHE 2805' 2-max (Play Money) Seat #2 is the button
Seat 1: s70n3fac3 (8542 in chips) 
Seat 2: FDIBA2009 (14567 in chips) 
FDIBA2009: posts small blind 50
s70n3fac3: posts big blind 100
*** HOLE CARDS ***
FDIBA2009: raises 100 to 200
s70n3fac3: folds 
Uncalled bet (100) returned to FDIBA2009
FDIBA2009 collected 200 from pot
FDIBA2009: doesn't show hand 
*** SUMMARY ***
Total pot 200 | Rake 0 
Seat 1: s70n3fac3 (big blind) folded before Flop
Seat 2: FDIBA2009 (button) (small blind) collected (200)



PokerStars Home Game Hand #227141117891: {Club #4781089}  Hold'em No Limit (50/100) - 2021/05/28 23:13:33 EET [2021/05/28 16:13:33 ET]
Table 'VTPP NLHE 2805' 2-max (Play Money) Seat #1 is the button
Seat 1: s70n3fac3 (8442 in chips) 
Seat 2: FDIBA2009 (14667 in chips) 
s70n3fac3: posts small blind 50
FDIBA2009: posts big blind 100
*** HOLE CARDS ***
s70n3fac3: folds 
Uncalled bet (50) returned to FDIBA2009
FDIBA2009 collected 100 from pot
FDIBA2009: doesn't show hand 
*** SUMMARY ***
Total pot 100 | Rake 0 
Seat 1: s70n3fac3 (button) (small blind) folded before Flop
Seat 2: FDIBA2009 (big blind) collected (100)



PokerStars Home Game Hand #227141120071: {Club #4781089}  Hold'em No Limit (50/100) - 2021/05/28 23:13:37 EET [2021/05/28 16:13:37 ET]
Table 'VTPP NLHE 2805' 2-max (Play Money) Seat #2 is the button
Seat 1: s70n3fac3 (8392 in chips) 
Seat 2: FDIBA2009 (14717 in chips) 
FDIBA2009: posts small blind 50
s70n3fac3: posts big blind 100
*** HOLE CARDS ***
FDIBA2009: calls 50
s70n3fac3: checks 
*** FLOP *** [Jc Kc Tc]
s70n3fac3: checks 
FDIBA2009: checks 
*** TURN *** [Jc Kc Tc] [3c]
s70n3fac3: checks 
FDIBA2009: checks 
*** RIVER *** [Jc Kc Tc 3c] [4d]
s70n3fac3: checks 
FDIBA2009: checks 
*** SHOW DOWN ***
s70n3fac3: shows [7s Kh] (a pair of Kings)
FDIBA2009: mucks hand 
s70n3fac3 collected 189 from pot
*** SUMMARY ***
Total pot 200 | Rake 11 
Board [Jc Kc Tc 3c 4d]
Seat 1: s70n3fac3 (big blind) showed [7s Kh] and won (189) with a pair of Kings
Seat 2: FDIBA2009 (button) (small blind) mucked [8h 3h]



PokerStars Home Game Hand #227141133749: {Club #4781089}  Hold'em No Limit (50/100) - 2021/05/28 23:14:03 EET [2021/05/28 16:14:03 ET]
Table 'VTPP NLHE 2805' 2-max (Play Money) Seat #1 is the button
Seat 1: s70n3fac3 (8481 in chips) 
Seat 2: FDIBA2009 (14617 in chips) 
s70n3fac3: posts small blind 50
FDIBA2009: posts big blind 100
*** HOLE CARDS ***
s70n3fac3: raises 100 to 200
FDIBA2009: calls 100
*** FLOP *** [8s 7c 4c]
FDIBA2009: checks 
s70n3fac3: checks 
*** TURN *** [8s 7c 4c] [2h]
FDIBA2009: bets 200
s70n3fac3: folds 
Uncalled bet (200) returned to FDIBA2009
FDIBA2009 collected 378 from pot
FDIBA2009: doesn't show hand 
*** SUMMARY ***
Total pot 400 | Rake 22 
Board [8s 7c 4c 2h]
Seat 1: s70n3fac3 (button) (small blind) folded on the Turn
Seat 2: FDIBA2009 (big blind) collected (378)



PokerStars Home Game Hand #227141144423: {Club #4781089}  Hold'em No Limit (50/100) - 2021/05/28 23:14:23 EET [2021/05/28 16:14:23 ET]
Table 'VTPP NLHE 2805' 2-max (Play Money) Seat #2 is the button
Seat 1: s70n3fac3 (8281 in chips) 
Seat 2: FDIBA2009 (14795 in chips) 
FDIBA2009: posts small blind 50
s70n3fac3: posts big blind 100
*** HOLE CARDS ***
FDIBA2009: raises 100 to 200
s70n3fac3: raises 400 to 600
FDIBA2009: folds 
Uncalled bet (400) returned to s70n3fac3
s70n3fac3 collected 400 from pot
s70n3fac3: doesn't show hand 
*** SUMMARY ***
Total pot 400 | Rake 0 
Seat 1: s70n3fac3 (big blind) collected (400)
Seat 2: FDIBA2009 (button) (small blind) folded before Flop



PokerStars Home Game Hand #227141152439: {Club #4781089}  Hold'em No Limit (50/100) - 2021/05/28 23:14:39 EET [2021/05/28 16:14:39 ET]
Table 'VTPP NLHE 2805' 2-max (Play Money) Seat #1 is the button
Seat 1: s70n3fac3 (8481 in chips) 
Seat 2: FDIBA2009 (14595 in chips) 
s70n3fac3: posts small blind 50
FDIBA2009: posts big blind 100
*** HOLE CARDS ***
s70n3fac3: raises 150 to 250
FDIBA2009: folds 
Uncalled bet (150) returned to s70n3fac3
s70n3fac3 collected 200 from pot
s70n3fac3: doesn't show hand 
*** SUMMARY ***
Total pot 200 | Rake 0 
Seat 1: s70n3fac3 (button) (small blind) collected (200)
Seat 2: FDIBA2009 (big blind) folded before Flop



PokerStars Home Game Hand #227141158042: {Club #4781089}  Hold'em No Limit (50/100) - 2021/05/28 23:14:49 EET [2021/05/28 16:14:49 ET]
Table 'VTPP NLHE 2805' 2-max (Play Money) Seat #2 is the button
Seat 1: s70n3fac3 (8581 in chips) 
Seat 2: FDIBA2009 (14495 in chips) 
FDIBA2009: posts small blind 50
s70n3fac3: posts big blind 100
*** HOLE CARDS ***
FDIBA2009: folds 
Uncalled bet (50) returned to s70n3fac3
s70n3fac3 collected 100 from pot
s70n3fac3: doesn't show hand 
*** SUMMARY ***
Total pot 100 | Rake 0 
Seat 1: s70n3fac3 (big blind) collected (100)
Seat 2: FDIBA2009 (button) (small blind) folded before Flop



PokerStars Home Game Hand #227141161525: {Club #4781089}  Hold'em No Limit (50/100) - 2021/05/28 23:14:56 EET [2021/05/28 16:14:56 ET]
Table 'VTPP NLHE 2805' 2-max (Play Money) Seat #1 is the button
Seat 1: s70n3fac3 (8631 in chips) 
Seat 2: FDIBA2009 (14445 in chips) 
s70n3fac3: posts small blind 50
FDIBA2009: posts big blind 100
*** HOLE CARDS ***
s70n3fac3: raises 150 to 250
FDIBA2009: folds 
Uncalled bet (150) returned to s70n3fac3
s70n3fac3 collected 200 from pot
s70n3fac3: doesn't show hand 
*** SUMMARY ***
Total pot 200 | Rake 0 
Seat 1: s70n3fac3 (button) (small blind) collected (200)
Seat 2: FDIBA2009 (big blind) folded before Flop



PokerStars Home Game Hand #227141167544: {Club #4781089}  Hold'em No Limit (50/100) - 2021/05/28 23:15:07 EET [2021/05/28 16:15:07 ET]
Table 'VTPP NLHE 2805' 2-max (Play Money) Seat #2 is the button
Seat 1: s70n3fac3 (8731 in chips) 
Seat 2: FDIBA2009 (14345 in chips) 
FDIBA2009: posts small blind 50
s70n3fac3: posts big blind 100
*** HOLE CARDS ***
FDIBA2009: raises 100 to 200
s70n3fac3: raises 450 to 650
FDIBA2009: folds 
Uncalled bet (450) returned to s70n3fac3
s70n3fac3 collected 400 from pot
s70n3fac3: doesn't show hand 
*** SUMMARY ***
Total pot 400 | Rake 0 
Seat 1: s70n3fac3 (big blind) collected (400)
Seat 2: FDIBA2009 (button) (small blind) folded before Flop



PokerStars Home Game Hand #227141174152: {Club #4781089}  Hold'em No Limit (50/100) - 2021/05/28 23:15:18 EET [2021/05/28 16:15:18 ET]
Table 'VTPP NLHE 2805' 2-max (Play Money) Seat #1 is the button
Seat 1: s70n3fac3 (8931 in chips) 
Seat 2: FDIBA2009 (14145 in chips) 
s70n3fac3: posts small blind 50
FDIBA2009: posts big blind 100
*** HOLE CARDS ***
s70n3fac3: raises 150 to 250
FDIBA2009: calls 150
*** FLOP *** [5c 6c 3c]
FDIBA2009: checks 
s70n3fac3: checks 
*** TURN *** [5c 6c 3c] [8s]
FDIBA2009: bets 300
s70n3fac3: calls 300
*** RIVER *** [5c 6c 3c 8s] [5s]
FDIBA2009: checks 
s70n3fac3: checks 
*** SHOW DOWN ***
FDIBA2009: shows [4d Ts] (a pair of Fives)
s70n3fac3: shows [7h Ah] (a pair of Fives - Ace kicker)
s70n3fac3 collected 1039 from pot
*** SUMMARY ***
Total pot 1100 | Rake 61 
Board [5c 6c 3c 8s 5s]
Seat 1: s70n3fac3 (button) (small blind) showed [7h Ah] and won (1039) with a pair of Fives
Seat 2: FDIBA2009 (big blind) showed [4d Ts] and lost with a pair of Fives



PokerStars Home Game Hand #227141193454: {Club #4781089}  Hold'em No Limit (50/100) - 2021/05/28 23:15:53 EET [2021/05/28 16:15:53 ET]
Table 'VTPP NLHE 2805' 2-max (Play Money) Seat #2 is the button
Seat 1: s70n3fac3 (9420 in chips) 
Seat 2: FDIBA2009 (13595 in chips) 
FDIBA2009: posts small blind 50
s70n3fac3: posts big blind 100
*** HOLE CARDS ***
FDIBA2009: raises 100 to 200
s70n3fac3: calls 100
*** FLOP *** [Jc 3c 4d]
s70n3fac3: checks 
FDIBA2009: bets 200
s70n3fac3: folds 
Uncalled bet (200) returned to FDIBA2009
FDIBA2009 collected 378 from pot
FDIBA2009: doesn't show hand 
*** SUMMARY ***
Total pot 400 | Rake 22 
Board [Jc 3c 4d]
Seat 1: s70n3fac3 (big blind) folded on the Flop
Seat 2: FDIBA2009 (button) (small blind) collected (378)



PokerStars Home Game Hand #227141204984: {Club #4781089}  Hold'em No Limit (50/100) - 2021/05/28 23:16:14 EET [2021/05/28 16:16:14 ET]
Table 'VTPP NLHE 2805' 2-max (Play Money) Seat #1 is the button
Seat 1: s70n3fac3 (9220 in chips) 
Seat 2: FDIBA2009 (13773 in chips) 
s70n3fac3: posts small blind 50
FDIBA2009: posts big blind 100
*** HOLE CARDS ***
s70n3fac3: folds 
Uncalled bet (50) returned to FDIBA2009
FDIBA2009 collected 100 from pot
FDIBA2009: doesn't show hand 
*** SUMMARY ***
Total pot 100 | Rake 0 
Seat 1: s70n3fac3 (button) (small blind) folded before Flop
Seat 2: FDIBA2009 (big blind) collected (100)



PokerStars Home Game Hand #227141207432: {Club #4781089}  Hold'em No Limit (50/100) - 2021/05/28 23:16:19 EET [2021/05/28 16:16:19 ET]
Table 'VTPP NLHE 2805' 2-max (Play Money) Seat #2 is the button
Seat 1: s70n3fac3 (9170 in chips) 
Seat 2: FDIBA2009 (13823 in chips) 
FDIBA2009: posts small blind 50
s70n3fac3: posts big blind 100
*** HOLE CARDS ***
FDIBA2009: raises 100 to 200
s70n3fac3: calls 100
*** FLOP *** [2d 8d Th]
s70n3fac3: checks 
FDIBA2009: bets 250
s70n3fac3: folds 
Uncalled bet (250) returned to FDIBA2009
FDIBA2009 collected 378 from pot
FDIBA2009: doesn't show hand 
*** SUMMARY ***
Total pot 400 | Rake 22 
Board [2d 8d Th]
Seat 1: s70n3fac3 (big blind) folded on the Flop
Seat 2: FDIBA2009 (button) (small blind) collected (378)



PokerStars Home Game Hand #227141217286: {Club #4781089}  Hold'em No Limit (50/100) - 2021/05/28 23:16:36 EET [2021/05/28 16:16:36 ET]
Table 'VTPP NLHE 2805' 2-max (Play Money) Seat #1 is the button
Seat 1: s70n3fac3 (8970 in chips) 
Seat 2: FDIBA2009 (14001 in chips) 
s70n3fac3: posts small blind 50
FDIBA2009: posts big blind 100
*** HOLE CARDS ***
s70n3fac3: folds 
Uncalled bet (50) returned to FDIBA2009
FDIBA2009 collected 100 from pot
FDIBA2009: doesn't show hand 
*** SUMMARY ***
Total pot 100 | Rake 0 
Seat 1: s70n3fac3 (button) (small blind) folded before Flop
Seat 2: FDIBA2009 (big blind) collected (100)



PokerStars Home Game Hand #227141219545: {Club #4781089}  Hold'em No Limit (50/100) - 2021/05/28 23:16:40 EET [2021/05/28 16:16:40 ET]
Table 'VTPP NLHE 2805' 2-max (Play Money) Seat #2 is the button
Seat 1: s70n3fac3 (8920 in chips) 
Seat 2: FDIBA2009 (14051 in chips) 
FDIBA2009: posts small blind 50
s70n3fac3: posts big blind 100
*** HOLE CARDS ***
FDIBA2009: raises 100 to 200
s70n3fac3: calls 100
*** FLOP *** [9d 7h 8c]
s70n3fac3: checks 
FDIBA2009: bets 200
s70n3fac3: folds 
Uncalled bet (200) returned to FDIBA2009
FDIBA2009 collected 378 from pot
FDIBA2009: doesn't show hand 
*** SUMMARY ***
Total pot 400 | Rake 22 
Board [9d 7h 8c]
Seat 1: s70n3fac3 (big blind) folded on the Flop
Seat 2: FDIBA2009 (button) (small blind) collected (378)



PokerStars Home Game Hand #227141231033: {Club #4781089}  Hold'em No Limit (50/100) - 2021/05/28 23:17:01 EET [2021/05/28 16:17:01 ET]
Table 'VTPP NLHE 2805' 2-max (Play Money) Seat #1 is the button
Seat 1: s70n3fac3 (8720 in chips) 
Seat 2: FDIBA2009 (14229 in chips) 
s70n3fac3: posts small blind 50
FDIBA2009: posts big blind 100
*** HOLE CARDS ***
s70n3fac3: raises 150 to 250
FDIBA2009: folds 
Uncalled bet (150) returned to s70n3fac3
s70n3fac3 collected 200 from pot
s70n3fac3: doesn't show hand 
*** SUMMARY ***
Total pot 200 | Rake 0 
Seat 1: s70n3fac3 (button) (small blind) collected (200)
Seat 2: FDIBA2009 (big blind) folded before Flop



PokerStars Home Game Hand #227141234176: {Club #4781089}  Hold'em No Limit (50/100) - 2021/05/28 23:17:06 EET [2021/05/28 16:17:06 ET]
Table 'VTPP NLHE 2805' 2-max (Play Money) Seat #2 is the button
Seat 1: s70n3fac3 (8820 in chips) 
Seat 2: FDIBA2009 (14129 in chips) 
FDIBA2009: posts small blind 50
s70n3fac3: posts big blind 100
*** HOLE CARDS ***
FDIBA2009: raises 100 to 200
s70n3fac3: folds 
Uncalled bet (100) returned to FDIBA2009
FDIBA2009 collected 200 from pot
FDIBA2009: doesn't show hand 
*** SUMMARY ***
Total pot 200 | Rake 0 
Seat 1: s70n3fac3 (big blind) folded before Flop
Seat 2: FDIBA2009 (button) (small blind) collected (200)



PokerStars Home Game Hand #227141240440: {Club #4781089}  Hold'em No Limit (50/100) - 2021/05/28 23:17:18 EET [2021/05/28 16:17:18 ET]
Table 'VTPP NLHE 2805' 2-max (Play Money) Seat #1 is the button
Seat 1: s70n3fac3 (8720 in chips) 
Seat 2: FDIBA2009 (14229 in chips) 
s70n3fac3: posts small blind 50
FDIBA2009: posts big blind 100
*** HOLE CARDS ***
s70n3fac3: raises 150 to 250
FDIBA2009: folds 
Uncalled bet (150) returned to s70n3fac3
s70n3fac3 collected 200 from pot
s70n3fac3: doesn't show hand 
*** SUMMARY ***
Total pot 200 | Rake 0 
Seat 1: s70n3fac3 (button) (small blind) collected (200)
Seat 2: FDIBA2009 (big blind) folded before Flop



PokerStars Home Game Hand #227141244740: {Club #4781089}  Hold'em No Limit (50/100) - 2021/05/28 23:17:25 EET [2021/05/28 16:17:25 ET]
Table 'VTPP NLHE 2805' 2-max (Play Money) Seat #2 is the button
Seat 1: s70n3fac3 (8820 in chips) 
Seat 2: FDIBA2009 (14129 in chips) 
FDIBA2009: posts small blind 50
s70n3fac3: posts big blind 100
*** HOLE CARDS ***
FDIBA2009: raises 100 to 200
s70n3fac3: calls 100
*** FLOP *** [Jh 7d Kh]
s70n3fac3: checks 
FDIBA2009: checks 
*** TURN *** [Jh 7d Kh] [Ah]
s70n3fac3: bets 300
FDIBA2009: folds 
Uncalled bet (300) returned to s70n3fac3
s70n3fac3 collected 378 from pot
s70n3fac3: doesn't show hand 
*** SUMMARY ***
Total pot 400 | Rake 22 
Board [Jh 7d Kh Ah]
Seat 1: s70n3fac3 (big blind) collected (378)
Seat 2: FDIBA2009 (button) (small blind) folded on the Turn



PokerStars Home Game Hand #227141257127: {Club #4781089}  Hold'em No Limit (50/100) - 2021/05/28 23:17:47 EET [2021/05/28 16:17:47 ET]
Table 'VTPP NLHE 2805' 2-max (Play Money) Seat #1 is the button
Seat 1: s70n3fac3 (8998 in chips) 
Seat 2: FDIBA2009 (13929 in chips) 
s70n3fac3: posts small blind 50
FDIBA2009: posts big blind 100
*** HOLE CARDS ***
s70n3fac3: raises 150 to 250
FDIBA2009: calls 150
*** FLOP *** [Ts 8d 9h]
FDIBA2009: checks 
s70n3fac3: checks 
*** TURN *** [Ts 8d 9h] [Ks]
FDIBA2009: checks 
s70n3fac3: bets 400
FDIBA2009: calls 400
*** RIVER *** [Ts 8d 9h Ks] [6h]
FDIBA2009: checks 
s70n3fac3: checks 
*** SHOW DOWN ***
FDIBA2009: shows [3d Td] (a pair of Tens)
s70n3fac3: mucks hand 
FDIBA2009 collected 1228 from pot
*** SUMMARY ***
Total pot 1300 | Rake 72 
Board [Ts 8d 9h Ks 6h]
Seat 1: s70n3fac3 (button) (small blind) mucked [Qh 6d]
Seat 2: FDIBA2009 (big blind) showed [3d Td] and won (1228) with a pair of Tens



PokerStars Home Game Hand #227141271795: {Club #4781089}  Hold'em No Limit (50/100) - 2021/05/28 23:18:14 EET [2021/05/28 16:18:14 ET]
Table 'VTPP NLHE 2805' 2-max (Play Money) Seat #2 is the button
Seat 1: s70n3fac3 (8348 in chips) 
Seat 2: FDIBA2009 (14507 in chips) 
FDIBA2009: posts small blind 50
s70n3fac3: posts big blind 100
*** HOLE CARDS ***
FDIBA2009: raises 100 to 200
s70n3fac3: raises 450 to 650
FDIBA2009: folds 
Uncalled bet (450) returned to s70n3fac3
s70n3fac3 collected 400 from pot
s70n3fac3: doesn't show hand 
*** SUMMARY ***
Total pot 400 | Rake 0 
Seat 1: s70n3fac3 (big blind) collected (400)
Seat 2: FDIBA2009 (button) (small blind) folded before Flop



PokerStars Home Game Hand #227141280243: {Club #4781089}  Hold'em No Limit (50/100) - 2021/05/28 23:18:29 EET [2021/05/28 16:18:29 ET]
Table 'VTPP NLHE 2805' 2-max (Play Money) Seat #1 is the button
Seat 1: s70n3fac3 (8548 in chips) 
Seat 2: FDIBA2009 (14307 in chips) 
s70n3fac3: posts small blind 50
FDIBA2009: posts big blind 100
*** HOLE CARDS ***
s70n3fac3: folds 
Uncalled bet (50) returned to FDIBA2009
FDIBA2009 collected 100 from pot
FDIBA2009: doesn't show hand 
*** SUMMARY ***
Total pot 100 | Rake 0 
Seat 1: s70n3fac3 (button) (small blind) folded before Flop
Seat 2: FDIBA2009 (big blind) collected (100)



PokerStars Home Game Hand #227141282391: {Club #4781089}  Hold'em No Limit (50/100) - 2021/05/28 23:18:33 EET [2021/05/28 16:18:33 ET]
Table 'VTPP NLHE 2805' 2-max (Play Money) Seat #2 is the button
Seat 1: s70n3fac3 (8498 in chips) 
Seat 2: FDIBA2009 (14357 in chips) 
FDIBA2009: posts small blind 50
s70n3fac3: posts big blind 100
*** HOLE CARDS ***
FDIBA2009: raises 100 to 200
s70n3fac3: folds 
Uncalled bet (100) returned to FDIBA2009
FDIBA2009 collected 200 from pot
FDIBA2009: doesn't show hand 
*** SUMMARY ***
Total pot 200 | Rake 0 
Seat 1: s70n3fac3 (big blind) folded before Flop
Seat 2: FDIBA2009 (button) (small blind) collected (200)



PokerStars Home Game Hand #227141286189: {Club #4781089}  Hold'em No Limit (50/100) - 2021/05/28 23:18:40 EET [2021/05/28 16:18:40 ET]
Table 'VTPP NLHE 2805' 2-max (Play Money) Seat #1 is the button
Seat 1: s70n3fac3 (8398 in chips) 
Seat 2: FDIBA2009 (14457 in chips) 
s70n3fac3: posts small blind 50
FDIBA2009: posts big blind 100
*** HOLE CARDS ***
s70n3fac3: folds 
Uncalled bet (50) returned to FDIBA2009
FDIBA2009 collected 100 from pot
FDIBA2009: doesn't show hand 
*** SUMMARY ***
Total pot 100 | Rake 0 
Seat 1: s70n3fac3 (button) (small blind) folded before Flop
Seat 2: FDIBA2009 (big blind) collected (100)



PokerStars Home Game Hand #227141288240: {Club #4781089}  Hold'em No Limit (50/100) - 2021/05/28 23:18:43 EET [2021/05/28 16:18:43 ET]
Table 'VTPP NLHE 2805' 2-max (Play Money) Seat #2 is the button
Seat 1: s70n3fac3 (8348 in chips) 
Seat 2: FDIBA2009 (14507 in chips) 
FDIBA2009: posts small blind 50
s70n3fac3: posts big blind 100
*** HOLE CARDS ***
FDIBA2009: raises 100 to 200
s70n3fac3: raises 450 to 650
FDIBA2009: folds 
Uncalled bet (450) returned to s70n3fac3
s70n3fac3 collected 400 from pot
s70n3fac3: doesn't show hand 
*** SUMMARY ***
Total pot 400 | Rake 0 
Seat 1: s70n3fac3 (big blind) collected (400)
Seat 2: FDIBA2009 (button) (small blind) folded before Flop



PokerStars Home Game Hand #227141298527: {Club #4781089}  Hold'em No Limit (50/100) - 2021/05/28 23:19:01 EET [2021/05/28 16:19:01 ET]
Table 'VTPP NLHE 2805' 2-max (Play Money) Seat #1 is the button
Seat 1: s70n3fac3 (8548 in chips) 
Seat 2: FDIBA2009 (14307 in chips) 
s70n3fac3: posts small blind 50
FDIBA2009: posts big blind 100
*** HOLE CARDS ***
s70n3fac3: folds 
Uncalled bet (50) returned to FDIBA2009
FDIBA2009 collected 100 from pot
FDIBA2009: doesn't show hand 
*** SUMMARY ***
Total pot 100 | Rake 0 
Seat 1: s70n3fac3 (button) (small blind) folded before Flop
Seat 2: FDIBA2009 (big blind) collected (100)



PokerStars Home Game Hand #227141300643: {Club #4781089}  Hold'em No Limit (50/100) - 2021/05/28 23:19:05 EET [2021/05/28 16:19:05 ET]
Table 'VTPP NLHE 2805' 2-max (Play Money) Seat #2 is the button
Seat 1: s70n3fac3 (8498 in chips) 
Seat 2: FDIBA2009 (14357 in chips) 
FDIBA2009: posts small blind 50
s70n3fac3: posts big blind 100
*** HOLE CARDS ***
FDIBA2009: raises 100 to 200
s70n3fac3: calls 100
*** FLOP *** [7c 5h 7h]
s70n3fac3: checks 
FDIBA2009: bets 200
s70n3fac3: folds 
Uncalled bet (200) returned to FDIBA2009
FDIBA2009 collected 378 from pot
FDIBA2009: doesn't show hand 
*** SUMMARY ***
Total pot 400 | Rake 22 
Board [7c 5h 7h]
Seat 1: s70n3fac3 (big blind) folded on the Flop
Seat 2: FDIBA2009 (button) (small blind) collected (378)



PokerStars Home Game Hand #227141317511: {Club #4781089}  Hold'em No Limit (50/100) - 2021/05/28 23:19:23 EET [2021/05/28 16:19:23 ET]
Table 'VTPP NLHE 2805' 2-max (Play Money) Seat #1 is the button
Seat 1: s70n3fac3 (8298 in chips) 
Seat 2: FDIBA2009 (14535 in chips) 
s70n3fac3: posts small blind 50
FDIBA2009: posts big blind 100
*** HOLE CARDS ***
s70n3fac3: raises 150 to 250
FDIBA2009: calls 150
*** FLOP *** [6c Td Qd]
FDIBA2009: checks 
s70n3fac3: bets 300
FDIBA2009: folds 
Uncalled bet (300) returned to s70n3fac3
s70n3fac3 collected 472 from pot
s70n3fac3: doesn't show hand 
*** SUMMARY ***
Total pot 500 | Rake 28 
Board [6c Td Qd]
Seat 1: s70n3fac3 (button) (small blind) collected (472)
Seat 2: FDIBA2009 (big blind) folded on the Flop



PokerStars Home Game Hand #227141323471: {Club #4781089}  Hold'em No Limit (50/100) - 2021/05/28 23:19:34 EET [2021/05/28 16:19:34 ET]
Table 'VTPP NLHE 2805' 2-max (Play Money) Seat #2 is the button
Seat 1: s70n3fac3 (8520 in chips) 
Seat 2: FDIBA2009 (14285 in chips) 
FDIBA2009: posts small blind 50
s70n3fac3: posts big blind 100
*** HOLE CARDS ***
FDIBA2009: raises 100 to 200
s70n3fac3: calls 100
*** FLOP *** [Kc 8c 5h]
s70n3fac3: checks 
FDIBA2009: checks 
*** TURN *** [Kc 8c 5h] [7s]
s70n3fac3: bets 200
FDIBA2009: calls 200
*** RIVER *** [Kc 8c 5h 7s] [2s]
s70n3fac3: bets 400
FDIBA2009: calls 400
*** SHOW DOWN ***
s70n3fac3: shows [7c Ah] (a pair of Sevens)
FDIBA2009: mucks hand 
s70n3fac3 collected 1512 from pot
*** SUMMARY ***
Total pot 1600 | Rake 88 
Board [Kc 8c 5h 7s 2s]
Seat 1: s70n3fac3 (big blind) showed [7c Ah] and won (1512) with a pair of Sevens
Seat 2: FDIBA2009 (button) (small blind) mucked [6h 6s]



PokerStars Home Game Hand #227141338888: {Club #4781089}  Hold'em No Limit (50/100) - 2021/05/28 23:20:02 EET [2021/05/28 16:20:02 ET]
Table 'VTPP NLHE 2805' 2-max (Play Money) Seat #1 is the button
Seat 1: s70n3fac3 (9232 in chips) 
Seat 2: FDIBA2009 (13485 in chips) 
s70n3fac3: posts small blind 50
FDIBA2009: posts big blind 100
*** HOLE CARDS ***
s70n3fac3: folds 
Uncalled bet (50) returned to FDIBA2009
FDIBA2009 collected 100 from pot
FDIBA2009: doesn't show hand 
*** SUMMARY ***
Total pot 100 | Rake 0 
Seat 1: s70n3fac3 (button) (small blind) folded before Flop
Seat 2: FDIBA2009 (big blind) collected (100)



PokerStars Home Game Hand #227141341342: {Club #4781089}  Hold'em No Limit (50/100) - 2021/05/28 23:20:06 EET [2021/05/28 16:20:06 ET]
Table 'VTPP NLHE 2805' 2-max (Play Money) Seat #2 is the button
Seat 1: s70n3fac3 (9182 in chips) 
Seat 2: FDIBA2009 (13535 in chips) 
FDIBA2009: posts small blind 50
s70n3fac3: posts big blind 100
*** HOLE CARDS ***
FDIBA2009: raises 100 to 200
s70n3fac3: raises 450 to 650
FDIBA2009: folds 
Uncalled bet (450) returned to s70n3fac3
s70n3fac3 collected 400 from pot
s70n3fac3: doesn't show hand 
*** SUMMARY ***
Total pot 400 | Rake 0 
Seat 1: s70n3fac3 (big blind) collected (400)
Seat 2: FDIBA2009 (button) (small blind) folded before Flop



PokerStars Home Game Hand #227141350378: {Club #4781089}  Hold'em No Limit (50/100) - 2021/05/28 23:20:22 EET [2021/05/28 16:20:22 ET]
Table 'VTPP NLHE 2805' 2-max (Play Money) Seat #1 is the button
Seat 1: s70n3fac3 (9382 in chips) 
Seat 2: FDIBA2009 (13335 in chips) 
s70n3fac3: posts small blind 50
FDIBA2009: posts big blind 100
*** HOLE CARDS ***
s70n3fac3: raises 150 to 250
FDIBA2009: raises 150 to 400
s70n3fac3: calls 150
*** FLOP *** [8s Kd 8h]
FDIBA2009: bets 450
s70n3fac3: folds 
Uncalled bet (450) returned to FDIBA2009
FDIBA2009 collected 756 from pot
FDIBA2009: doesn't show hand 
*** SUMMARY ***
Total pot 800 | Rake 44 
Board [8s Kd 8h]
Seat 1: s70n3fac3 (button) (small blind) folded on the Flop
Seat 2: FDIBA2009 (big blind) collected (756)



PokerStars Home Game Hand #227141361383: {Club #4781089}  Hold'em No Limit (50/100) - 2021/05/28 23:20:42 EET [2021/05/28 16:20:42 ET]
Table 'VTPP NLHE 2805' 2-max (Play Money) Seat #2 is the button
Seat 1: s70n3fac3 (8982 in chips) 
Seat 2: FDIBA2009 (13691 in chips) 
FDIBA2009: posts small blind 50
s70n3fac3: posts big blind 100
*** HOLE CARDS ***
FDIBA2009: raises 100 to 200
s70n3fac3: folds 
Uncalled bet (100) returned to FDIBA2009
FDIBA2009 collected 200 from pot
FDIBA2009: doesn't show hand 
*** SUMMARY ***
Total pot 200 | Rake 0 
Seat 1: s70n3fac3 (big blind) folded before Flop
Seat 2: FDIBA2009 (button) (small blind) collected (200)



PokerStars Home Game Hand #227141365228: {Club #4781089}  Hold'em No Limit (50/100) - 2021/05/28 23:20:49 EET [2021/05/28 16:20:49 ET]
Table 'VTPP NLHE 2805' 2-max (Play Money) Seat #1 is the button
Seat 1: s70n3fac3 (8882 in chips) 
Seat 2: FDIBA2009 (13791 in chips) 
s70n3fac3: posts small blind 50
FDIBA2009: posts big blind 100
*** HOLE CARDS ***
s70n3fac3: raises 100 to 200
FDIBA2009: folds 
Uncalled bet (100) returned to s70n3fac3
s70n3fac3 collected 200 from pot
s70n3fac3: doesn't show hand 
*** SUMMARY ***
Total pot 200 | Rake 0 
Seat 1: s70n3fac3 (button) (small blind) collected (200)
Seat 2: FDIBA2009 (big blind) folded before Flop



PokerStars Home Game Hand #227141368795: {Club #4781089}  Hold'em No Limit (50/100) - 2021/05/28 23:20:55 EET [2021/05/28 16:20:55 ET]
Table 'VTPP NLHE 2805' 2-max (Play Money) Seat #2 is the button
Seat 1: s70n3fac3 (8982 in chips) 
Seat 2: FDIBA2009 (13691 in chips) 
FDIBA2009: posts small blind 50
s70n3fac3: posts big blind 100
*** HOLE CARDS ***
FDIBA2009: raises 100 to 200
s70n3fac3: calls 100
*** FLOP *** [3h Ts 8d]
s70n3fac3: checks 
FDIBA2009: bets 200
s70n3fac3: folds 
Uncalled bet (200) returned to FDIBA2009
FDIBA2009 collected 378 from pot
FDIBA2009: doesn't show hand 
*** SUMMARY ***
Total pot 400 | Rake 22 
Board [3h Ts 8d]
Seat 1: s70n3fac3 (big blind) folded on the Flop
Seat 2: FDIBA2009 (button) (small blind) collected (378)



PokerStars Home Game Hand #227141377969: {Club #4781089}  Hold'em No Limit (50/100) - 2021/05/28 23:21:12 EET [2021/05/28 16:21:12 ET]
Table 'VTPP NLHE 2805' 2-max (Play Money) Seat #1 is the button
Seat 1: s70n3fac3 (8782 in chips) 
Seat 2: FDIBA2009 (13869 in chips) 
s70n3fac3: posts small blind 50
FDIBA2009: posts big blind 100
*** HOLE CARDS ***
s70n3fac3: raises 150 to 250
FDIBA2009: calls 150
*** FLOP *** [9d Td 2c]
FDIBA2009: checks 
s70n3fac3: bets 255
FDIBA2009: folds 
Uncalled bet (255) returned to s70n3fac3
s70n3fac3 collected 472 from pot
s70n3fac3: doesn't show hand 
*** SUMMARY ***
Total pot 500 | Rake 28 
Board [9d Td 2c]
Seat 1: s70n3fac3 (button) (small blind) collected (472)
Seat 2: FDIBA2009 (big blind) folded on the Flop



PokerStars Home Game Hand #227141388627: {Club #4781089}  Hold'em No Limit (50/100) - 2021/05/28 23:21:31 EET [2021/05/28 16:21:31 ET]
Table 'VTPP NLHE 2805' 2-max (Play Money) Seat #2 is the button
Seat 1: s70n3fac3 (9004 in chips) 
Seat 2: FDIBA2009 (13619 in chips) 
FDIBA2009: posts small blind 50
s70n3fac3: posts big blind 100
*** HOLE CARDS ***
FDIBA2009: raises 100 to 200
s70n3fac3: folds 
Uncalled bet (100) returned to FDIBA2009
FDIBA2009 collected 200 from pot
FDIBA2009: doesn't show hand 
*** SUMMARY ***
Total pot 200 | Rake 0 
Seat 1: s70n3fac3 (big blind) folded before Flop
Seat 2: FDIBA2009 (button) (small blind) collected (200)



PokerStars Home Game Hand #227141394237: {Club #4781089}  Hold'em No Limit (50/100) - 2021/05/28 23:21:41 EET [2021/05/28 16:21:41 ET]
Table 'VTPP NLHE 2805' 2-max (Play Money) Seat #1 is the button
Seat 1: s70n3fac3 (8904 in chips) 
Seat 2: FDIBA2009 (13719 in chips) 
s70n3fac3: posts small blind 50
FDIBA2009: posts big blind 100
*** HOLE CARDS ***
s70n3fac3: raises 150 to 250
FDIBA2009: raises 500 to 750
s70n3fac3: folds 
Uncalled bet (500) returned to FDIBA2009
FDIBA2009 collected 500 from pot
FDIBA2009: doesn't show hand 
*** SUMMARY ***
Total pot 500 | Rake 0 
Seat 1: s70n3fac3 (button) (small blind) folded before Flop
Seat 2: FDIBA2009 (big blind) collected (500)



PokerStars Home Game Hand #227141401277: {Club #4781089}  Hold'em No Limit (50/100) - 2021/05/28 23:21:53 EET [2021/05/28 16:21:53 ET]
Table 'VTPP NLHE 2805' 2-max (Play Money) Seat #2 is the button
Seat 1: s70n3fac3 (8654 in chips) 
Seat 2: FDIBA2009 (13969 in chips) 
FDIBA2009: posts small blind 50
s70n3fac3: posts big blind 100
*** HOLE CARDS ***
FDIBA2009: raises 100 to 200
s70n3fac3: calls 100
*** FLOP *** [5s 8s Ad]
s70n3fac3: checks 
FDIBA2009: bets 250
s70n3fac3: folds 
Uncalled bet (250) returned to FDIBA2009
FDIBA2009 collected 378 from pot
FDIBA2009: doesn't show hand 
*** SUMMARY ***
Total pot 400 | Rake 22 
Board [5s 8s Ad]
Seat 1: s70n3fac3 (big blind) folded on the Flop
Seat 2: FDIBA2009 (button) (small blind) collected (378)



PokerStars Home Game Hand #227141410660: {Club #4781089}  Hold'em No Limit (50/100) - 2021/05/28 23:22:10 EET [2021/05/28 16:22:10 ET]
Table 'VTPP NLHE 2805' 2-max (Play Money) Seat #1 is the button
Seat 1: s70n3fac3 (8454 in chips) 
Seat 2: FDIBA2009 (14147 in chips) 
s70n3fac3: posts small blind 50
FDIBA2009: posts big blind 100
*** HOLE CARDS ***
s70n3fac3: folds 
Uncalled bet (50) returned to FDIBA2009
FDIBA2009 collected 100 from pot
FDIBA2009: doesn't show hand 
*** SUMMARY ***
Total pot 100 | Rake 0 
Seat 1: s70n3fac3 (button) (small blind) folded before Flop
Seat 2: FDIBA2009 (big blind) collected (100)



PokerStars Home Game Hand #227141412900: {Club #4781089}  Hold'em No Limit (50/100) - 2021/05/28 23:22:14 EET [2021/05/28 16:22:14 ET]
Table 'VTPP NLHE 2805' 2-max (Play Money) Seat #2 is the button
Seat 1: s70n3fac3 (8404 in chips) 
Seat 2: FDIBA2009 (14197 in chips) 
FDIBA2009: posts small blind 50
s70n3fac3: posts big blind 100
*** HOLE CARDS ***
FDIBA2009: raises 100 to 200
s70n3fac3: calls 100
*** FLOP *** [2s 2d Ad]
s70n3fac3: checks 
FDIBA2009: bets 250
s70n3fac3: calls 250
*** TURN *** [2s 2d Ad] [2c]
s70n3fac3: checks 
FDIBA2009: checks 
*** RIVER *** [2s 2d Ad 2c] [4d]
s70n3fac3: checks 
FDIBA2009: checks 
*** SHOW DOWN ***
s70n3fac3: shows [5s 3c] (a straight, Ace to Five)
FDIBA2009: mucks hand 
s70n3fac3 collected 850 from pot
*** SUMMARY ***
Total pot 900 | Rake 50 
Board [2s 2d Ad 2c 4d]
Seat 1: s70n3fac3 (big blind) showed [5s 3c] and won (850) with a straight, Ace to Five
Seat 2: FDIBA2009 (button) (small blind) mucked [Tc 7c]



PokerStars Home Game Hand #227141427192: {Club #4781089}  Hold'em No Limit (50/100) - 2021/05/28 23:22:40 EET [2021/05/28 16:22:40 ET]
Table 'VTPP NLHE 2805' 2-max (Play Money) Seat #1 is the button
Seat 1: s70n3fac3 (8804 in chips) 
Seat 2: FDIBA2009 (13747 in chips) 
s70n3fac3: posts small blind 50
FDIBA2009: posts big blind 100
*** HOLE CARDS ***
s70n3fac3: folds 
Uncalled bet (50) returned to FDIBA2009
FDIBA2009 collected 100 from pot
FDIBA2009: doesn't show hand 
*** SUMMARY ***
Total pot 100 | Rake 0 
Seat 1: s70n3fac3 (button) (small blind) folded before Flop
Seat 2: FDIBA2009 (big blind) collected (100)



PokerStars Home Game Hand #227141429611: {Club #4781089}  Hold'em No Limit (50/100) - 2021/05/28 23:22:44 EET [2021/05/28 16:22:44 ET]
Table 'VTPP NLHE 2805' 2-max (Play Money) Seat #2 is the button
Seat 1: s70n3fac3 (8754 in chips) 
Seat 2: FDIBA2009 (13797 in chips) 
FDIBA2009: posts small blind 50
s70n3fac3: posts big blind 100
*** HOLE CARDS ***
FDIBA2009: raises 100 to 200
s70n3fac3: calls 100
*** FLOP *** [Kh Ac 6d]
s70n3fac3: checks 
FDIBA2009: bets 200
s70n3fac3: calls 200
*** TURN *** [Kh Ac 6d] [Ah]
s70n3fac3: checks 
FDIBA2009: bets 600
s70n3fac3: folds 
Uncalled bet (600) returned to FDIBA2009
FDIBA2009 collected 756 from pot
FDIBA2009: doesn't show hand 
*** SUMMARY ***
Total pot 800 | Rake 44 
Board [Kh Ac 6d Ah]
Seat 1: s70n3fac3 (big blind) folded on the Turn
Seat 2: FDIBA2009 (button) (small blind) collected (756)



PokerStars Home Game Hand #227141449235: {Club #4781089}  Hold'em No Limit (50/100) - 2021/05/28 23:23:19 EET [2021/05/28 16:23:19 ET]
Table 'VTPP NLHE 2805' 2-max (Play Money) Seat #1 is the button
Seat 1: s70n3fac3 (8354 in chips) 
Seat 2: FDIBA2009 (14153 in chips) 
s70n3fac3: posts small blind 50
FDIBA2009: posts big blind 100
*** HOLE CARDS ***
s70n3fac3: folds 
Uncalled bet (50) returned to FDIBA2009
FDIBA2009 collected 100 from pot
FDIBA2009: doesn't show hand 
*** SUMMARY ***
Total pot 100 | Rake 0 
Seat 1: s70n3fac3 (button) (small blind) folded before Flop
Seat 2: FDIBA2009 (big blind) collected (100)



PokerStars Home Game Hand #227141455184: {Club #4781089}  Hold'em No Limit (50/100) - 2021/05/28 23:23:30 EET [2021/05/28 16:23:30 ET]
Table 'VTPP NLHE 2805' 2-max (Play Money) Seat #2 is the button
Seat 1: s70n3fac3 (8304 in chips) 
Seat 2: FDIBA2009 (14203 in chips) 
FDIBA2009: posts small blind 50
s70n3fac3: posts big blind 100
*** HOLE CARDS ***
FDIBA2009: raises 100 to 200
s70n3fac3: calls 100
*** FLOP *** [Qc 6c Kc]
s70n3fac3: checks 
FDIBA2009: checks 
*** TURN *** [Qc 6c Kc] [4h]
s70n3fac3: bets 200
FDIBA2009: calls 200
*** RIVER *** [Qc 6c Kc 4h] [3s]
s70n3fac3: bets 600
FDIBA2009: folds 
Uncalled bet (600) returned to s70n3fac3
s70n3fac3 collected 756 from pot
s70n3fac3: doesn't show hand 
*** SUMMARY ***
Total pot 800 | Rake 44 
Board [Qc 6c Kc 4h 3s]
Seat 1: s70n3fac3 (big blind) collected (756)
Seat 2: FDIBA2009 (button) (small blind) folded on the River



PokerStars Home Game Hand #227141471079: {Club #4781089}  Hold'em No Limit (50/100) - 2021/05/28 23:23:59 EET [2021/05/28 16:23:59 ET]
Table 'VTPP NLHE 2805' 2-max (Play Money) Seat #1 is the button
Seat 1: s70n3fac3 (8660 in chips) 
Seat 2: FDIBA2009 (13803 in chips) 
s70n3fac3: posts small blind 50
FDIBA2009: posts big blind 100
*** HOLE CARDS ***
s70n3fac3: raises 100 to 200
FDIBA2009: calls 100
*** FLOP *** [3h Ac 5h]
FDIBA2009: checks 
s70n3fac3: bets 200
FDIBA2009: raises 600 to 800
s70n3fac3: folds 
Uncalled bet (600) returned to FDIBA2009
FDIBA2009 collected 756 from pot
FDIBA2009: doesn't show hand 
*** SUMMARY ***
Total pot 800 | Rake 44 
Board [3h Ac 5h]
Seat 1: s70n3fac3 (button) (small blind) folded on the Flop
Seat 2: FDIBA2009 (big blind) collected (756)



PokerStars Home Game Hand #227141485865: {Club #4781089}  Hold'em No Limit (50/100) - 2021/05/28 23:24:25 EET [2021/05/28 16:24:25 ET]
Table 'VTPP NLHE 2805' 2-max (Play Money) Seat #2 is the button
Seat 1: s70n3fac3 (8260 in chips) 
Seat 2: FDIBA2009 (14159 in chips) 
FDIBA2009: posts small blind 50
s70n3fac3: posts big blind 100
*** HOLE CARDS ***
FDIBA2009: raises 100 to 200
s70n3fac3: calls 100
*** FLOP *** [7s 3d Ts]
s70n3fac3: checks 
FDIBA2009: checks 
*** TURN *** [7s 3d Ts] [Kc]
s70n3fac3: checks 
FDIBA2009: bets 250
s70n3fac3: calls 250
*** RIVER *** [7s 3d Ts Kc] [6d]
s70n3fac3: checks 
FDIBA2009: checks 
*** SHOW DOWN ***
s70n3fac3: shows [2s 6s] (a pair of Sixes)
FDIBA2009: mucks hand 
s70n3fac3 collected 850 from pot
*** SUMMARY ***
Total pot 900 | Rake 50 
Board [7s 3d Ts Kc 6d]
Seat 1: s70n3fac3 (big blind) showed [2s 6s] and won (850) with a pair of Sixes
Seat 2: FDIBA2009 (button) (small blind) mucked [2c 8s]



PokerStars Home Game Hand #227141500514: {Club #4781089}  Hold'em No Limit (50/100) - 2021/05/28 23:24:51 EET [2021/05/28 16:24:51 ET]
Table 'VTPP NLHE 2805' 2-max (Play Money) Seat #1 is the button
Seat 1: s70n3fac3 (8660 in chips) 
Seat 2: FDIBA2009 (13709 in chips) 
s70n3fac3: posts small blind 50
FDIBA2009: posts big blind 100
*** HOLE CARDS ***
s70n3fac3: raises 150 to 250
FDIBA2009: folds 
Uncalled bet (150) returned to s70n3fac3
s70n3fac3 collected 200 from pot
s70n3fac3: doesn't show hand 
*** SUMMARY ***
Total pot 200 | Rake 0 
Seat 1: s70n3fac3 (button) (small blind) collected (200)
Seat 2: FDIBA2009 (big blind) folded before Flop



PokerStars Home Game Hand #227141505581: {Club #4781089}  Hold'em No Limit (50/100) - 2021/05/28 23:25:01 EET [2021/05/28 16:25:01 ET]
Table 'VTPP NLHE 2805' 2-max (Play Money) Seat #2 is the button
Seat 1: s70n3fac3 (8760 in chips) 
Seat 2: FDIBA2009 (13609 in chips) 
FDIBA2009: posts small blind 50
s70n3fac3: posts big blind 100
*** HOLE CARDS ***
FDIBA2009: raises 100 to 200
s70n3fac3: folds 
Uncalled bet (100) returned to FDIBA2009
FDIBA2009 collected 200 from pot
FDIBA2009: doesn't show hand 
*** SUMMARY ***
Total pot 200 | Rake 0 
Seat 1: s70n3fac3 (big blind) folded before Flop
Seat 2: FDIBA2009 (button) (small blind) collected (200)



PokerStars Home Game Hand #227141510126: {Club #4781089}  Hold'em No Limit (50/100) - 2021/05/28 23:25:09 EET [2021/05/28 16:25:09 ET]
Table 'VTPP NLHE 2805' 2-max (Play Money) Seat #1 is the button
Seat 1: s70n3fac3 (8660 in chips) 
Seat 2: FDIBA2009 (13709 in chips) 
s70n3fac3: posts small blind 50
FDIBA2009: posts big blind 100
*** HOLE CARDS ***
s70n3fac3: raises 200 to 300
FDIBA2009: calls 200
*** FLOP *** [7h Ks 8d]
FDIBA2009: checks 
s70n3fac3: checks 
*** TURN *** [7h Ks 8d] [4c]
FDIBA2009: checks 
s70n3fac3: bets 300
FDIBA2009: folds 
Uncalled bet (300) returned to s70n3fac3
s70n3fac3 collected 567 from pot
s70n3fac3: doesn't show hand 
*** SUMMARY ***
Total pot 600 | Rake 33 
Board [7h Ks 8d 4c]
Seat 1: s70n3fac3 (button) (small blind) collected (567)
Seat 2: FDIBA2009 (big blind) folded on the Turn



PokerStars Home Game Hand #227141534313: {Club #4781089}  Hold'em No Limit (50/100) - 2021/05/28 23:25:37 EET [2021/05/28 16:25:37 ET]
Table 'VTPP NLHE 2805' 2-max (Play Money) Seat #2 is the button
Seat 1: s70n3fac3 (8927 in chips) 
Seat 2: FDIBA2009 (13409 in chips) 
FDIBA2009: posts small blind 50
s70n3fac3: posts big blind 100
*** HOLE CARDS ***
FDIBA2009: raises 100 to 200
s70n3fac3: folds 
Uncalled bet (100) returned to FDIBA2009
FDIBA2009 collected 200 from pot
FDIBA2009: doesn't show hand 
*** SUMMARY ***
Total pot 200 | Rake 0 
Seat 1: s70n3fac3 (big blind) folded before Flop
Seat 2: FDIBA2009 (button) (small blind) collected (200)



PokerStars Home Game Hand #227141538644: {Club #4781089}  Hold'em No Limit (50/100) - 2021/05/28 23:25:45 EET [2021/05/28 16:25:45 ET]
Table 'VTPP NLHE 2805' 2-max (Play Money) Seat #1 is the button
Seat 1: s70n3fac3 (8827 in chips) 
Seat 2: FDIBA2009 (13509 in chips) 
s70n3fac3: posts small blind 50
FDIBA2009: posts big blind 100
*** HOLE CARDS ***
s70n3fac3: raises 150 to 250
FDIBA2009: calls 150
*** FLOP *** [Kd 3d Js]
FDIBA2009: bets 300
s70n3fac3: folds 
Uncalled bet (300) returned to FDIBA2009
FDIBA2009 collected 472 from pot
FDIBA2009: doesn't show hand 
*** SUMMARY ***
Total pot 500 | Rake 28 
Board [Kd 3d Js]
Seat 1: s70n3fac3 (button) (small blind) folded on the Flop
Seat 2: FDIBA2009 (big blind) collected (472)



PokerStars Home Game Hand #227141554009: {Club #4781089}  Hold'em No Limit (50/100) - 2021/05/28 23:26:13 EET [2021/05/28 16:26:13 ET]
Table 'VTPP NLHE 2805' 2-max (Play Money) Seat #2 is the button
Seat 1: s70n3fac3 (8577 in chips) 
Seat 2: FDIBA2009 (13731 in chips) 
FDIBA2009: posts small blind 50
s70n3fac3: posts big blind 100
*** HOLE CARDS ***
FDIBA2009: raises 100 to 200
s70n3fac3: raises 400 to 600
FDIBA2009: calls 400
*** FLOP *** [4d 8d Kc]
s70n3fac3: checks 
FDIBA2009: checks 
*** TURN *** [4d 8d Kc] [2h]
s70n3fac3: bets 600
FDIBA2009: calls 600
*** RIVER *** [4d 8d Kc 2h] [9c]
s70n3fac3: bets 1550
FDIBA2009: calls 1550
*** SHOW DOWN ***
s70n3fac3: shows [7c Ac] (high card Ace)
FDIBA2009: shows [6s 4s] (a pair of Fours)
FDIBA2009 collected 5197 from pot
*** SUMMARY ***
Total pot 5500 | Rake 303 
Board [4d 8d Kc 2h 9c]
Seat 1: s70n3fac3 (big blind) showed [7c Ac] and lost with high card Ace
Seat 2: FDIBA2009 (button) (small blind) showed [6s 4s] and won (5197) with a pair of Fours



PokerStars Home Game Hand #227141586498: {Club #4781089}  Hold'em No Limit (50/100) - 2021/05/28 23:27:11 EET [2021/05/28 16:27:11 ET]
Table 'VTPP NLHE 2805' 2-max (Play Money) Seat #1 is the button
Seat 1: s70n3fac3 (5827 in chips) 
Seat 2: FDIBA2009 (16178 in chips) 
s70n3fac3: posts small blind 50
FDIBA2009: posts big blind 100
*** HOLE CARDS ***
s70n3fac3: folds 
Uncalled bet (50) returned to FDIBA2009
FDIBA2009 collected 100 from pot
FDIBA2009: doesn't show hand 
*** SUMMARY ***
Total pot 100 | Rake 0 
Seat 1: s70n3fac3 (button) (small blind) folded before Flop
Seat 2: FDIBA2009 (big blind) collected (100)



PokerStars Home Game Hand #227141589626: {Club #4781089}  Hold'em No Limit (50/100) - 2021/05/28 23:27:17 EET [2021/05/28 16:27:17 ET]
Table 'VTPP NLHE 2805' 2-max (Play Money) Seat #2 is the button
Seat 1: s70n3fac3 (5777 in chips) 
Seat 2: FDIBA2009 (16228 in chips) 
FDIBA2009: posts small blind 50
s70n3fac3: posts big blind 100
*** HOLE CARDS ***
FDIBA2009: raises 100 to 200
s70n3fac3: calls 100
*** FLOP *** [Ks Qh 6c]
s70n3fac3: checks 
FDIBA2009: bets 200
s70n3fac3: folds 
Uncalled bet (200) returned to FDIBA2009
FDIBA2009 collected 378 from pot
FDIBA2009: doesn't show hand 
*** SUMMARY ***
Total pot 400 | Rake 22 
Board [Ks Qh 6c]
Seat 1: s70n3fac3 (big blind) folded on the Flop
Seat 2: FDIBA2009 (button) (small blind) collected (378)



PokerStars Home Game Hand #227141600638: {Club #4781089}  Hold'em No Limit (50/100) - 2021/05/28 23:27:37 EET [2021/05/28 16:27:37 ET]
Table 'VTPP NLHE 2805' 2-max (Play Money) Seat #1 is the button
Seat 1: s70n3fac3 (5577 in chips) 
Seat 2: FDIBA2009 (16406 in chips) 
s70n3fac3: posts small blind 50
FDIBA2009: posts big blind 100
*** HOLE CARDS ***
s70n3fac3: raises 150 to 250
FDIBA2009: calls 150
*** FLOP *** [Kc Th 8c]
FDIBA2009: checks 
s70n3fac3: bets 300
FDIBA2009: folds 
Uncalled bet (300) returned to s70n3fac3
s70n3fac3 collected 472 from pot
s70n3fac3: doesn't show hand 
*** SUMMARY ***
Total pot 500 | Rake 28 
Board [Kc Th 8c]
Seat 1: s70n3fac3 (button) (small blind) collected (472)
Seat 2: FDIBA2009 (big blind) folded on the Flop



PokerStars Home Game Hand #227141607917: {Club #4781089}  Hold'em No Limit (50/100) - 2021/05/28 23:27:50 EET [2021/05/28 16:27:50 ET]
Table 'VTPP NLHE 2805' 2-max (Play Money) Seat #2 is the button
Seat 1: s70n3fac3 (5799 in chips) 
Seat 2: FDIBA2009 (16156 in chips) 
FDIBA2009: posts small blind 50
s70n3fac3: posts big blind 100
*** HOLE CARDS ***
FDIBA2009: raises 100 to 200
s70n3fac3: folds 
Uncalled bet (100) returned to FDIBA2009
FDIBA2009 collected 200 from pot
FDIBA2009: doesn't show hand 
*** SUMMARY ***
Total pot 200 | Rake 0 
Seat 1: s70n3fac3 (big blind) folded before Flop
Seat 2: FDIBA2009 (button) (small blind) collected (200)



PokerStars Home Game Hand #227141611254: {Club #4781089}  Hold'em No Limit (50/100) - 2021/05/28 23:27:56 EET [2021/05/28 16:27:56 ET]
Table 'VTPP NLHE 2805' 2-max (Play Money) Seat #1 is the button
Seat 1: s70n3fac3 (5699 in chips) 
Seat 2: FDIBA2009 (16256 in chips) 
s70n3fac3: posts small blind 50
FDIBA2009: posts big blind 100
*** HOLE CARDS ***
s70n3fac3: raises 150 to 250
FDIBA2009: folds 
Uncalled bet (150) returned to s70n3fac3
s70n3fac3 collected 200 from pot
s70n3fac3: doesn't show hand 
*** SUMMARY ***
Total pot 200 | Rake 0 
Seat 1: s70n3fac3 (button) (small blind) collected (200)
Seat 2: FDIBA2009 (big blind) folded before Flop



PokerStars Home Game Hand #227141614482: {Club #4781089}  Hold'em No Limit (50/100) - 2021/05/28 23:28:02 EET [2021/05/28 16:28:02 ET]
Table 'VTPP NLHE 2805' 2-max (Play Money) Seat #2 is the button
Seat 1: s70n3fac3 (5799 in chips) 
Seat 2: FDIBA2009 (16156 in chips) 
FDIBA2009: posts small blind 50
s70n3fac3: posts big blind 100
*** HOLE CARDS ***
FDIBA2009: raises 100 to 200
s70n3fac3: calls 100
*** FLOP *** [2h 4c 4h]
s70n3fac3: checks 
FDIBA2009: checks 
*** TURN *** [2h 4c 4h] [6d]
s70n3fac3: checks 
FDIBA2009: checks 
*** RIVER *** [2h 4c 4h 6d] [4s]
s70n3fac3: checks 
FDIBA2009: checks 
*** SHOW DOWN ***
s70n3fac3: shows [2c Jc] (a full house, Fours full of Deuces)
FDIBA2009: mucks hand 
s70n3fac3 collected 378 from pot
*** SUMMARY ***
Total pot 400 | Rake 22 
Board [2h 4c 4h 6d 4s]
Seat 1: s70n3fac3 (big blind) showed [2c Jc] and won (378) with a full house, Fours full of Deuces
Seat 2: FDIBA2009 (button) (small blind) mucked [Jh Ad]



PokerStars Home Game Hand #227141626847: {Club #4781089}  Hold'em No Limit (50/100) - 2021/05/28 23:28:24 EET [2021/05/28 16:28:24 ET]
Table 'VTPP NLHE 2805' 2-max (Play Money) Seat #1 is the button
Seat 1: s70n3fac3 (5977 in chips) 
Seat 2: FDIBA2009 (15956 in chips) 
s70n3fac3: posts small blind 50
FDIBA2009: posts big blind 100
*** HOLE CARDS ***
s70n3fac3: calls 50
FDIBA2009: checks 
*** FLOP *** [4c Ts 5c]
FDIBA2009: checks 
s70n3fac3: checks 
*** TURN *** [4c Ts 5c] [4d]
FDIBA2009: bets 189
s70n3fac3: folds 
Uncalled bet (189) returned to FDIBA2009
FDIBA2009 collected 189 from pot
FDIBA2009: doesn't show hand 
*** SUMMARY ***
Total pot 200 | Rake 11 
Board [4c Ts 5c 4d]
Seat 1: s70n3fac3 (button) (small blind) folded on the Turn
Seat 2: FDIBA2009 (big blind) collected (189)



PokerStars Home Game Hand #227141635952: {Club #4781089}  Hold'em No Limit (50/100) - 2021/05/28 23:28:41 EET [2021/05/28 16:28:41 ET]
Table 'VTPP NLHE 2805' 2-max (Play Money) Seat #2 is the button
Seat 1: s70n3fac3 (5877 in chips) 
Seat 2: FDIBA2009 (16045 in chips) 
FDIBA2009: posts small blind 50
s70n3fac3: posts big blind 100
*** HOLE CARDS ***
FDIBA2009: raises 100 to 200
s70n3fac3: folds 
Uncalled bet (100) returned to FDIBA2009
FDIBA2009 collected 200 from pot
FDIBA2009: doesn't show hand 
*** SUMMARY ***
Total pot 200 | Rake 0 
Seat 1: s70n3fac3 (big blind) folded before Flop
Seat 2: FDIBA2009 (button) (small blind) collected (200)



PokerStars Home Game Hand #227141640114: {Club #4781089}  Hold'em No Limit (50/100) - 2021/05/28 23:28:48 EET [2021/05/28 16:28:48 ET]
Table 'VTPP NLHE 2805' 2-max (Play Money) Seat #1 is the button
Seat 1: s70n3fac3 (5777 in chips) 
Seat 2: FDIBA2009 (16145 in chips) 
s70n3fac3: posts small blind 50
FDIBA2009: posts big blind 100
*** HOLE CARDS ***
s70n3fac3: folds 
Uncalled bet (50) returned to FDIBA2009
FDIBA2009 collected 100 from pot
FDIBA2009: doesn't show hand 
*** SUMMARY ***
Total pot 100 | Rake 0 
Seat 1: s70n3fac3 (button) (small blind) folded before Flop
Seat 2: FDIBA2009 (big blind) collected (100)



PokerStars Home Game Hand #227141642039: {Club #4781089}  Hold'em No Limit (50/100) - 2021/05/28 23:28:52 EET [2021/05/28 16:28:52 ET]
Table 'VTPP NLHE 2805' 2-max (Play Money) Seat #2 is the button
Seat 1: s70n3fac3 (5727 in chips) 
Seat 2: FDIBA2009 (16195 in chips) 
FDIBA2009: posts small blind 50
s70n3fac3: posts big blind 100
*** HOLE CARDS ***
FDIBA2009: raises 100 to 200
s70n3fac3: calls 100
*** FLOP *** [9d 8h Ad]
s70n3fac3: checks 
FDIBA2009: checks 
*** TURN *** [9d 8h Ad] [6h]
s70n3fac3: bets 200
FDIBA2009: calls 200
*** RIVER *** [9d 8h Ad 6h] [5s]
s70n3fac3: checks 
FDIBA2009: bets 450
s70n3fac3: folds 
Uncalled bet (450) returned to FDIBA2009
FDIBA2009 collected 756 from pot
FDIBA2009: doesn't show hand 
*** SUMMARY ***
Total pot 800 | Rake 44 
Board [9d 8h Ad 6h 5s]
Seat 1: s70n3fac3 (big blind) folded on the River
Seat 2: FDIBA2009 (button) (small blind) collected (756)



PokerStars Home Game Hand #227141658632: {Club #4781089}  Hold'em No Limit (50/100) - 2021/05/28 23:29:22 EET [2021/05/28 16:29:22 ET]
Table 'VTPP NLHE 2805' 2-max (Play Money) Seat #1 is the button
Seat 1: s70n3fac3 (5327 in chips) 
Seat 2: FDIBA2009 (16551 in chips) 
s70n3fac3: posts small blind 50
FDIBA2009: posts big blind 100
*** HOLE CARDS ***
s70n3fac3: raises 150 to 250
FDIBA2009: folds 
Uncalled bet (150) returned to s70n3fac3
s70n3fac3 collected 200 from pot
s70n3fac3: doesn't show hand 
*** SUMMARY ***
Total pot 200 | Rake 0 
Seat 1: s70n3fac3 (button) (small blind) collected (200)
Seat 2: FDIBA2009 (big blind) folded before Flop



PokerStars Home Game Hand #227141662523: {Club #4781089}  Hold'em No Limit (50/100) - 2021/05/28 23:29:29 EET [2021/05/28 16:29:29 ET]
Table 'VTPP NLHE 2805' 2-max (Play Money) Seat #2 is the button
Seat 1: s70n3fac3 (5427 in chips) 
Seat 2: FDIBA2009 (16451 in chips) 
FDIBA2009: posts small blind 50
s70n3fac3: posts big blind 100
*** HOLE CARDS ***
FDIBA2009: raises 100 to 200
s70n3fac3: calls 100
*** FLOP *** [Kc As 8d]
s70n3fac3: checks 
FDIBA2009: checks 
*** TURN *** [Kc As 8d] [Ts]
s70n3fac3: bets 200
FDIBA2009: folds 
Uncalled bet (200) returned to s70n3fac3
s70n3fac3 collected 378 from pot
s70n3fac3: doesn't show hand 
*** SUMMARY ***
Total pot 400 | Rake 22 
Board [Kc As 8d Ts]
Seat 1: s70n3fac3 (big blind) collected (378)
Seat 2: FDIBA2009 (button) (small blind) folded on the Turn



PokerStars Home Game Hand #227141673521: {Club #4781089}  Hold'em No Limit (50/100) - 2021/05/28 23:29:49 EET [2021/05/28 16:29:49 ET]
Table 'VTPP NLHE 2805' 2-max (Play Money) Seat #1 is the button
Seat 1: s70n3fac3 (5605 in chips) 
Seat 2: FDIBA2009 (16251 in chips) 
s70n3fac3: posts small blind 50
FDIBA2009: posts big blind 100
*** HOLE CARDS ***
s70n3fac3: raises 100 to 200
FDIBA2009: calls 100
*** FLOP *** [Td 3c Ah]
FDIBA2009: checks 
s70n3fac3: bets 200
FDIBA2009: calls 200
*** TURN *** [Td 3c Ah] [8s]
FDIBA2009: checks 
s70n3fac3: checks 
*** RIVER *** [Td 3c Ah 8s] [5s]
FDIBA2009: bets 250
s70n3fac3: calls 250
*** SHOW DOWN ***
FDIBA2009: shows [2c Ac] (a pair of Aces)
s70n3fac3: mucks hand 
FDIBA2009 collected 1228 from pot
*** SUMMARY ***
Total pot 1300 | Rake 72 
Board [Td 3c Ah 8s 5s]
Seat 1: s70n3fac3 (button) (small blind) mucked [Qs 5d]
Seat 2: FDIBA2009 (big blind) showed [2c Ac] and won (1228) with a pair of Aces



PokerStars Home Game Hand #227141691757: {Club #4781089}  Hold'em No Limit (50/100) - 2021/05/28 23:30:21 EET [2021/05/28 16:30:21 ET]
Table 'VTPP NLHE 2805' 2-max (Play Money) Seat #2 is the button
Seat 1: s70n3fac3 (4955 in chips) 
Seat 2: FDIBA2009 (16829 in chips) 
FDIBA2009: posts small blind 50
s70n3fac3: posts big blind 100
*** HOLE CARDS ***
FDIBA2009: raises 100 to 200
s70n3fac3: calls 100
*** FLOP *** [Td 2s Ks]
s70n3fac3: checks 
FDIBA2009: checks 
*** TURN *** [Td 2s Ks] [Ts]
s70n3fac3: bets 200
FDIBA2009: calls 200
*** RIVER *** [Td 2s Ks Ts] [9h]
s70n3fac3: bets 400
FDIBA2009: calls 400
*** SHOW DOWN ***
s70n3fac3: shows [Qd 2d] (two pair, Tens and Deuces)
FDIBA2009: shows [Qs 9c] (two pair, Tens and Nines)
FDIBA2009 collected 1512 from pot
*** SUMMARY ***
Total pot 1600 | Rake 88 
Board [Td 2s Ks Ts 9h]
Seat 1: s70n3fac3 (big blind) showed [Qd 2d] and lost with two pair, Tens and Deuces
Seat 2: FDIBA2009 (button) (small blind) showed [Qs 9c] and won (1512) with two pair, Tens and Nines



PokerStars Home Game Hand #227141702363: {Club #4781089}  Hold'em No Limit (50/100) - 2021/05/28 23:30:41 EET [2021/05/28 16:30:41 ET]
Table 'VTPP NLHE 2805' 2-max (Play Money) Seat #1 is the button
Seat 1: s70n3fac3 (4155 in chips) 
Seat 2: FDIBA2009 (17541 in chips) 
s70n3fac3: posts small blind 50
FDIBA2009: posts big blind 100
*** HOLE CARDS ***
s70n3fac3: raises 150 to 250
FDIBA2009: folds 
Uncalled bet (150) returned to s70n3fac3
s70n3fac3 collected 200 from pot
s70n3fac3: doesn't show hand 
*** SUMMARY ***
Total pot 200 | Rake 0 
Seat 1: s70n3fac3 (button) (small blind) collected (200)
Seat 2: FDIBA2009 (big blind) folded before Flop



PokerStars Home Game Hand #227141705620: {Club #4781089}  Hold'em No Limit (50/100) - 2021/05/28 23:30:47 EET [2021/05/28 16:30:47 ET]
Table 'VTPP NLHE 2805' 2-max (Play Money) Seat #2 is the button
Seat 1: s70n3fac3 (4255 in chips) 
Seat 2: FDIBA2009 (17441 in chips) 
FDIBA2009: posts small blind 50
s70n3fac3: posts big blind 100
*** HOLE CARDS ***
FDIBA2009: raises 100 to 200
s70n3fac3: raises 400 to 600
FDIBA2009: folds 
Uncalled bet (400) returned to s70n3fac3
s70n3fac3 collected 400 from pot
s70n3fac3: doesn't show hand 
*** SUMMARY ***
Total pot 400 | Rake 0 
Seat 1: s70n3fac3 (big blind) collected (400)
Seat 2: FDIBA2009 (button) (small blind) folded before Flop



PokerStars Home Game Hand #227141710105: {Club #4781089}  Hold'em No Limit (50/100) - 2021/05/28 23:30:55 EET [2021/05/28 16:30:55 ET]
Table 'VTPP NLHE 2805' 2-max (Play Money) Seat #1 is the button
Seat 1: s70n3fac3 (4455 in chips) 
Seat 2: FDIBA2009 (17241 in chips) 
s70n3fac3: posts small blind 50
FDIBA2009: posts big blind 100
*** HOLE CARDS ***
s70n3fac3: raises 150 to 250
FDIBA2009: folds 
Uncalled bet (150) returned to s70n3fac3
s70n3fac3 collected 200 from pot
s70n3fac3: doesn't show hand 
*** SUMMARY ***
Total pot 200 | Rake 0 
Seat 1: s70n3fac3 (button) (small blind) collected (200)
Seat 2: FDIBA2009 (big blind) folded before Flop



PokerStars Home Game Hand #227141713761: {Club #4781089}  Hold'em No Limit (50/100) - 2021/05/28 23:31:01 EET [2021/05/28 16:31:01 ET]
Table 'VTPP NLHE 2805' 2-max (Play Money) Seat #2 is the button
Seat 1: s70n3fac3 (4555 in chips) 
Seat 2: FDIBA2009 (17141 in chips) 
FDIBA2009: posts small blind 50
s70n3fac3: posts big blind 100
*** HOLE CARDS ***
FDIBA2009: raises 100 to 200
s70n3fac3: calls 100
*** FLOP *** [2h 3c Ts]
s70n3fac3: checks 
FDIBA2009: bets 200
s70n3fac3: calls 200
*** TURN *** [2h 3c Ts] [4h]
s70n3fac3: checks 
FDIBA2009: bets 450
s70n3fac3: folds 
Uncalled bet (450) returned to FDIBA2009
FDIBA2009 collected 756 from pot
FDIBA2009: doesn't show hand 
*** SUMMARY ***
Total pot 800 | Rake 44 
Board [2h 3c Ts 4h]
Seat 1: s70n3fac3 (big blind) folded on the Turn
Seat 2: FDIBA2009 (button) (small blind) collected (756)



PokerStars Home Game Hand #227141732953: {Club #4781089}  Hold'em No Limit (50/100) - 2021/05/28 23:31:36 EET [2021/05/28 16:31:36 ET]
Table 'VTPP NLHE 2805' 2-max (Play Money) Seat #1 is the button
Seat 1: s70n3fac3 (9155 in chips) 
Seat 2: FDIBA2009 (17497 in chips) 
s70n3fac3: posts small blind 50
FDIBA2009: posts big blind 100
*** HOLE CARDS ***
s70n3fac3: folds 
Uncalled bet (50) returned to FDIBA2009
FDIBA2009 collected 100 from pot
FDIBA2009: doesn't show hand 
*** SUMMARY ***
Total pot 100 | Rake 0 
Seat 1: s70n3fac3 (button) (small blind) folded before Flop
Seat 2: FDIBA2009 (big blind) collected (100)



PokerStars Home Game Hand #227141735098: {Club #4781089}  Hold'em No Limit (50/100) - 2021/05/28 23:31:39 EET [2021/05/28 16:31:39 ET]
Table 'VTPP NLHE 2805' 2-max (Play Money) Seat #2 is the button
Seat 1: s70n3fac3 (9105 in chips) 
Seat 2: FDIBA2009 (17547 in chips) 
FDIBA2009: posts small blind 50
s70n3fac3: posts big blind 100
*** HOLE CARDS ***
FDIBA2009: raises 100 to 200
s70n3fac3: folds 
Uncalled bet (100) returned to FDIBA2009
FDIBA2009 collected 200 from pot
FDIBA2009: doesn't show hand 
*** SUMMARY ***
Total pot 200 | Rake 0 
Seat 1: s70n3fac3 (big blind) folded before Flop
Seat 2: FDIBA2009 (button) (small blind) collected (200)



PokerStars Home Game Hand #227141738880: {Club #4781089}  Hold'em No Limit (50/100) - 2021/05/28 23:31:46 EET [2021/05/28 16:31:46 ET]
Table 'VTPP NLHE 2805' 2-max (Play Money) Seat #1 is the button
Seat 1: s70n3fac3 (9005 in chips) 
Seat 2: FDIBA2009 (17647 in chips) 
s70n3fac3: posts small blind 50
FDIBA2009: posts big blind 100
*** HOLE CARDS ***
s70n3fac3: raises 150 to 250
FDIBA2009: calls 150
*** FLOP *** [8c Qd Jh]
FDIBA2009: checks 
s70n3fac3: bets 300
FDIBA2009: folds 
Uncalled bet (300) returned to s70n3fac3
s70n3fac3 collected 472 from pot
s70n3fac3: doesn't show hand 
*** SUMMARY ***
Total pot 500 | Rake 28 
Board [8c Qd Jh]
Seat 1: s70n3fac3 (button) (small blind) collected (472)
Seat 2: FDIBA2009 (big blind) folded on the Flop



PokerStars Home Game Hand #227141746636: {Club #4781089}  Hold'em No Limit (50/100) - 2021/05/28 23:32:00 EET [2021/05/28 16:32:00 ET]
Table 'VTPP NLHE 2805' 2-max (Play Money) Seat #2 is the button
Seat 1: s70n3fac3 (9227 in chips) 
Seat 2: FDIBA2009 (17397 in chips) 
FDIBA2009: posts small blind 50
s70n3fac3: posts big blind 100
*** HOLE CARDS ***
FDIBA2009: raises 100 to 200
s70n3fac3: calls 100
*** FLOP *** [2d 6s 6c]
s70n3fac3: checks 
FDIBA2009: bets 200
s70n3fac3: calls 200
*** TURN *** [2d 6s 6c] [Ts]
s70n3fac3: checks 
FDIBA2009: bets 450
s70n3fac3: folds 
Uncalled bet (450) returned to FDIBA2009
FDIBA2009 collected 756 from pot
FDIBA2009: doesn't show hand 
*** SUMMARY ***
Total pot 800 | Rake 44 
Board [2d 6s 6c Ts]
Seat 1: s70n3fac3 (big blind) folded on the Turn
Seat 2: FDIBA2009 (button) (small blind) collected (756)



PokerStars Home Game Hand #227141758068: {Club #4781089}  Hold'em No Limit (50/100) - 2021/05/28 23:32:21 EET [2021/05/28 16:32:21 ET]
Table 'VTPP NLHE 2805' 2-max (Play Money) Seat #1 is the button
Seat 1: s70n3fac3 (8827 in chips) 
Seat 2: FDIBA2009 (17753 in chips) 
s70n3fac3: posts small blind 50
FDIBA2009: posts big blind 100
*** HOLE CARDS ***
s70n3fac3: raises 150 to 250
FDIBA2009: calls 150
*** FLOP *** [Ad Ks 3s]
FDIBA2009: checks 
s70n3fac3: bets 300
FDIBA2009: folds 
Uncalled bet (300) returned to s70n3fac3
s70n3fac3 collected 472 from pot
s70n3fac3: doesn't show hand 
*** SUMMARY ***
Total pot 500 | Rake 28 
Board [Ad Ks 3s]
Seat 1: s70n3fac3 (button) (small blind) collected (472)
Seat 2: FDIBA2009 (big blind) folded on the Flop



PokerStars Home Game Hand #227141764746: {Club #4781089}  Hold'em No Limit (50/100) - 2021/05/28 23:32:33 EET [2021/05/28 16:32:33 ET]
Table 'VTPP NLHE 2805' 2-max (Play Money) Seat #2 is the button
Seat 1: s70n3fac3 (9049 in chips) 
Seat 2: FDIBA2009 (17503 in chips) 
FDIBA2009: posts small blind 50
s70n3fac3: posts big blind 100
*** HOLE CARDS ***
FDIBA2009: raises 100 to 200
s70n3fac3: raises 400 to 600
FDIBA2009: folds 
Uncalled bet (400) returned to s70n3fac3
s70n3fac3 collected 400 from pot
s70n3fac3: doesn't show hand 
*** SUMMARY ***
Total pot 400 | Rake 0 
Seat 1: s70n3fac3 (big blind) collected (400)
Seat 2: FDIBA2009 (button) (small blind) folded before Flop



PokerStars Home Game Hand #227141770530: {Club #4781089}  Hold'em No Limit (50/100) - 2021/05/28 23:32:43 EET [2021/05/28 16:32:43 ET]
Table 'VTPP NLHE 2805' 2-max (Play Money) Seat #1 is the button
Seat 1: s70n3fac3 (9249 in chips) 
Seat 2: FDIBA2009 (17303 in chips) 
s70n3fac3: posts small blind 50
FDIBA2009: posts big blind 100
*** HOLE CARDS ***
s70n3fac3: folds 
Uncalled bet (50) returned to FDIBA2009
FDIBA2009 collected 100 from pot
FDIBA2009: doesn't show hand 
*** SUMMARY ***
Total pot 100 | Rake 0 
Seat 1: s70n3fac3 (button) (small blind) folded before Flop
Seat 2: FDIBA2009 (big blind) collected (100)



PokerStars Home Game Hand #227141772527: {Club #4781089}  Hold'em No Limit (50/100) - 2021/05/28 23:32:47 EET [2021/05/28 16:32:47 ET]
Table 'VTPP NLHE 2805' 2-max (Play Money) Seat #2 is the button
Seat 1: s70n3fac3 (9199 in chips) 
Seat 2: FDIBA2009 (17353 in chips) 
FDIBA2009: posts small blind 50
s70n3fac3: posts big blind 100
*** HOLE CARDS ***
FDIBA2009: raises 100 to 200
s70n3fac3: calls 100
*** FLOP *** [4h Jd Js]
s70n3fac3: checks 
FDIBA2009: checks 
*** TURN *** [4h Jd Js] [9s]
s70n3fac3: checks 
FDIBA2009: checks 
*** RIVER *** [4h Jd Js 9s] [9d]
s70n3fac3: checks 
FDIBA2009: bets 100
s70n3fac3: calls 100
*** SHOW DOWN ***
FDIBA2009: shows [3h Kc] (two pair, Jacks and Nines)
s70n3fac3: shows [Ah 2c] (two pair, Jacks and Nines - Ace kicker)
s70n3fac3 collected 567 from pot
*** SUMMARY ***
Total pot 600 | Rake 33 
Board [4h Jd Js 9s 9d]
Seat 1: s70n3fac3 (big blind) showed [Ah 2c] and won (567) with two pair, Jacks and Nines
Seat 2: FDIBA2009 (button) (small blind) showed [3h Kc] and lost with two pair, Jacks and Nines



PokerStars Home Game Hand #227141783659: {Club #4781089}  Hold'em No Limit (50/100) - 2021/05/28 23:33:07 EET [2021/05/28 16:33:07 ET]
Table 'VTPP NLHE 2805' 2-max (Play Money) Seat #1 is the button
Seat 1: s70n3fac3 (9466 in chips) 
Seat 2: FDIBA2009 (17053 in chips) 
s70n3fac3: posts small blind 50
FDIBA2009: posts big blind 100
*** HOLE CARDS ***
s70n3fac3: raises 150 to 250
FDIBA2009: raises 300 to 550
s70n3fac3: calls 300
*** FLOP *** [3h 2s 8d]
FDIBA2009: bets 650
s70n3fac3: folds 
Uncalled bet (650) returned to FDIBA2009
FDIBA2009 collected 1039 from pot
FDIBA2009: doesn't show hand 
*** SUMMARY ***
Total pot 1100 | Rake 61 
Board [3h 2s 8d]
Seat 1: s70n3fac3 (button) (small blind) folded on the Flop
Seat 2: FDIBA2009 (big blind) collected (1039)



PokerStars Home Game Hand #227141798186: {Club #4781089}  Hold'em No Limit (50/100) - 2021/05/28 23:33:33 EET [2021/05/28 16:33:33 ET]
Table 'VTPP NLHE 2805' 2-max (Play Money) Seat #2 is the button
Seat 1: s70n3fac3 (8916 in chips) 
Seat 2: FDIBA2009 (17542 in chips) 
FDIBA2009: posts small blind 50
s70n3fac3: posts big blind 100
*** HOLE CARDS ***
FDIBA2009: raises 100 to 200
s70n3fac3: calls 100
*** FLOP *** [7c 5s Ad]
s70n3fac3: checks 
FDIBA2009: checks 
*** TURN *** [7c 5s Ad] [9c]
s70n3fac3: checks 
FDIBA2009: checks 
*** RIVER *** [7c 5s Ad 9c] [Kc]
s70n3fac3: checks 
FDIBA2009: bets 100
s70n3fac3: calls 100
*** SHOW DOWN ***
FDIBA2009: shows [Kd 4h] (a pair of Kings)
s70n3fac3: mucks hand 
FDIBA2009 collected 567 from pot
*** SUMMARY ***
Total pot 600 | Rake 33 
Board [7c 5s Ad 9c Kc]
Seat 1: s70n3fac3 (big blind) mucked [7s Ts]
Seat 2: FDIBA2009 (button) (small blind) showed [Kd 4h] and won (567) with a pair of Kings



PokerStars Home Game Hand #227141812106: {Club #4781089}  Hold'em No Limit (50/100) - 2021/05/28 23:33:58 EET [2021/05/28 16:33:58 ET]
Table 'VTPP NLHE 2805' 2-max (Play Money) Seat #1 is the button
Seat 1: s70n3fac3 (8616 in chips) 
Seat 2: FDIBA2009 (17809 in chips) 
s70n3fac3: posts small blind 50
FDIBA2009: posts big blind 100
*** HOLE CARDS ***
s70n3fac3: raises 150 to 250
FDIBA2009: folds 
Uncalled bet (150) returned to s70n3fac3
s70n3fac3 collected 200 from pot
s70n3fac3: doesn't show hand 
*** SUMMARY ***
Total pot 200 | Rake 0 
Seat 1: s70n3fac3 (button) (small blind) collected (200)
Seat 2: FDIBA2009 (big blind) folded before Flop



PokerStars Home Game Hand #227141815240: {Club #4781089}  Hold'em No Limit (50/100) - 2021/05/28 23:34:04 EET [2021/05/28 16:34:04 ET]
Table 'VTPP NLHE 2805' 2-max (Play Money) Seat #2 is the button
Seat 1: s70n3fac3 (8716 in chips) 
Seat 2: FDIBA2009 (17709 in chips) 
FDIBA2009: posts small blind 50
s70n3fac3: posts big blind 100
*** HOLE CARDS ***
FDIBA2009: raises 100 to 200
s70n3fac3: folds 
Uncalled bet (100) returned to FDIBA2009
FDIBA2009 collected 200 from pot
FDIBA2009: doesn't show hand 
*** SUMMARY ***
Total pot 200 | Rake 0 
Seat 1: s70n3fac3 (big blind) folded before Flop
Seat 2: FDIBA2009 (button) (small blind) collected (200)



PokerStars Home Game Hand #227141820240: {Club #4781089}  Hold'em No Limit (50/100) - 2021/05/28 23:34:13 EET [2021/05/28 16:34:13 ET]
Table 'VTPP NLHE 2805' 2-max (Play Money) Seat #1 is the button
Seat 1: s70n3fac3 (8616 in chips) 
Seat 2: FDIBA2009 (17809 in chips) 
s70n3fac3: posts small blind 50
FDIBA2009: posts big blind 100
*** HOLE CARDS ***
s70n3fac3: raises 150 to 250
FDIBA2009: folds 
Uncalled bet (150) returned to s70n3fac3
s70n3fac3 collected 200 from pot
s70n3fac3: doesn't show hand 
*** SUMMARY ***
Total pot 200 | Rake 0 
Seat 1: s70n3fac3 (button) (small blind) collected (200)
Seat 2: FDIBA2009 (big blind) folded before Flop



PokerStars Home Game Hand #227141823686: {Club #4781089}  Hold'em No Limit (50/100) - 2021/05/28 23:34:19 EET [2021/05/28 16:34:19 ET]
Table 'VTPP NLHE 2805' 2-max (Play Money) Seat #2 is the button
Seat 1: s70n3fac3 (8716 in chips) 
Seat 2: FDIBA2009 (17709 in chips) 
FDIBA2009: posts small blind 50
s70n3fac3: posts big blind 100
*** HOLE CARDS ***
FDIBA2009: raises 100 to 200
s70n3fac3: raises 400 to 600
FDIBA2009: calls 400
*** FLOP *** [Ah 4s Td]
s70n3fac3: bets 600
FDIBA2009: calls 600
*** TURN *** [Ah 4s Td] [9s]
s70n3fac3: bets 2425
FDIBA2009: folds 
Uncalled bet (2425) returned to s70n3fac3
s70n3fac3 collected 2268 from pot
s70n3fac3: doesn't show hand 
*** SUMMARY ***
Total pot 2400 | Rake 132 
Board [Ah 4s Td 9s]
Seat 1: s70n3fac3 (big blind) collected (2268)
Seat 2: FDIBA2009 (button) (small blind) folded on the Turn



PokerStars Home Game Hand #227141846094: {Club #4781089}  Hold'em No Limit (50/100) - 2021/05/28 23:35:00 EET [2021/05/28 16:35:00 ET]
Table 'VTPP NLHE 2805' 2-max (Play Money) Seat #1 is the button
Seat 1: s70n3fac3 (9784 in chips) 
Seat 2: FDIBA2009 (16509 in chips) 
s70n3fac3: posts small blind 50
FDIBA2009: posts big blind 100
*** HOLE CARDS ***
s70n3fac3: raises 150 to 250
FDIBA2009: calls 150
*** FLOP *** [Js 3h 9d]
FDIBA2009: checks 
s70n3fac3: bets 300
FDIBA2009: folds 
Uncalled bet (300) returned to s70n3fac3
s70n3fac3 collected 472 from pot
s70n3fac3: doesn't show hand 
*** SUMMARY ***
Total pot 500 | Rake 28 
Board [Js 3h 9d]
Seat 1: s70n3fac3 (button) (small blind) collected (472)
Seat 2: FDIBA2009 (big blind) folded on the Flop



PokerStars Home Game Hand #227141864853: {Club #4781089}  Hold'em No Limit (50/100) - 2021/05/28 23:35:17 EET [2021/05/28 16:35:17 ET]
Table 'VTPP NLHE 2805' 2-max (Play Money) Seat #2 is the button
Seat 1: s70n3fac3 (10006 in chips) 
Seat 2: FDIBA2009 (16259 in chips) 
FDIBA2009: posts small blind 50
s70n3fac3: posts big blind 100
*** HOLE CARDS ***
FDIBA2009: raises 100 to 200
s70n3fac3: folds 
Uncalled bet (100) returned to FDIBA2009
FDIBA2009 collected 200 from pot
FDIBA2009: doesn't show hand 
*** SUMMARY ***
Total pot 200 | Rake 0 
Seat 1: s70n3fac3 (big blind) folded before Flop
Seat 2: FDIBA2009 (button) (small blind) collected (200)



PokerStars Home Game Hand #227141868960: {Club #4781089}  Hold'em No Limit (50/100) - 2021/05/28 23:35:25 EET [2021/05/28 16:35:25 ET]
Table 'VTPP NLHE 2805' 2-max (Play Money) Seat #1 is the button
Seat 1: s70n3fac3 (9906 in chips) 
Seat 2: FDIBA2009 (16359 in chips) 
s70n3fac3: posts small blind 50
FDIBA2009: posts big blind 100
*** HOLE CARDS ***
s70n3fac3: raises 150 to 250
FDIBA2009: calls 150
*** FLOP *** [6c Ad Tc]
FDIBA2009: checks 
s70n3fac3: bets 300
FDIBA2009: calls 300
*** TURN *** [6c Ad Tc] [6h]
FDIBA2009: checks 
s70n3fac3: bets 700
FDIBA2009: calls 700
*** RIVER *** [6c Ad Tc 6h] [2h]
FDIBA2009: checks 
s70n3fac3: checks 
*** SHOW DOWN ***
FDIBA2009: shows [5c 6s] (three of a kind, Sixes)
s70n3fac3: mucks hand 
FDIBA2009 collected 2362 from pot
*** SUMMARY ***
Total pot 2500 | Rake 138 
Board [6c Ad Tc 6h 2h]
Seat 1: s70n3fac3 (button) (small blind) mucked [Kc Ks]
Seat 2: FDIBA2009 (big blind) showed [5c 6s] and won (2362) with three of a kind, Sixes



PokerStars Home Game Hand #227141889289: {Club #4781089}  Hold'em No Limit (50/100) - 2021/05/28 23:36:02 EET [2021/05/28 16:36:02 ET]
Table 'VTPP NLHE 2805' 2-max (Play Money) Seat #2 is the button
Seat 1: s70n3fac3 (8656 in chips) 
Seat 2: FDIBA2009 (17471 in chips) 
FDIBA2009: posts small blind 50
s70n3fac3: posts big blind 100
*** HOLE CARDS ***
FDIBA2009: raises 100 to 200
s70n3fac3: calls 100
*** FLOP *** [Jd Jc 3s]
s70n3fac3: checks 
FDIBA2009: bets 200
s70n3fac3: folds 
Uncalled bet (200) returned to FDIBA2009
FDIBA2009 collected 378 from pot
FDIBA2009: doesn't show hand 
*** SUMMARY ***
Total pot 400 | Rake 22 
Board [Jd Jc 3s]
Seat 1: s70n3fac3 (big blind) folded on the Flop
Seat 2: FDIBA2009 (button) (small blind) collected (378)



PokerStars Home Game Hand #227141898357: {Club #4781089}  Hold'em No Limit (50/100) - 2021/05/28 23:36:18 EET [2021/05/28 16:36:18 ET]
Table 'VTPP NLHE 2805' 2-max (Play Money) Seat #1 is the button
Seat 1: s70n3fac3 (8456 in chips) 
Seat 2: FDIBA2009 (17649 in chips) 
s70n3fac3: posts small blind 50
FDIBA2009: posts big blind 100
*** HOLE CARDS ***
s70n3fac3: raises 150 to 250
FDIBA2009: folds 
Uncalled bet (150) returned to s70n3fac3
s70n3fac3 collected 200 from pot
s70n3fac3: doesn't show hand 
*** SUMMARY ***
Total pot 200 | Rake 0 
Seat 1: s70n3fac3 (button) (small blind) collected (200)
Seat 2: FDIBA2009 (big blind) folded before Flop



PokerStars Home Game Hand #227141901608: {Club #4781089}  Hold'em No Limit (50/100) - 2021/05/28 23:36:24 EET [2021/05/28 16:36:24 ET]
Table 'VTPP NLHE 2805' 2-max (Play Money) Seat #2 is the button
Seat 1: s70n3fac3 (8556 in chips) 
Seat 2: FDIBA2009 (17549 in chips) 
FDIBA2009: posts small blind 50
s70n3fac3: posts big blind 100
*** HOLE CARDS ***
FDIBA2009: raises 100 to 200
s70n3fac3: folds 
Uncalled bet (100) returned to FDIBA2009
FDIBA2009 collected 200 from pot
FDIBA2009: doesn't show hand 
*** SUMMARY ***
Total pot 200 | Rake 0 
Seat 1: s70n3fac3 (big blind) folded before Flop
Seat 2: FDIBA2009 (button) (small blind) collected (200)



PokerStars Home Game Hand #227141906057: {Club #4781089}  Hold'em No Limit (50/100) - 2021/05/28 23:36:33 EET [2021/05/28 16:36:33 ET]
Table 'VTPP NLHE 2805' 2-max (Play Money) Seat #1 is the button
Seat 1: s70n3fac3 (8456 in chips) 
Seat 2: FDIBA2009 (17649 in chips) 
s70n3fac3: posts small blind 50
FDIBA2009: posts big blind 100
*** HOLE CARDS ***
s70n3fac3: raises 150 to 250
FDIBA2009: calls 150
*** FLOP *** [Ad 9s Tc]
FDIBA2009: checks 
s70n3fac3: bets 300
FDIBA2009: calls 300
*** TURN *** [Ad 9s Tc] [Ac]
FDIBA2009: checks 
s70n3fac3: bets 800
FDIBA2009: folds 
Uncalled bet (800) returned to s70n3fac3
s70n3fac3 collected 1039 from pot
s70n3fac3: doesn't show hand 
*** SUMMARY ***
Total pot 1100 | Rake 61 
Board [Ad 9s Tc Ac]
Seat 1: s70n3fac3 (button) (small blind) collected (1039)
Seat 2: FDIBA2009 (big blind) folded on the Turn



PokerStars Home Game Hand #227141920547: {Club #4781089}  Hold'em No Limit (50/100) - 2021/05/28 23:36:59 EET [2021/05/28 16:36:59 ET]
Table 'VTPP NLHE 2805' 2-max (Play Money) Seat #2 is the button
Seat 1: s70n3fac3 (8945 in chips) 
Seat 2: FDIBA2009 (17099 in chips) 
FDIBA2009: posts small blind 50
s70n3fac3: posts big blind 100
*** HOLE CARDS ***
FDIBA2009: raises 100 to 200
s70n3fac3: calls 100
*** FLOP *** [3s 7h Jc]
s70n3fac3: checks 
FDIBA2009: bets 200
s70n3fac3: folds 
Uncalled bet (200) returned to FDIBA2009
FDIBA2009 collected 378 from pot
FDIBA2009: doesn't show hand 
*** SUMMARY ***
Total pot 400 | Rake 22 
Board [3s 7h Jc]
Seat 1: s70n3fac3 (big blind) folded on the Flop
Seat 2: FDIBA2009 (button) (small blind) collected (378)



PokerStars Home Game Hand #227141928798: {Club #4781089}  Hold'em No Limit (50/100) - 2021/05/28 23:37:14 EET [2021/05/28 16:37:14 ET]
Table 'VTPP NLHE 2805' 2-max (Play Money) Seat #1 is the button
Seat 1: s70n3fac3 (8745 in chips) 
Seat 2: FDIBA2009 (17277 in chips) 
s70n3fac3: posts small blind 50
FDIBA2009: posts big blind 100
*** HOLE CARDS ***
s70n3fac3: raises 100 to 200
FDIBA2009: raises 100 to 300
s70n3fac3: calls 100
*** FLOP *** [9d 6d 9c]
FDIBA2009: checks 
s70n3fac3: checks 
*** TURN *** [9d 6d 9c] [Qh]
FDIBA2009: bets 300
s70n3fac3: folds 
Uncalled bet (300) returned to FDIBA2009
FDIBA2009 collected 567 from pot
FDIBA2009: doesn't show hand 
*** SUMMARY ***
Total pot 600 | Rake 33 
Board [9d 6d 9c Qh]
Seat 1: s70n3fac3 (button) (small blind) folded on the Turn
Seat 2: FDIBA2009 (big blind) collected (567)



PokerStars Home Game Hand #227141943519: {Club #4781089}  Hold'em No Limit (50/100) - 2021/05/28 23:37:41 EET [2021/05/28 16:37:41 ET]
Table 'VTPP NLHE 2805' 2-max (Play Money) Seat #2 is the button
Seat 1: s70n3fac3 (8445 in chips) 
Seat 2: FDIBA2009 (17544 in chips) 
FDIBA2009: posts small blind 50
s70n3fac3: posts big blind 100
*** HOLE CARDS ***
FDIBA2009: raises 100 to 200
s70n3fac3: folds 
Uncalled bet (100) returned to FDIBA2009
FDIBA2009 collected 200 from pot
FDIBA2009: doesn't show hand 
*** SUMMARY ***
Total pot 200 | Rake 0 
Seat 1: s70n3fac3 (big blind) folded before Flop
Seat 2: FDIBA2009 (button) (small blind) collected (200)



PokerStars Home Game Hand #227141948921: {Club #4781089}  Hold'em No Limit (50/100) - 2021/05/28 23:37:50 EET [2021/05/28 16:37:50 ET]
Table 'VTPP NLHE 2805' 2-max (Play Money) Seat #1 is the button
Seat 1: s70n3fac3 (8345 in chips) 
Seat 2: FDIBA2009 (17644 in chips) 
s70n3fac3: posts small blind 50
FDIBA2009: posts big blind 100
*** HOLE CARDS ***
s70n3fac3: raises 150 to 250
FDIBA2009: raises 150 to 400
s70n3fac3: calls 150
*** FLOP *** [3c 2h 8c]
FDIBA2009: bets 400
s70n3fac3: calls 400
*** TURN *** [3c 2h 8c] [7s]
FDIBA2009: checks 
s70n3fac3: bets 850
FDIBA2009: raises 3800 to 4650
s70n3fac3: folds 
Uncalled bet (3800) returned to FDIBA2009
FDIBA2009 collected 3118 from pot
FDIBA2009: doesn't show hand 
*** SUMMARY ***
Total pot 3300 | Rake 182 
Board [3c 2h 8c 7s]
Seat 1: s70n3fac3 (button) (small blind) folded on the Turn
Seat 2: FDIBA2009 (big blind) collected (3118)



PokerStars Home Game Hand #227141984597: {Club #4781089}  Hold'em No Limit (50/100) - 2021/05/28 23:38:56 EET [2021/05/28 16:38:56 ET]
Table 'VTPP NLHE 2805' 2-max (Play Money) Seat #2 is the button
Seat 1: s70n3fac3 (6695 in chips) 
Seat 2: FDIBA2009 (19112 in chips) 
FDIBA2009: posts small blind 50
s70n3fac3: posts big blind 100
*** HOLE CARDS ***
FDIBA2009: raises 100 to 200
s70n3fac3: calls 100
*** FLOP *** [7s Td 3s]
s70n3fac3: checks 
FDIBA2009: bets 200
s70n3fac3: calls 200
*** TURN *** [7s Td 3s] [3h]
s70n3fac3: checks 
FDIBA2009: checks 
*** RIVER *** [7s Td 3s 3h] [8d]
s70n3fac3: bets 800
FDIBA2009: folds 
Uncalled bet (800) returned to s70n3fac3
s70n3fac3 collected 756 from pot
s70n3fac3: doesn't show hand 
*** SUMMARY ***
Total pot 800 | Rake 44 
Board [7s Td 3s 3h 8d]
Seat 1: s70n3fac3 (big blind) collected (756)
Seat 2: FDIBA2009 (button) (small blind) folded on the River



PokerStars Home Game Hand #227141999806: {Club #4781089}  Hold'em No Limit (50/100) - 2021/05/28 23:39:23 EET [2021/05/28 16:39:23 ET]
Table 'VTPP NLHE 2805' 2-max (Play Money) Seat #1 is the button
Seat 1: s70n3fac3 (7051 in chips) 
Seat 2: FDIBA2009 (18712 in chips) 
s70n3fac3: posts small blind 50
FDIBA2009: posts big blind 100
*** HOLE CARDS ***
s70n3fac3: raises 150 to 250
FDIBA2009: calls 150
*** FLOP *** [Tc 5s 3h]
FDIBA2009: checks 
s70n3fac3: checks 
*** TURN *** [Tc 5s 3h] [Ad]
FDIBA2009: bets 300
s70n3fac3: folds 
Uncalled bet (300) returned to FDIBA2009
FDIBA2009 collected 472 from pot
FDIBA2009: doesn't show hand 
*** SUMMARY ***
Total pot 500 | Rake 28 
Board [Tc 5s 3h Ad]
Seat 1: s70n3fac3 (button) (small blind) folded on the Turn
Seat 2: FDIBA2009 (big blind) collected (472)



PokerStars Home Game Hand #227142011341: {Club #4781089}  Hold'em No Limit (50/100) - 2021/05/28 23:39:44 EET [2021/05/28 16:39:44 ET]
Table 'VTPP NLHE 2805' 2-max (Play Money) Seat #2 is the button
Seat 1: s70n3fac3 (6801 in chips) 
Seat 2: FDIBA2009 (18934 in chips) 
FDIBA2009: posts small blind 50
s70n3fac3: posts big blind 100
*** HOLE CARDS ***
FDIBA2009: raises 100 to 200
s70n3fac3: calls 100
*** FLOP *** [8s Ac 5d]
s70n3fac3: checks 
FDIBA2009: bets 200
s70n3fac3: calls 200
*** TURN *** [8s Ac 5d] [8h]
s70n3fac3: checks 
FDIBA2009: checks 
*** RIVER *** [8s Ac 5d 8h] [5c]
s70n3fac3: checks 
FDIBA2009: checks 
*** SHOW DOWN ***
s70n3fac3: shows [7c 9d] (two pair, Eights and Fives)
FDIBA2009: shows [Jh Kd] (two pair, Eights and Fives)
s70n3fac3 collected 378 from pot
FDIBA2009 collected 378 from pot
*** SUMMARY ***
Total pot 800 | Rake 44 
Board [8s Ac 5d 8h 5c]
Seat 1: s70n3fac3 (big blind) showed [7c 9d] and won (378) with two pair, Eights and Fives
Seat 2: FDIBA2009 (button) (small blind) showed [Jh Kd] and won (378) with two pair, Eights and Fives



PokerStars Home Game Hand #227142023944: {Club #4781089}  Hold'em No Limit (50/100) - 2021/05/28 23:40:07 EET [2021/05/28 16:40:07 ET]
Table 'VTPP NLHE 2805' 2-max (Play Money) Seat #1 is the button
Seat 1: s70n3fac3 (6779 in chips) 
Seat 2: FDIBA2009 (18912 in chips) 
s70n3fac3: posts small blind 50
FDIBA2009: posts big blind 100
*** HOLE CARDS ***
s70n3fac3: raises 150 to 250
FDIBA2009: calls 150
*** FLOP *** [9s 2c 7c]
FDIBA2009: checks 
s70n3fac3: checks 
*** TURN *** [9s 2c 7c] [7d]
FDIBA2009: bets 250
s70n3fac3: folds 
Uncalled bet (250) returned to FDIBA2009
FDIBA2009 collected 472 from pot
FDIBA2009: doesn't show hand 
*** SUMMARY ***
Total pot 500 | Rake 28 
Board [9s 2c 7c 7d]
Seat 1: s70n3fac3 (button) (small blind) folded on the Turn
Seat 2: FDIBA2009 (big blind) collected (472)



PokerStars Home Game Hand #227142033199: {Club #4781089}  Hold'em No Limit (50/100) - 2021/05/28 23:40:24 EET [2021/05/28 16:40:24 ET]
Table 'VTPP NLHE 2805' 2-max (Play Money) Seat #2 is the button
Seat 1: s70n3fac3 (6529 in chips) 
Seat 2: FDIBA2009 (19134 in chips) 
FDIBA2009: posts small blind 50
s70n3fac3: posts big blind 100
*** HOLE CARDS ***
FDIBA2009: raises 100 to 200
s70n3fac3: folds 
Uncalled bet (100) returned to FDIBA2009
FDIBA2009 collected 200 from pot
FDIBA2009: doesn't show hand 
*** SUMMARY ***
Total pot 200 | Rake 0 
Seat 1: s70n3fac3 (big blind) folded before Flop
Seat 2: FDIBA2009 (button) (small blind) collected (200)



PokerStars Home Game Hand #227142037010: {Club #4781089}  Hold'em No Limit (50/100) - 2021/05/28 23:40:31 EET [2021/05/28 16:40:31 ET]
Table 'VTPP NLHE 2805' 2-max (Play Money) Seat #1 is the button
Seat 1: s70n3fac3 (6429 in chips) 
Seat 2: FDIBA2009 (19234 in chips) 
s70n3fac3: posts small blind 50
FDIBA2009: posts big blind 100
*** HOLE CARDS ***
s70n3fac3: raises 150 to 250
FDIBA2009: folds 
Uncalled bet (150) returned to s70n3fac3
s70n3fac3 collected 200 from pot
s70n3fac3: doesn't show hand 
*** SUMMARY ***
Total pot 200 | Rake 0 
Seat 1: s70n3fac3 (button) (small blind) collected (200)
Seat 2: FDIBA2009 (big blind) folded before Flop



PokerStars Home Game Hand #227142042707: {Club #4781089}  Hold'em No Limit (50/100) - 2021/05/28 23:40:41 EET [2021/05/28 16:40:41 ET]
Table 'VTPP NLHE 2805' 2-max (Play Money) Seat #2 is the button
Seat 1: s70n3fac3 (6529 in chips) 
Seat 2: FDIBA2009 (19134 in chips) 
FDIBA2009: posts small blind 50
s70n3fac3: posts big blind 100
*** HOLE CARDS ***
FDIBA2009: raises 100 to 200
s70n3fac3: calls 100
*** FLOP *** [3s 3d 5d]
s70n3fac3: checks 
FDIBA2009: bets 200
s70n3fac3: folds 
Uncalled bet (200) returned to FDIBA2009
FDIBA2009 collected 378 from pot
FDIBA2009: doesn't show hand 
*** SUMMARY ***
Total pot 400 | Rake 22 
Board [3s 3d 5d]
Seat 1: s70n3fac3 (big blind) folded on the Flop
Seat 2: FDIBA2009 (button) (small blind) collected (378)



PokerStars Home Game Hand #227142051195: {Club #4781089}  Hold'em No Limit (50/100) - 2021/05/28 23:40:57 EET [2021/05/28 16:40:57 ET]
Table 'VTPP NLHE 2805' 2-max (Play Money) Seat #1 is the button
Seat 1: s70n3fac3 (6329 in chips) 
Seat 2: FDIBA2009 (19312 in chips) 
s70n3fac3: posts small blind 50
FDIBA2009: posts big blind 100
*** HOLE CARDS ***
s70n3fac3: raises 150 to 250
FDIBA2009: calls 150
*** FLOP *** [6h Kd Kc]
FDIBA2009: checks 
s70n3fac3: bets 300
FDIBA2009: folds 
Uncalled bet (300) returned to s70n3fac3
s70n3fac3 collected 472 from pot
s70n3fac3: doesn't show hand 
*** SUMMARY ***
Total pot 500 | Rake 28 
Board [6h Kd Kc]
Seat 1: s70n3fac3 (button) (small blind) collected (472)
Seat 2: FDIBA2009 (big blind) folded on the Flop



PokerStars Home Game Hand #227142060016: {Club #4781089}  Hold'em No Limit (50/100) - 2021/05/28 23:41:13 EET [2021/05/28 16:41:13 ET]
Table 'VTPP NLHE 2805' 2-max (Play Money) Seat #2 is the button
Seat 1: s70n3fac3 (6551 in chips) 
Seat 2: FDIBA2009 (19062 in chips) 
FDIBA2009: posts small blind 50
s70n3fac3: posts big blind 100
*** HOLE CARDS ***
FDIBA2009: raises 100 to 200
s70n3fac3: calls 100
*** FLOP *** [Tc Jd Js]
s70n3fac3: checks 
FDIBA2009: checks 
*** TURN *** [Tc Jd Js] [6s]
s70n3fac3: checks 
FDIBA2009: bets 200
s70n3fac3: folds 
Uncalled bet (200) returned to FDIBA2009
FDIBA2009 collected 378 from pot
FDIBA2009: doesn't show hand 
*** SUMMARY ***
Total pot 400 | Rake 22 
Board [Tc Jd Js 6s]
Seat 1: s70n3fac3 (big blind) folded on the Turn
Seat 2: FDIBA2009 (button) (small blind) collected (378)



PokerStars Home Game Hand #227142071535: {Club #4781089}  Hold'em No Limit (50/100) - 2021/05/28 23:41:34 EET [2021/05/28 16:41:34 ET]
Table 'VTPP NLHE 2805' 2-max (Play Money) Seat #1 is the button
Seat 1: s70n3fac3 (6351 in chips) 
Seat 2: FDIBA2009 (19240 in chips) 
s70n3fac3: posts small blind 50
FDIBA2009: posts big blind 100
*** HOLE CARDS ***
s70n3fac3: raises 150 to 250
FDIBA2009: raises 150 to 400
s70n3fac3: calls 150
*** FLOP *** [3h Ks 2c]
FDIBA2009: bets 450
s70n3fac3: calls 450
*** TURN *** [3h Ks 2c] [Jh]
FDIBA2009: checks 
s70n3fac3: bets 850
FDIBA2009: calls 850
*** RIVER *** [3h Ks 2c Jh] [Ad]
FDIBA2009: checks 
s70n3fac3: checks 
*** SHOW DOWN ***
FDIBA2009: shows [9s Jc] (a pair of Jacks)
s70n3fac3: shows [Kc 6c] (a pair of Kings)
s70n3fac3 collected 3213 from pot
*** SUMMARY ***
Total pot 3400 | Rake 187 
Board [3h Ks 2c Jh Ad]
Seat 1: s70n3fac3 (button) (small blind) showed [Kc 6c] and won (3213) with a pair of Kings
Seat 2: FDIBA2009 (big blind) showed [9s Jc] and lost with a pair of Jacks



PokerStars Home Game Hand #227142088545: {Club #4781089}  Hold'em No Limit (50/100) - 2021/05/28 23:42:05 EET [2021/05/28 16:42:05 ET]
Table 'VTPP NLHE 2805' 2-max (Play Money) Seat #2 is the button
Seat 1: s70n3fac3 (7864 in chips) 
Seat 2: FDIBA2009 (17540 in chips) 
FDIBA2009: posts small blind 50
s70n3fac3: posts big blind 100
*** HOLE CARDS ***
FDIBA2009: raises 100 to 200
s70n3fac3: calls 100
*** FLOP *** [6d Ts 7s]
s70n3fac3: checks 
FDIBA2009: bets 200
s70n3fac3: calls 200
*** TURN *** [6d Ts 7s] [3d]
s70n3fac3: checks 
FDIBA2009: bets 450
s70n3fac3: folds 
Uncalled bet (450) returned to FDIBA2009
FDIBA2009 collected 756 from pot
FDIBA2009: doesn't show hand 
*** SUMMARY ***
Total pot 800 | Rake 44 
Board [6d Ts 7s 3d]
Seat 1: s70n3fac3 (big blind) folded on the Turn
Seat 2: FDIBA2009 (button) (small blind) collected (756)



PokerStars Home Game Hand #227142101088: {Club #4781089}  Hold'em No Limit (50/100) - 2021/05/28 23:42:28 EET [2021/05/28 16:42:28 ET]
Table 'VTPP NLHE 2805' 2-max (Play Money) Seat #1 is the button
Seat 1: s70n3fac3 (7464 in chips) 
Seat 2: FDIBA2009 (17896 in chips) 
s70n3fac3: posts small blind 50
FDIBA2009: posts big blind 100
*** HOLE CARDS ***
s70n3fac3: raises 150 to 250
FDIBA2009: folds 
Uncalled bet (150) returned to s70n3fac3
s70n3fac3 collected 200 from pot
s70n3fac3: doesn't show hand 
*** SUMMARY ***
Total pot 200 | Rake 0 
Seat 1: s70n3fac3 (button) (small blind) collected (200)
Seat 2: FDIBA2009 (big blind) folded before Flop



PokerStars Home Game Hand #227142104226: {Club #4781089}  Hold'em No Limit (50/100) - 2021/05/28 23:42:34 EET [2021/05/28 16:42:34 ET]
Table 'VTPP NLHE 2805' 2-max (Play Money) Seat #2 is the button
Seat 1: s70n3fac3 (7564 in chips) 
Seat 2: FDIBA2009 (17796 in chips) 
FDIBA2009: posts small blind 50
s70n3fac3: posts big blind 100
*** HOLE CARDS ***
FDIBA2009: raises 100 to 200
s70n3fac3: calls 100
*** FLOP *** [6h 8c Kc]
s70n3fac3: checks 
FDIBA2009: checks 
*** TURN *** [6h 8c Kc] [Tc]
s70n3fac3: checks 
FDIBA2009: bets 250
s70n3fac3: calls 250
*** RIVER *** [6h 8c Kc Tc] [7s]
s70n3fac3: checks 
FDIBA2009: bets 650
s70n3fac3: calls 650
*** SHOW DOWN ***
FDIBA2009: shows [2d 5s] (high card King)
s70n3fac3: shows [9s 6s] (a straight, Six to Ten)
s70n3fac3 collected 2079 from pot
*** SUMMARY ***
Total pot 2200 | Rake 121 
Board [6h 8c Kc Tc 7s]
Seat 1: s70n3fac3 (big blind) showed [9s 6s] and won (2079) with a straight, Six to Ten
Seat 2: FDIBA2009 (button) (small blind) showed [2d 5s] and lost with high card King



PokerStars Home Game Hand #227142119096: {Club #4781089}  Hold'em No Limit (50/100) - 2021/05/28 23:43:01 EET [2021/05/28 16:43:01 ET]
Table 'VTPP NLHE 2805' 2-max (Play Money) Seat #1 is the button
Seat 1: s70n3fac3 (8543 in chips) 
Seat 2: FDIBA2009 (16696 in chips) 
s70n3fac3: posts small blind 50
FDIBA2009: posts big blind 100
*** HOLE CARDS ***
s70n3fac3: raises 150 to 250
FDIBA2009: folds 
Uncalled bet (150) returned to s70n3fac3
s70n3fac3 collected 200 from pot
s70n3fac3: doesn't show hand 
*** SUMMARY ***
Total pot 200 | Rake 0 
Seat 1: s70n3fac3 (button) (small blind) collected (200)
Seat 2: FDIBA2009 (big blind) folded before Flop



PokerStars Home Game Hand #227142125004: {Club #4781089}  Hold'em No Limit (50/100) - 2021/05/28 23:43:12 EET [2021/05/28 16:43:12 ET]
Table 'VTPP NLHE 2805' 2-max (Play Money) Seat #2 is the button
Seat 1: s70n3fac3 (8643 in chips) 
Seat 2: FDIBA2009 (16596 in chips) 
FDIBA2009: posts small blind 50
s70n3fac3: posts big blind 100
*** HOLE CARDS ***
FDIBA2009: raises 100 to 200
s70n3fac3: raises 400 to 600
FDIBA2009: calls 400
*** FLOP *** [8c Ac 6h]
s70n3fac3: checks 
FDIBA2009: checks 
*** TURN *** [8c Ac 6h] [6c]
s70n3fac3: checks 
FDIBA2009: bets 650
s70n3fac3: folds 
Uncalled bet (650) returned to FDIBA2009
FDIBA2009 collected 1134 from pot
FDIBA2009: doesn't show hand 
*** SUMMARY ***
Total pot 1200 | Rake 66 
Board [8c Ac 6h 6c]
Seat 1: s70n3fac3 (big blind) folded on the Turn
Seat 2: FDIBA2009 (button) (small blind) collected (1134)



PokerStars Home Game Hand #227142142506: {Club #4781089}  Hold'em No Limit (50/100) - 2021/05/28 23:43:44 EET [2021/05/28 16:43:44 ET]
Table 'VTPP NLHE 2805' 2-max (Play Money) Seat #1 is the button
Seat 1: s70n3fac3 (8043 in chips) 
Seat 2: FDIBA2009 (17130 in chips) 
s70n3fac3: posts small blind 50
FDIBA2009: posts big blind 100
*** HOLE CARDS ***
s70n3fac3: raises 150 to 250
FDIBA2009: calls 150
*** FLOP *** [2d 6d 5d]
FDIBA2009: checks 
s70n3fac3: checks 
*** TURN *** [2d 6d 5d] [3h]
FDIBA2009: bets 300
s70n3fac3: calls 300
*** RIVER *** [2d 6d 5d 3h] [5h]
FDIBA2009: checks 
s70n3fac3: bets 750
FDIBA2009: calls 750
*** SHOW DOWN ***
s70n3fac3: shows [Ah 5s] (three of a kind, Fives)
FDIBA2009: mucks hand 
s70n3fac3 collected 2457 from pot
*** SUMMARY ***
Total pot 2600 | Rake 143 
Board [2d 6d 5d 3h 5h]
Seat 1: s70n3fac3 (button) (small blind) showed [Ah 5s] and won (2457) with three of a kind, Fives
Seat 2: FDIBA2009 (big blind) mucked [Ks 6s]



PokerStars Home Game Hand #227142158320: {Club #4781089}  Hold'em No Limit (50/100) - 2021/05/28 23:44:13 EET [2021/05/28 16:44:13 ET]
Table 'VTPP NLHE 2805' 2-max (Play Money) Seat #2 is the button
Seat 1: s70n3fac3 (9200 in chips) 
Seat 2: FDIBA2009 (15830 in chips) 
FDIBA2009: posts small blind 50
s70n3fac3: posts big blind 100
*** HOLE CARDS ***
FDIBA2009: raises 100 to 200
s70n3fac3: raises 400 to 600
FDIBA2009: calls 400
*** FLOP *** [4h 8h Ah]
s70n3fac3: checks 
FDIBA2009: checks 
*** TURN *** [4h 8h Ah] [Qh]
s70n3fac3: bets 600
FDIBA2009: folds 
Uncalled bet (600) returned to s70n3fac3
s70n3fac3 collected 1134 from pot
s70n3fac3: doesn't show hand 
*** SUMMARY ***
Total pot 1200 | Rake 66 
Board [4h 8h Ah Qh]
Seat 1: s70n3fac3 (big blind) collected (1134)
Seat 2: FDIBA2009 (button) (small blind) folded on the Turn



PokerStars Home Game Hand #227142171780: {Club #4781089}  Hold'em No Limit (50/100) - 2021/05/28 23:44:38 EET [2021/05/28 16:44:38 ET]
Table 'VTPP NLHE 2805' 2-max (Play Money) Seat #1 is the button
Seat 1: s70n3fac3 (9734 in chips) 
Seat 2: FDIBA2009 (15230 in chips) 
s70n3fac3: posts small blind 50
FDIBA2009: posts big blind 100
*** HOLE CARDS ***
s70n3fac3: raises 150 to 250
FDIBA2009: calls 150
*** FLOP *** [Ac Qs Ks]
FDIBA2009: checks 
s70n3fac3: bets 300
FDIBA2009: folds 
Uncalled bet (300) returned to s70n3fac3
s70n3fac3 collected 472 from pot
s70n3fac3: doesn't show hand 
*** SUMMARY ***
Total pot 500 | Rake 28 
Board [Ac Qs Ks]
Seat 1: s70n3fac3 (button) (small blind) collected (472)
Seat 2: FDIBA2009 (big blind) folded on the Flop



PokerStars Home Game Hand #227142180036: {Club #4781089}  Hold'em No Limit (50/100) - 2021/05/28 23:44:53 EET [2021/05/28 16:44:53 ET]
Table 'VTPP NLHE 2805' 2-max (Play Money) Seat #2 is the button
Seat 1: s70n3fac3 (9956 in chips) 
Seat 2: FDIBA2009 (14980 in chips) 
FDIBA2009: posts small blind 50
s70n3fac3: posts big blind 100
*** HOLE CARDS ***
FDIBA2009: raises 100 to 200
s70n3fac3: calls 100
*** FLOP *** [3s Qc 6c]
s70n3fac3: checks 
FDIBA2009: checks 
*** TURN *** [3s Qc 6c] [5s]
s70n3fac3: checks 
FDIBA2009: bets 378
s70n3fac3: folds 
Uncalled bet (378) returned to FDIBA2009
FDIBA2009 collected 378 from pot
FDIBA2009: doesn't show hand 
*** SUMMARY ***
Total pot 400 | Rake 22 
Board [3s Qc 6c 5s]
Seat 1: s70n3fac3 (big blind) folded on the Turn
Seat 2: FDIBA2009 (button) (small blind) collected (378)



PokerStars Home Game Hand #227142197936: {Club #4781089}  Hold'em No Limit (50/100) - 2021/05/28 23:45:26 EET [2021/05/28 16:45:26 ET]
Table 'VTPP NLHE 2805' 2-max (Play Money) Seat #1 is the button
Seat 1: s70n3fac3 (9756 in chips) 
Seat 2: FDIBA2009 (15158 in chips) 
s70n3fac3: posts small blind 50
FDIBA2009: posts big blind 100
*** HOLE CARDS ***
s70n3fac3: raises 150 to 250
FDIBA2009: calls 150
*** FLOP *** [Qh 3d 5h]
FDIBA2009: checks 
s70n3fac3: bets 300
FDIBA2009: calls 300
*** TURN *** [Qh 3d 5h] [Kd]
FDIBA2009: checks 
s70n3fac3: checks 
*** RIVER *** [Qh 3d 5h Kd] [Jc]
FDIBA2009: checks 
s70n3fac3: checks 
*** SHOW DOWN ***
FDIBA2009: shows [As 3s] (a pair of Threes)
s70n3fac3: shows [6h 5d] (a pair of Fives)
s70n3fac3 collected 1039 from pot
*** SUMMARY ***
Total pot 1100 | Rake 61 
Board [Qh 3d 5h Kd Jc]
Seat 1: s70n3fac3 (button) (small blind) showed [6h 5d] and won (1039) with a pair of Fives
Seat 2: FDIBA2009 (big blind) showed [As 3s] and lost with a pair of Threes



PokerStars Home Game Hand #227142215975: {Club #4781089}  Hold'em No Limit (50/100) - 2021/05/28 23:45:59 EET [2021/05/28 16:45:59 ET]
Table 'VTPP NLHE 2805' 2-max (Play Money) Seat #2 is the button
Seat 1: s70n3fac3 (10245 in chips) 
Seat 2: FDIBA2009 (14608 in chips) 
FDIBA2009: posts small blind 50
s70n3fac3: posts big blind 100
*** HOLE CARDS ***
FDIBA2009: raises 100 to 200
s70n3fac3: calls 100
*** FLOP *** [Jh 7h 4d]
s70n3fac3: checks 
FDIBA2009: bets 200
s70n3fac3: folds 
Uncalled bet (200) returned to FDIBA2009
FDIBA2009 collected 378 from pot
FDIBA2009: doesn't show hand 
*** SUMMARY ***
Total pot 400 | Rake 22 
Board [Jh 7h 4d]
Seat 1: s70n3fac3 (big blind) folded on the Flop
Seat 2: FDIBA2009 (button) (small blind) collected (378)



PokerStars Home Game Hand #227142223506: {Club #4781089}  Hold'em No Limit (50/100) - 2021/05/28 23:46:12 EET [2021/05/28 16:46:12 ET]
Table 'VTPP NLHE 2805' 2-max (Play Money) Seat #1 is the button
Seat 1: s70n3fac3 (10045 in chips) 
Seat 2: FDIBA2009 (14786 in chips) 
s70n3fac3: posts small blind 50
FDIBA2009: posts big blind 100
*** HOLE CARDS ***
s70n3fac3: raises 150 to 250
FDIBA2009: calls 150
*** FLOP *** [2s Th 8c]
FDIBA2009: checks 
s70n3fac3: checks 
*** TURN *** [2s Th 8c] [6d]
FDIBA2009: checks 
s70n3fac3: checks 
*** RIVER *** [2s Th 8c 6d] [Ts]
FDIBA2009: bets 250
s70n3fac3: folds 
Uncalled bet (250) returned to FDIBA2009
FDIBA2009 collected 472 from pot
FDIBA2009: doesn't show hand 
*** SUMMARY ***
Total pot 500 | Rake 28 
Board [2s Th 8c 6d Ts]
Seat 1: s70n3fac3 (button) (small blind) folded on the River
Seat 2: FDIBA2009 (big blind) collected (472)



PokerStars Home Game Hand #227142236060: {Club #4781089}  Hold'em No Limit (50/100) - 2021/05/28 23:46:35 EET [2021/05/28 16:46:35 ET]
Table 'VTPP NLHE 2805' 2-max (Play Money) Seat #2 is the button
Seat 1: s70n3fac3 (9795 in chips) 
Seat 2: FDIBA2009 (15008 in chips) 
FDIBA2009: posts small blind 50
s70n3fac3: posts big blind 100
*** HOLE CARDS ***
FDIBA2009: raises 100 to 200
s70n3fac3: folds 
Uncalled bet (100) returned to FDIBA2009
FDIBA2009 collected 200 from pot
FDIBA2009: doesn't show hand 
*** SUMMARY ***
Total pot 200 | Rake 0 
Seat 1: s70n3fac3 (big blind) folded before Flop
Seat 2: FDIBA2009 (button) (small blind) collected (200)



PokerStars Home Game Hand #227142240523: {Club #4781089}  Hold'em No Limit (50/100) - 2021/05/28 23:46:43 EET [2021/05/28 16:46:43 ET]
Table 'VTPP NLHE 2805' 2-max (Play Money) Seat #1 is the button
Seat 1: s70n3fac3 (9695 in chips) 
Seat 2: FDIBA2009 (15108 in chips) 
s70n3fac3: posts small blind 50
FDIBA2009: posts big blind 100
*** HOLE CARDS ***
s70n3fac3: raises 150 to 250
FDIBA2009: folds 
Uncalled bet (150) returned to s70n3fac3
s70n3fac3 collected 200 from pot
s70n3fac3: doesn't show hand 
*** SUMMARY ***
Total pot 200 | Rake 0 
Seat 1: s70n3fac3 (button) (small blind) collected (200)
Seat 2: FDIBA2009 (big blind) folded before Flop



PokerStars Home Game Hand #227142246206: {Club #4781089}  Hold'em No Limit (50/100) - 2021/05/28 23:46:53 EET [2021/05/28 16:46:53 ET]
Table 'VTPP NLHE 2805' 2-max (Play Money) Seat #2 is the button
Seat 1: s70n3fac3 (9795 in chips) 
Seat 2: FDIBA2009 (15008 in chips) 
FDIBA2009: posts small blind 50
s70n3fac3: posts big blind 100
*** HOLE CARDS ***
FDIBA2009: raises 100 to 200
s70n3fac3: folds 
Uncalled bet (100) returned to FDIBA2009
FDIBA2009 collected 200 from pot
FDIBA2009: doesn't show hand 
*** SUMMARY ***
Total pot 200 | Rake 0 
Seat 1: s70n3fac3 (big blind) folded before Flop
Seat 2: FDIBA2009 (button) (small blind) collected (200)



PokerStars Home Game Hand #227142251334: {Club #4781089}  Hold'em No Limit (50/100) - 2021/05/28 23:47:03 EET [2021/05/28 16:47:03 ET]
Table 'VTPP NLHE 2805' 2-max (Play Money) Seat #1 is the button
Seat 1: s70n3fac3 (9695 in chips) 
Seat 2: FDIBA2009 (15108 in chips) 
s70n3fac3: posts small blind 50
FDIBA2009: posts big blind 100
*** HOLE CARDS ***
s70n3fac3: raises 150 to 250
FDIBA2009: calls 150
*** FLOP *** [Th 7d Jd]
FDIBA2009: checks 
s70n3fac3: checks 
*** TURN *** [Th 7d Jd] [5s]
FDIBA2009: bets 250
s70n3fac3: calls 250
*** RIVER *** [Th 7d Jd 5s] [9d]
FDIBA2009: checks 
s70n3fac3: checks 
*** SHOW DOWN ***
FDIBA2009: shows [3s Js] (a pair of Jacks)
s70n3fac3: mucks hand 
FDIBA2009 collected 945 from pot
*** SUMMARY ***
Total pot 1000 | Rake 55 
Board [Th 7d Jd 5s 9d]
Seat 1: s70n3fac3 (button) (small blind) mucked [As 6d]
Seat 2: FDIBA2009 (big blind) showed [3s Js] and won (945) with a pair of Jacks



PokerStars Home Game Hand #227142267682: {Club #4781089}  Hold'em No Limit (50/100) - 2021/05/28 23:47:32 EET [2021/05/28 16:47:32 ET]
Table 'VTPP NLHE 2805' 2-max (Play Money) Seat #2 is the button
Seat 1: s70n3fac3 (9195 in chips) 
Seat 2: FDIBA2009 (15553 in chips) 
FDIBA2009: posts small blind 50
s70n3fac3: posts big blind 100
*** HOLE CARDS ***
FDIBA2009: raises 100 to 200
s70n3fac3: folds 
Uncalled bet (100) returned to FDIBA2009
FDIBA2009 collected 200 from pot
FDIBA2009: doesn't show hand 
*** SUMMARY ***
Total pot 200 | Rake 0 
Seat 1: s70n3fac3 (big blind) folded before Flop
Seat 2: FDIBA2009 (button) (small blind) collected (200)



PokerStars Home Game Hand #227142273345: {Club #4781089}  Hold'em No Limit (50/100) - 2021/05/28 23:47:43 EET [2021/05/28 16:47:43 ET]
Table 'VTPP NLHE 2805' 2-max (Play Money) Seat #1 is the button
Seat 1: s70n3fac3 (9095 in chips) 
Seat 2: FDIBA2009 (15653 in chips) 
s70n3fac3: posts small blind 50
FDIBA2009: posts big blind 100
*** HOLE CARDS ***
s70n3fac3: folds 
Uncalled bet (50) returned to FDIBA2009
FDIBA2009 collected 100 from pot
FDIBA2009: doesn't show hand 
*** SUMMARY ***
Total pot 100 | Rake 0 
Seat 1: s70n3fac3 (button) (small blind) folded before Flop
Seat 2: FDIBA2009 (big blind) collected (100)



PokerStars Home Game Hand #227142275527: {Club #4781089}  Hold'em No Limit (50/100) - 2021/05/28 23:47:47 EET [2021/05/28 16:47:47 ET]
Table 'VTPP NLHE 2805' 2-max (Play Money) Seat #2 is the button
Seat 1: s70n3fac3 (9045 in chips) 
Seat 2: FDIBA2009 (15703 in chips) 
FDIBA2009: posts small blind 50
s70n3fac3: posts big blind 100
*** HOLE CARDS ***
FDIBA2009: raises 100 to 200
s70n3fac3: calls 100
*** FLOP *** [8c Kc Ad]
s70n3fac3: checks 
FDIBA2009: checks 
*** TURN *** [8c Kc Ad] [Qc]
s70n3fac3: checks 
FDIBA2009: bets 250
s70n3fac3: calls 250
*** RIVER *** [8c Kc Ad Qc] [7s]
s70n3fac3: checks 
FDIBA2009: bets 950
s70n3fac3: folds 
Uncalled bet (950) returned to FDIBA2009
FDIBA2009 collected 850 from pot
FDIBA2009: doesn't show hand 
*** SUMMARY ***
Total pot 900 | Rake 50 
Board [8c Kc Ad Qc 7s]
Seat 1: s70n3fac3 (big blind) folded on the River
Seat 2: FDIBA2009 (button) (small blind) collected (850)



PokerStars Home Game Hand #227142302561: {Club #4781089}  Hold'em No Limit (50/100) - 2021/05/28 23:48:31 EET [2021/05/28 16:48:31 ET]
Table 'VTPP NLHE 2805' 2-max (Play Money) Seat #1 is the button
Seat 1: s70n3fac3 (8595 in chips) 
Seat 2: FDIBA2009 (16103 in chips) 
s70n3fac3: posts small blind 50
FDIBA2009: posts big blind 100
*** HOLE CARDS ***
s70n3fac3: raises 150 to 250
FDIBA2009: folds 
Uncalled bet (150) returned to s70n3fac3
s70n3fac3 collected 200 from pot
s70n3fac3: doesn't show hand 
*** SUMMARY ***
Total pot 200 | Rake 0 
Seat 1: s70n3fac3 (button) (small blind) collected (200)
Seat 2: FDIBA2009 (big blind) folded before Flop



PokerStars Home Game Hand #227142306947: {Club #4781089}  Hold'em No Limit (50/100) - 2021/05/28 23:48:39 EET [2021/05/28 16:48:39 ET]
Table 'VTPP NLHE 2805' 2-max (Play Money) Seat #2 is the button
Seat 1: s70n3fac3 (8695 in chips) 
Seat 2: FDIBA2009 (16003 in chips) 
FDIBA2009: posts small blind 50
s70n3fac3: posts big blind 100
*** HOLE CARDS ***
FDIBA2009: raises 100 to 200
s70n3fac3: calls 100
*** FLOP *** [Tc 6s Ac]
s70n3fac3: checks 
FDIBA2009: bets 200
s70n3fac3: calls 200
*** TURN *** [Tc 6s Ac] [4c]
s70n3fac3: checks 
FDIBA2009: checks 
*** RIVER *** [Tc 6s Ac 4c] [3d]
s70n3fac3: checks 
FDIBA2009: checks 
*** SHOW DOWN ***
s70n3fac3: shows [6d 6c] (three of a kind, Sixes)
FDIBA2009: mucks hand 
s70n3fac3 collected 756 from pot
*** SUMMARY ***
Total pot 800 | Rake 44 
Board [Tc 6s Ac 4c 3d]
Seat 1: s70n3fac3 (big blind) showed [6d 6c] and won (756) with three of a kind, Sixes
Seat 2: FDIBA2009 (button) (small blind) mucked [9c 2s]



PokerStars Home Game Hand #227142320796: {Club #4781089}  Hold'em No Limit (50/100) - 2021/05/28 23:49:04 EET [2021/05/28 16:49:04 ET]
Table 'VTPP NLHE 2805' 2-max (Play Money) Seat #1 is the button
Seat 1: s70n3fac3 (9051 in chips) 
Seat 2: FDIBA2009 (15603 in chips) 
s70n3fac3: posts small blind 50
FDIBA2009: posts big blind 100
*** HOLE CARDS ***
s70n3fac3: raises 150 to 250
FDIBA2009: calls 150
*** FLOP *** [Ac Ts Th]
FDIBA2009: checks 
s70n3fac3: bets 300
FDIBA2009: calls 300
*** TURN *** [Ac Ts Th] [Kd]
FDIBA2009: checks 
s70n3fac3: checks 
*** RIVER *** [Ac Ts Th Kd] [2d]
FDIBA2009: bets 550
s70n3fac3: folds 
Uncalled bet (550) returned to FDIBA2009
FDIBA2009 collected 1039 from pot
FDIBA2009: doesn't show hand 
*** SUMMARY ***
Total pot 1100 | Rake 61 
Board [Ac Ts Th Kd 2d]
Seat 1: s70n3fac3 (button) (small blind) folded on the River
Seat 2: FDIBA2009 (big blind) collected (1039)



PokerStars Home Game Hand #227142338171: {Club #4781089}  Hold'em No Limit (50/100) - 2021/05/28 23:49:36 EET [2021/05/28 16:49:36 ET]
Table 'VTPP NLHE 2805' 2-max (Play Money) Seat #2 is the button
Seat 1: s70n3fac3 (8501 in chips) 
Seat 2: FDIBA2009 (16092 in chips) 
FDIBA2009: posts small blind 50
s70n3fac3: posts big blind 100
*** HOLE CARDS ***
FDIBA2009: raises 100 to 200
s70n3fac3: calls 100
*** FLOP *** [Td 8c 3c]
s70n3fac3: checks 
FDIBA2009: bets 200
s70n3fac3: calls 200
*** TURN *** [Td 8c 3c] [4d]
s70n3fac3: checks 
FDIBA2009: checks 
*** RIVER *** [Td 8c 3c 4d] [Qs]
s70n3fac3: checks 
FDIBA2009: checks 
*** SHOW DOWN ***
s70n3fac3: shows [8s 5d] (a pair of Eights)
FDIBA2009: mucks hand 
s70n3fac3 collected 756 from pot
*** SUMMARY ***
Total pot 800 | Rake 44 
Board [Td 8c 3c 4d Qs]
Seat 1: s70n3fac3 (big blind) showed [8s 5d] and won (756) with a pair of Eights
Seat 2: FDIBA2009 (button) (small blind) mucked [9d 3s]



PokerStars Home Game Hand #227142349031: {Club #4781089}  Hold'em No Limit (50/100) - 2021/05/28 23:49:55 EET [2021/05/28 16:49:55 ET]
Table 'VTPP NLHE 2805' 2-max (Play Money) Seat #1 is the button
Seat 1: s70n3fac3 (8857 in chips) 
Seat 2: FDIBA2009 (15692 in chips) 
s70n3fac3: posts small blind 50
FDIBA2009: posts big blind 100
*** HOLE CARDS ***
s70n3fac3: raises 150 to 250
FDIBA2009: calls 150
*** FLOP *** [As Tc 5s]
FDIBA2009: checks 
s70n3fac3: bets 300
FDIBA2009: folds 
Uncalled bet (300) returned to s70n3fac3
s70n3fac3 collected 472 from pot
s70n3fac3: doesn't show hand 
*** SUMMARY ***
Total pot 500 | Rake 28 
Board [As Tc 5s]
Seat 1: s70n3fac3 (button) (small blind) collected (472)
Seat 2: FDIBA2009 (big blind) folded on the Flop



PokerStars Home Game Hand #227142358943: {Club #4781089}  Hold'em No Limit (50/100) - 2021/05/28 23:50:14 EET [2021/05/28 16:50:14 ET]
Table 'VTPP NLHE 2805' 2-max (Play Money) Seat #2 is the button
Seat 1: s70n3fac3 (9079 in chips) 
Seat 2: FDIBA2009 (15442 in chips) 
FDIBA2009: posts small blind 50
s70n3fac3: posts big blind 100
*** HOLE CARDS ***
FDIBA2009: raises 100 to 200
s70n3fac3: calls 100
*** FLOP *** [4c 6h 5c]
s70n3fac3: checks 
FDIBA2009: bets 200
s70n3fac3: calls 200
*** TURN *** [4c 6h 5c] [Qh]
s70n3fac3: checks 
FDIBA2009: bets 650
s70n3fac3: folds 
Uncalled bet (650) returned to FDIBA2009
FDIBA2009 collected 756 from pot
FDIBA2009: doesn't show hand 
*** SUMMARY ***
Total pot 800 | Rake 44 
Board [4c 6h 5c Qh]
Seat 1: s70n3fac3 (big blind) folded on the Turn
Seat 2: FDIBA2009 (button) (small blind) collected (756)



PokerStars Home Game Hand #227142370168: {Club #4781089}  Hold'em No Limit (50/100) - 2021/05/28 23:50:34 EET [2021/05/28 16:50:34 ET]
Table 'VTPP NLHE 2805' 2-max (Play Money) Seat #1 is the button
Seat 1: s70n3fac3 (8679 in chips) 
Seat 2: FDIBA2009 (15798 in chips) 
s70n3fac3: posts small blind 50
FDIBA2009: posts big blind 100
*** HOLE CARDS ***
s70n3fac3: raises 100 to 200
FDIBA2009: raises 100 to 300
s70n3fac3: calls 100
*** FLOP *** [Qc Jd 5s]
FDIBA2009: checks 
s70n3fac3: bets 300
FDIBA2009: folds 
Uncalled bet (300) returned to s70n3fac3
s70n3fac3 collected 567 from pot
s70n3fac3: doesn't show hand 
*** SUMMARY ***
Total pot 600 | Rake 33 
Board [Qc Jd 5s]
Seat 1: s70n3fac3 (button) (small blind) collected (567)
Seat 2: FDIBA2009 (big blind) folded on the Flop



PokerStars Home Game Hand #227142377999: {Club #4781089}  Hold'em No Limit (50/100) - 2021/05/28 23:50:49 EET [2021/05/28 16:50:49 ET]
Table 'VTPP NLHE 2805' 2-max (Play Money) Seat #2 is the button
Seat 1: s70n3fac3 (8946 in chips) 
Seat 2: FDIBA2009 (15498 in chips) 
FDIBA2009: posts small blind 50
s70n3fac3: posts big blind 100
*** HOLE CARDS ***
FDIBA2009: folds 
Uncalled bet (50) returned to s70n3fac3
s70n3fac3 collected 100 from pot
s70n3fac3: doesn't show hand 
*** SUMMARY ***
Total pot 100 | Rake 0 
Seat 1: s70n3fac3 (big blind) collected (100)
Seat 2: FDIBA2009 (button) (small blind) folded before Flop



PokerStars Home Game Hand #227142380971: {Club #4781089}  Hold'em No Limit (50/100) - 2021/05/28 23:50:54 EET [2021/05/28 16:50:54 ET]
Table 'VTPP NLHE 2805' 2-max (Play Money) Seat #1 is the button
Seat 1: s70n3fac3 (8996 in chips) 
Seat 2: FDIBA2009 (15448 in chips) 
s70n3fac3: posts small blind 50
FDIBA2009: posts big blind 100
*** HOLE CARDS ***
s70n3fac3: raises 100 to 200
FDIBA2009: raises 100 to 300
s70n3fac3: calls 100
*** FLOP *** [8d 2h 2d]
FDIBA2009: checks 
s70n3fac3: checks 
*** TURN *** [8d 2h 2d] [3d]
FDIBA2009: checks 
s70n3fac3: checks 
*** RIVER *** [8d 2h 2d 3d] [8c]
FDIBA2009: bets 567
s70n3fac3: folds 
Uncalled bet (567) returned to FDIBA2009
FDIBA2009 collected 567 from pot
FDIBA2009: doesn't show hand 
*** SUMMARY ***
Total pot 600 | Rake 33 
Board [8d 2h 2d 3d 8c]
Seat 1: s70n3fac3 (button) (small blind) folded on the River
Seat 2: FDIBA2009 (big blind) collected (567)



PokerStars Home Game Hand #227142394164: {Club #4781089}  Hold'em No Limit (50/100) - 2021/05/28 23:51:18 EET [2021/05/28 16:51:18 ET]
Table 'VTPP NLHE 2805' 2-max (Play Money) Seat #2 is the button
Seat 1: s70n3fac3 (8696 in chips) 
Seat 2: FDIBA2009 (15715 in chips) 
FDIBA2009: posts small blind 50
s70n3fac3: posts big blind 100
*** HOLE CARDS ***
FDIBA2009: raises 100 to 200
s70n3fac3: calls 100
*** FLOP *** [3h 5h 4c]
s70n3fac3: checks 
FDIBA2009: bets 200
s70n3fac3: folds 
Uncalled bet (200) returned to FDIBA2009
FDIBA2009 collected 378 from pot
FDIBA2009: doesn't show hand 
*** SUMMARY ***
Total pot 400 | Rake 22 
Board [3h 5h 4c]
Seat 1: s70n3fac3 (big blind) folded on the Flop
Seat 2: FDIBA2009 (button) (small blind) collected (378)



PokerStars Home Game Hand #227142402015: {Club #4781089}  Hold'em No Limit (50/100) - 2021/05/28 23:51:33 EET [2021/05/28 16:51:33 ET]
Table 'VTPP NLHE 2805' 2-max (Play Money) Seat #1 is the button
Seat 1: s70n3fac3 (8496 in chips) 
Seat 2: FDIBA2009 (15893 in chips) 
s70n3fac3: posts small blind 50
FDIBA2009: posts big blind 100
*** HOLE CARDS ***
s70n3fac3: folds 
Uncalled bet (50) returned to FDIBA2009
FDIBA2009 collected 100 from pot
FDIBA2009: doesn't show hand 
*** SUMMARY ***
Total pot 100 | Rake 0 
Seat 1: s70n3fac3 (button) (small blind) folded before Flop
Seat 2: FDIBA2009 (big blind) collected (100)



PokerStars Home Game Hand #227142404107: {Club #4781089}  Hold'em No Limit (50/100) - 2021/05/28 23:51:36 EET [2021/05/28 16:51:36 ET]
Table 'VTPP NLHE 2805' 2-max (Play Money) Seat #2 is the button
Seat 1: s70n3fac3 (8446 in chips) 
Seat 2: FDIBA2009 (15943 in chips) 
FDIBA2009: posts small blind 50
s70n3fac3: posts big blind 100
*** HOLE CARDS ***
FDIBA2009: raises 100 to 200
s70n3fac3: calls 100
*** FLOP *** [2s 7s Qh]
s70n3fac3: checks 
FDIBA2009: checks 
*** TURN *** [2s 7s Qh] [7h]
s70n3fac3: checks 
FDIBA2009: checks 
*** RIVER *** [2s 7s Qh 7h] [Ac]
s70n3fac3: checks 
FDIBA2009: checks 
*** SHOW DOWN ***
s70n3fac3: shows [Tc Js] (a pair of Sevens)
FDIBA2009: mucks hand 
s70n3fac3 collected 378 from pot
*** SUMMARY ***
Total pot 400 | Rake 22 
Board [2s 7s Qh 7h Ac]
Seat 1: s70n3fac3 (big blind) showed [Tc Js] and won (378) with a pair of Sevens
Seat 2: FDIBA2009 (button) (small blind) mucked [3c Th]



PokerStars Home Game Hand #227142417916: {Club #4781089}  Hold'em No Limit (50/100) - 2021/05/28 23:52:01 EET [2021/05/28 16:52:01 ET]
Table 'VTPP NLHE 2805' 2-max (Play Money) Seat #1 is the button
Seat 1: s70n3fac3 (8624 in chips) 
Seat 2: FDIBA2009 (15743 in chips) 
s70n3fac3: posts small blind 50
FDIBA2009: posts big blind 100
*** HOLE CARDS ***
s70n3fac3: folds 
Uncalled bet (50) returned to FDIBA2009
FDIBA2009 collected 100 from pot
FDIBA2009: doesn't show hand 
*** SUMMARY ***
Total pot 100 | Rake 0 
Seat 1: s70n3fac3 (button) (small blind) folded before Flop
Seat 2: FDIBA2009 (big blind) collected (100)



PokerStars Home Game Hand #227142419918: {Club #4781089}  Hold'em No Limit (50/100) - 2021/05/28 23:52:05 EET [2021/05/28 16:52:05 ET]
Table 'VTPP NLHE 2805' 2-max (Play Money) Seat #2 is the button
Seat 1: s70n3fac3 (8574 in chips) 
Seat 2: FDIBA2009 (15793 in chips) 
FDIBA2009: posts small blind 50
s70n3fac3: posts big blind 100
*** HOLE CARDS ***
FDIBA2009: raises 100 to 200
s70n3fac3: folds 
Uncalled bet (100) returned to FDIBA2009
FDIBA2009 collected 200 from pot
FDIBA2009: doesn't show hand 
*** SUMMARY ***
Total pot 200 | Rake 0 
Seat 1: s70n3fac3 (big blind) folded before Flop
Seat 2: FDIBA2009 (button) (small blind) collected (200)



PokerStars Home Game Hand #227142427254: {Club #4781089}  Hold'em No Limit (50/100) - 2021/05/28 23:52:19 EET [2021/05/28 16:52:19 ET]
Table 'VTPP NLHE 2805' 2-max (Play Money) Seat #1 is the button
Seat 1: s70n3fac3 (8474 in chips) 
Seat 2: FDIBA2009 (15893 in chips) 
s70n3fac3: posts small blind 50
FDIBA2009: posts big blind 100
*** HOLE CARDS ***
s70n3fac3: raises 150 to 250
FDIBA2009: calls 150
*** FLOP *** [3c Kc Tc]
FDIBA2009: checks 
s70n3fac3: checks 
*** TURN *** [3c Kc Tc] [8s]
FDIBA2009: bets 250
s70n3fac3: folds 
Uncalled bet (250) returned to FDIBA2009
FDIBA2009 collected 472 from pot
FDIBA2009: doesn't show hand 
*** SUMMARY ***
Total pot 500 | Rake 28 
Board [3c Kc Tc 8s]
Seat 1: s70n3fac3 (button) (small blind) folded on the Turn
Seat 2: FDIBA2009 (big blind) collected (472)



PokerStars Home Game Hand #227142436921: {Club #4781089}  Hold'em No Limit (50/100) - 2021/05/28 23:52:37 EET [2021/05/28 16:52:37 ET]
Table 'VTPP NLHE 2805' 2-max (Play Money) Seat #2 is the button
Seat 1: s70n3fac3 (8224 in chips) 
Seat 2: FDIBA2009 (16115 in chips) 
FDIBA2009: posts small blind 50
s70n3fac3: posts big blind 100
*** HOLE CARDS ***
FDIBA2009: raises 100 to 200
s70n3fac3: calls 100
*** FLOP *** [6d 9c 4c]
s70n3fac3: checks 
FDIBA2009: checks 
*** TURN *** [6d 9c 4c] [6s]
s70n3fac3: checks 
FDIBA2009: checks 
*** RIVER *** [6d 9c 4c 6s] [Td]
s70n3fac3: checks 
FDIBA2009: checks 
*** SHOW DOWN ***
s70n3fac3: shows [Qs 7d] (a pair of Sixes)
FDIBA2009: mucks hand 
s70n3fac3 collected 378 from pot
*** SUMMARY ***
Total pot 400 | Rake 22 
Board [6d 9c 4c 6s Td]
Seat 1: s70n3fac3 (big blind) showed [Qs 7d] and won (378) with a pair of Sixes
Seat 2: FDIBA2009 (button) (small blind) mucked [Js 7c]



PokerStars Home Game Hand #227142449543: {Club #4781089}  Hold'em No Limit (50/100) - 2021/05/28 23:53:00 EET [2021/05/28 16:53:00 ET]
Table 'VTPP NLHE 2805' 2-max (Play Money) Seat #1 is the button
Seat 1: s70n3fac3 (8402 in chips) 
Seat 2: FDIBA2009 (15915 in chips) 
s70n3fac3: posts small blind 50
FDIBA2009: posts big blind 100
*** HOLE CARDS ***
s70n3fac3: raises 150 to 250
FDIBA2009: folds 
Uncalled bet (150) returned to s70n3fac3
s70n3fac3 collected 200 from pot
s70n3fac3: doesn't show hand 
*** SUMMARY ***
Total pot 200 | Rake 0 
Seat 1: s70n3fac3 (button) (small blind) collected (200)
Seat 2: FDIBA2009 (big blind) folded before Flop



PokerStars Home Game Hand #227142455329: {Club #4781089}  Hold'em No Limit (50/100) - 2021/05/28 23:53:11 EET [2021/05/28 16:53:11 ET]
Table 'VTPP NLHE 2805' 2-max (Play Money) Seat #2 is the button
Seat 1: s70n3fac3 (8502 in chips) 
Seat 2: FDIBA2009 (15815 in chips) 
FDIBA2009: posts small blind 50
s70n3fac3: posts big blind 100
*** HOLE CARDS ***
FDIBA2009: raises 100 to 200
s70n3fac3: calls 100
*** FLOP *** [Ks 8s Ts]
s70n3fac3: checks 
FDIBA2009: bets 200
s70n3fac3: folds 
Uncalled bet (200) returned to FDIBA2009
FDIBA2009 collected 378 from pot
FDIBA2009: doesn't show hand 
*** SUMMARY ***
Total pot 400 | Rake 22 
Board [Ks 8s Ts]
Seat 1: s70n3fac3 (big blind) folded on the Flop
Seat 2: FDIBA2009 (button) (small blind) collected (378)



PokerStars Home Game Hand #227142463014: {Club #4781089}  Hold'em No Limit (50/100) - 2021/05/28 23:53:25 EET [2021/05/28 16:53:25 ET]
Table 'VTPP NLHE 2805' 2-max (Play Money) Seat #1 is the button
Seat 1: s70n3fac3 (8302 in chips) 
Seat 2: FDIBA2009 (15993 in chips) 
s70n3fac3: posts small blind 50
FDIBA2009: posts big blind 100
*** HOLE CARDS ***
s70n3fac3: folds 
Uncalled bet (50) returned to FDIBA2009
FDIBA2009 collected 100 from pot
FDIBA2009: doesn't show hand 
*** SUMMARY ***
Total pot 100 | Rake 0 
Seat 1: s70n3fac3 (button) (small blind) folded before Flop
Seat 2: FDIBA2009 (big blind) collected (100)



PokerStars Home Game Hand #227142464975: {Club #4781089}  Hold'em No Limit (50/100) - 2021/05/28 23:53:29 EET [2021/05/28 16:53:29 ET]
Table 'VTPP NLHE 2805' 2-max (Play Money) Seat #2 is the button
Seat 1: s70n3fac3 (8252 in chips) 
Seat 2: FDIBA2009 (16043 in chips) 
FDIBA2009: posts small blind 50
s70n3fac3: posts big blind 100
*** HOLE CARDS ***
FDIBA2009: raises 100 to 200
s70n3fac3: raises 400 to 600
FDIBA2009: folds 
Uncalled bet (400) returned to s70n3fac3
s70n3fac3 collected 400 from pot
s70n3fac3: doesn't show hand 
*** SUMMARY ***
Total pot 400 | Rake 0 
Seat 1: s70n3fac3 (big blind) collected (400)
Seat 2: FDIBA2009 (button) (small blind) folded before Flop



PokerStars Home Game Hand #227142472049: {Club #4781089}  Hold'em No Limit (50/100) - 2021/05/28 23:53:42 EET [2021/05/28 16:53:42 ET]
Table 'VTPP NLHE 2805' 2-max (Play Money) Seat #1 is the button
Seat 1: s70n3fac3 (8452 in chips) 
Seat 2: FDIBA2009 (15843 in chips) 
s70n3fac3: posts small blind 50
FDIBA2009: posts big blind 100
*** HOLE CARDS ***
s70n3fac3: raises 150 to 250
FDIBA2009: folds 
Uncalled bet (150) returned to s70n3fac3
s70n3fac3 collected 200 from pot
s70n3fac3: doesn't show hand 
*** SUMMARY ***
Total pot 200 | Rake 0 
Seat 1: s70n3fac3 (button) (small blind) collected (200)
Seat 2: FDIBA2009 (big blind) folded before Flop



PokerStars Home Game Hand #227142476173: {Club #4781089}  Hold'em No Limit (50/100) - 2021/05/28 23:53:49 EET [2021/05/28 16:53:49 ET]
Table 'VTPP NLHE 2805' 2-max (Play Money) Seat #2 is the button
Seat 1: s70n3fac3 (8552 in chips) 
Seat 2: FDIBA2009 (15743 in chips) 
FDIBA2009: posts small blind 50
s70n3fac3: posts big blind 100
*** HOLE CARDS ***
FDIBA2009: folds 
Uncalled bet (50) returned to s70n3fac3
s70n3fac3 collected 100 from pot
s70n3fac3: doesn't show hand 
*** SUMMARY ***
Total pot 100 | Rake 0 
Seat 1: s70n3fac3 (big blind) collected (100)
Seat 2: FDIBA2009 (button) (small blind) folded before Flop



PokerStars Home Game Hand #227142479381: {Club #4781089}  Hold'em No Limit (50/100) - 2021/05/28 23:53:55 EET [2021/05/28 16:53:55 ET]
Table 'VTPP NLHE 2805' 2-max (Play Money) Seat #1 is the button
Seat 1: s70n3fac3 (8602 in chips) 
Seat 2: FDIBA2009 (15693 in chips) 
s70n3fac3: posts small blind 50
FDIBA2009: posts big blind 100
*** HOLE CARDS ***
s70n3fac3: raises 150 to 250
FDIBA2009: calls 150
*** FLOP *** [6c 7c 7s]
FDIBA2009: checks 
s70n3fac3: bets 300
FDIBA2009: calls 300
*** TURN *** [6c 7c 7s] [3d]
FDIBA2009: checks 
s70n3fac3: checks 
*** RIVER *** [6c 7c 7s 3d] [5c]
FDIBA2009: checks 
s70n3fac3: checks 
*** SHOW DOWN ***
FDIBA2009: shows [9h 6d] (two pair, Sevens and Sixes)
s70n3fac3: mucks hand 
FDIBA2009 collected 1039 from pot
*** SUMMARY ***
Total pot 1100 | Rake 61 
Board [6c 7c 7s 3d 5c]
Seat 1: s70n3fac3 (button) (small blind) mucked [5d Ad]
Seat 2: FDIBA2009 (big blind) showed [9h 6d] and won (1039) with two pair, Sevens and Sixes



PokerStars Home Game Hand #227142492808: {Club #4781089}  Hold'em No Limit (50/100) - 2021/05/28 23:54:20 EET [2021/05/28 16:54:20 ET]
Table 'VTPP NLHE 2805' 2-max (Play Money) Seat #2 is the button
Seat 1: s70n3fac3 (8052 in chips) 
Seat 2: FDIBA2009 (16182 in chips) 
FDIBA2009: posts small blind 50
s70n3fac3: posts big blind 100
*** HOLE CARDS ***
FDIBA2009: raises 100 to 200
s70n3fac3: calls 100
*** FLOP *** [8d 3d 2s]
s70n3fac3: checks 
FDIBA2009: bets 200
s70n3fac3: calls 200
*** TURN *** [8d 3d 2s] [9h]
s70n3fac3: checks 
FDIBA2009: checks 
*** RIVER *** [8d 3d 2s 9h] [Js]
s70n3fac3: checks 
FDIBA2009: bets 250
s70n3fac3: folds 
Uncalled bet (250) returned to FDIBA2009
FDIBA2009 collected 756 from pot
FDIBA2009: doesn't show hand 
*** SUMMARY ***
Total pot 800 | Rake 44 
Board [8d 3d 2s 9h Js]
Seat 1: s70n3fac3 (big blind) folded on the River
Seat 2: FDIBA2009 (button) (small blind) collected (756)



PokerStars Home Game Hand #227142512234: {Club #4781089}  Hold'em No Limit (50/100) - 2021/05/28 23:54:56 EET [2021/05/28 16:54:56 ET]
Table 'VTPP NLHE 2805' 2-max (Play Money) Seat #1 is the button
Seat 1: s70n3fac3 (7652 in chips) 
Seat 2: FDIBA2009 (16538 in chips) 
s70n3fac3: posts small blind 50
FDIBA2009: posts big blind 100
*** HOLE CARDS ***
s70n3fac3: folds 
Uncalled bet (50) returned to FDIBA2009
FDIBA2009 collected 100 from pot
FDIBA2009: doesn't show hand 
*** SUMMARY ***
Total pot 100 | Rake 0 
Seat 1: s70n3fac3 (button) (small blind) folded before Flop
Seat 2: FDIBA2009 (big blind) collected (100)



PokerStars Home Game Hand #227142514228: {Club #4781089}  Hold'em No Limit (50/100) - 2021/05/28 23:55:00 EET [2021/05/28 16:55:00 ET]
Table 'VTPP NLHE 2805' 2-max (Play Money) Seat #2 is the button
Seat 1: s70n3fac3 (7602 in chips) 
Seat 2: FDIBA2009 (16588 in chips) 
FDIBA2009: posts small blind 50
s70n3fac3: posts big blind 100
*** HOLE CARDS ***
FDIBA2009: raises 100 to 200
s70n3fac3: folds 
Uncalled bet (100) returned to FDIBA2009
FDIBA2009 collected 200 from pot
FDIBA2009: doesn't show hand 
*** SUMMARY ***
Total pot 200 | Rake 0 
Seat 1: s70n3fac3 (big blind) folded before Flop
Seat 2: FDIBA2009 (button) (small blind) collected (200)



PokerStars Home Game Hand #227142519061: {Club #4781089}  Hold'em No Limit (50/100) - 2021/05/28 23:55:09 EET [2021/05/28 16:55:09 ET]
Table 'VTPP NLHE 2805' 2-max (Play Money) Seat #1 is the button
Seat 1: s70n3fac3 (7502 in chips) 
Seat 2: FDIBA2009 (16688 in chips) 
s70n3fac3: posts small blind 50
FDIBA2009: posts big blind 100
*** HOLE CARDS ***
s70n3fac3: raises 150 to 250
FDIBA2009: calls 150
*** FLOP *** [5c 9h 5h]
FDIBA2009: checks 
s70n3fac3: bets 300
FDIBA2009: folds 
Uncalled bet (300) returned to s70n3fac3
s70n3fac3 collected 472 from pot
s70n3fac3: doesn't show hand 
*** SUMMARY ***
Total pot 500 | Rake 28 
Board [5c 9h 5h]
Seat 1: s70n3fac3 (button) (small blind) collected (472)
Seat 2: FDIBA2009 (big blind) folded on the Flop



PokerStars Home Game Hand #227142532788: {Club #4781089}  Hold'em No Limit (50/100) - 2021/05/28 23:55:24 EET [2021/05/28 16:55:24 ET]
Table 'VTPP NLHE 2805' 2-max (Play Money) Seat #2 is the button
Seat 1: s70n3fac3 (7724 in chips) 
Seat 2: FDIBA2009 (16438 in chips) 
FDIBA2009: posts small blind 50
s70n3fac3: posts big blind 100
*** HOLE CARDS ***
FDIBA2009: raises 100 to 200
s70n3fac3: folds 
Uncalled bet (100) returned to FDIBA2009
FDIBA2009 collected 200 from pot
FDIBA2009: doesn't show hand 
*** SUMMARY ***
Total pot 200 | Rake 0 
Seat 1: s70n3fac3 (big blind) folded before Flop
Seat 2: FDIBA2009 (button) (small blind) collected (200)



PokerStars Home Game Hand #227142535197: {Club #4781089}  Hold'em No Limit (50/100) - 2021/05/28 23:55:30 EET [2021/05/28 16:55:30 ET]
Table 'VTPP NLHE 2805' 2-max (Play Money) Seat #1 is the button
Seat 1: s70n3fac3 (7624 in chips) 
Seat 2: FDIBA2009 (16538 in chips) 
s70n3fac3: posts small blind 50
FDIBA2009: posts big blind 100
*** HOLE CARDS ***
s70n3fac3: raises 200 to 300
FDIBA2009: folds 
Uncalled bet (200) returned to s70n3fac3
s70n3fac3 collected 200 from pot
s70n3fac3: doesn't show hand 
*** SUMMARY ***
Total pot 200 | Rake 0 
Seat 1: s70n3fac3 (button) (small blind) collected (200)
Seat 2: FDIBA2009 (big blind) folded before Flop



PokerStars Home Game Hand #227142537347: {Club #4781089}  Hold'em No Limit (50/100) - 2021/05/28 23:55:36 EET [2021/05/28 16:55:36 ET]
Table 'VTPP NLHE 2805' 2-max (Play Money) Seat #2 is the button
Seat 1: s70n3fac3 (7724 in chips) 
Seat 2: FDIBA2009 (16438 in chips) 
FDIBA2009: posts small blind 50
s70n3fac3: posts big blind 100
*** HOLE CARDS ***
FDIBA2009: raises 100 to 200
s70n3fac3: folds 
Uncalled bet (100) returned to FDIBA2009
FDIBA2009 collected 200 from pot
FDIBA2009: doesn't show hand 
*** SUMMARY ***
Total pot 200 | Rake 0 
Seat 1: s70n3fac3 (big blind) folded before Flop
Seat 2: FDIBA2009 (button) (small blind) collected (200)



PokerStars Home Game Hand #227142539919: {Club #4781089}  Hold'em No Limit (50/100) - 2021/05/28 23:55:42 EET [2021/05/28 16:55:42 ET]
Table 'VTPP NLHE 2805' 2-max (Play Money) Seat #1 is the button
Seat 1: s70n3fac3 (7624 in chips) 
Seat 2: FDIBA2009 (16538 in chips) 
s70n3fac3: posts small blind 50
FDIBA2009: posts big blind 100
*** HOLE CARDS ***
s70n3fac3: folds 
Uncalled bet (50) returned to FDIBA2009
FDIBA2009 collected 100 from pot
FDIBA2009: doesn't show hand 
*** SUMMARY ***
Total pot 100 | Rake 0 
Seat 1: s70n3fac3 (button) (small blind) folded before Flop
Seat 2: FDIBA2009 (big blind) collected (100)



PokerStars Home Game Hand #227142541515: {Club #4781089}  Hold'em No Limit (50/100) - 2021/05/28 23:55:46 EET [2021/05/28 16:55:46 ET]
Table 'VTPP NLHE 2805' 2-max (Play Money) Seat #2 is the button
Seat 1: s70n3fac3 (7574 in chips) 
Seat 2: FDIBA2009 (16588 in chips) 
FDIBA2009: posts small blind 50
s70n3fac3: posts big blind 100
*** HOLE CARDS ***
FDIBA2009: raises 100 to 200
s70n3fac3: calls 100
*** FLOP *** [Ah Kh Jd]
s70n3fac3: checks 
FDIBA2009: bets 200
s70n3fac3: calls 200
*** TURN *** [Ah Kh Jd] [7d]
s70n3fac3: checks 
FDIBA2009: bets 450
s70n3fac3: calls 450
*** RIVER *** [Ah Kh Jd 7d] [7h]
s70n3fac3: checks 
FDIBA2009: checks 
*** SHOW DOWN ***
s70n3fac3: shows [Kc 5d] (two pair, Kings and Sevens)
FDIBA2009: mucks hand 
s70n3fac3 collected 1606 from pot
*** SUMMARY ***
Total pot 1700 | Rake 94 
Board [Ah Kh Jd 7d 7h]
Seat 1: s70n3fac3 (big blind) showed [Kc 5d] and won (1606) with two pair, Kings and Sevens
Seat 2: FDIBA2009 (button) (small blind) mucked [5h 8c]



PokerStars Home Game Hand #227142551226: {Club #4781089}  Hold'em No Limit (50/100) - 2021/05/28 23:56:12 EET [2021/05/28 16:56:12 ET]
Table 'VTPP NLHE 2805' 2-max (Play Money) Seat #1 is the button
Seat 1: s70n3fac3 (8330 in chips) 
Seat 2: FDIBA2009 (15738 in chips) 
s70n3fac3: posts small blind 50
FDIBA2009: posts big blind 100
*** HOLE CARDS ***
s70n3fac3: raises 150 to 250
FDIBA2009: raises 500 to 750
s70n3fac3: folds 
Uncalled bet (500) returned to FDIBA2009
FDIBA2009 collected 500 from pot
FDIBA2009: doesn't show hand 
*** SUMMARY ***
Total pot 500 | Rake 0 
Seat 1: s70n3fac3 (button) (small blind) folded before Flop
Seat 2: FDIBA2009 (big blind) collected (500)



PokerStars Home Game Hand #227142555538: {Club #4781089}  Hold'em No Limit (50/100) - 2021/05/28 23:56:23 EET [2021/05/28 16:56:23 ET]
Table 'VTPP NLHE 2805' 2-max (Play Money) Seat #2 is the button
Seat 1: s70n3fac3 (8080 in chips) 
Seat 2: FDIBA2009 (15988 in chips) 
FDIBA2009: posts small blind 50
s70n3fac3: posts big blind 100
*** HOLE CARDS ***
FDIBA2009: raises 100 to 200
s70n3fac3: calls 100
*** FLOP *** [Ah 9c 7s]
s70n3fac3: checks 
FDIBA2009: bets 200
s70n3fac3: calls 200
*** TURN *** [Ah 9c 7s] [3h]
s70n3fac3: checks 
FDIBA2009: checks 
*** RIVER *** [Ah 9c 7s 3h] [6d]
s70n3fac3: bets 400
FDIBA2009: folds 
Uncalled bet (400) returned to s70n3fac3
s70n3fac3 collected 756 from pot
s70n3fac3: doesn't show hand 
*** SUMMARY ***
Total pot 800 | Rake 44 
Board [Ah 9c 7s 3h 6d]
Seat 1: s70n3fac3 (big blind) collected (756)
Seat 2: FDIBA2009 (button) (small blind) folded on the River



PokerStars Home Game Hand #227142576616: {Club #4781089}  Hold'em No Limit (50/100) - 2021/05/28 23:56:52 EET [2021/05/28 16:56:52 ET]
Table 'VTPP NLHE 2805' 2-max (Play Money) Seat #1 is the button
Seat 1: s70n3fac3 (8436 in chips) 
Seat 2: FDIBA2009 (15588 in chips) 
s70n3fac3: posts small blind 50
FDIBA2009: posts big blind 100
*** HOLE CARDS ***
s70n3fac3: raises 150 to 250
FDIBA2009: raises 150 to 400
s70n3fac3: raises 500 to 900
FDIBA2009: raises 500 to 1400
s70n3fac3: calls 500
*** FLOP *** [Qs Th Td]
FDIBA2009: checks 
s70n3fac3: checks 
*** TURN *** [Qs Th Td] [Kh]
FDIBA2009: checks 
s70n3fac3: checks 
*** RIVER *** [Qs Th Td Kh] [6c]
FDIBA2009: checks 
s70n3fac3: checks 
*** SHOW DOWN ***
FDIBA2009: shows [Ac As] (two pair, Aces and Tens)
s70n3fac3: mucks hand 
FDIBA2009 collected 2646 from pot
*** SUMMARY ***
Total pot 2800 | Rake 154 
Board [Qs Th Td Kh 6c]
Seat 1: s70n3fac3 (button) (small blind) mucked [Jd Jc]
Seat 2: FDIBA2009 (big blind) showed [Ac As] and won (2646) with two pair, Aces and Tens



PokerStars Home Game Hand #227142598894: {Club #4781089}  Hold'em No Limit (50/100) - 2021/05/28 23:57:49 EET [2021/05/28 16:57:49 ET]
Table 'VTPP NLHE 2805' 2-max (Play Money) Seat #2 is the button
Seat 1: s70n3fac3 (7036 in chips) 
Seat 2: FDIBA2009 (16834 in chips) 
FDIBA2009: posts small blind 50
s70n3fac3: posts big blind 100
*** HOLE CARDS ***
FDIBA2009: raises 100 to 200
s70n3fac3: folds 
Uncalled bet (100) returned to FDIBA2009
FDIBA2009 collected 200 from pot
FDIBA2009: doesn't show hand 
*** SUMMARY ***
Total pot 200 | Rake 0 
Seat 1: s70n3fac3 (big blind) folded before Flop
Seat 2: FDIBA2009 (button) (small blind) collected (200)



PokerStars Home Game Hand #227142603530: {Club #4781089}  Hold'em No Limit (50/100) - 2021/05/28 23:58:00 EET [2021/05/28 16:58:00 ET]
Table 'VTPP NLHE 2805' 2-max (Play Money) Seat #1 is the button
Seat 1: s70n3fac3 (6936 in chips) 
Seat 2: FDIBA2009 (16934 in chips) 
s70n3fac3: posts small blind 50
FDIBA2009: posts big blind 100
*** HOLE CARDS ***
s70n3fac3: folds 
Uncalled bet (50) returned to FDIBA2009
FDIBA2009 collected 100 from pot
FDIBA2009: doesn't show hand 
*** SUMMARY ***
Total pot 100 | Rake 0 
Seat 1: s70n3fac3 (button) (small blind) folded before Flop
Seat 2: FDIBA2009 (big blind) collected (100)



PokerStars Home Game Hand #227142605239: {Club #4781089}  Hold'em No Limit (50/100) - 2021/05/28 23:58:05 EET [2021/05/28 16:58:05 ET]
Table 'VTPP NLHE 2805' 2-max (Play Money) Seat #2 is the button
Seat 1: s70n3fac3 (6886 in chips) 
Seat 2: FDIBA2009 (16984 in chips) 
FDIBA2009: posts small blind 50
s70n3fac3: posts big blind 100
*** HOLE CARDS ***
FDIBA2009: raises 100 to 200
s70n3fac3: calls 100
*** FLOP *** [9d Qh 4d]
s70n3fac3: checks 
FDIBA2009: checks 
*** TURN *** [9d Qh 4d] [3h]
s70n3fac3: bets 200
FDIBA2009: calls 200
*** RIVER *** [9d Qh 4d 3h] [Th]
s70n3fac3: checks 
FDIBA2009: bets 400
s70n3fac3: calls 400
*** SHOW DOWN ***
FDIBA2009: shows [9s Kh] (a pair of Nines)
s70n3fac3: mucks hand 
FDIBA2009 collected 1512 from pot
*** SUMMARY ***
Total pot 1600 | Rake 88 
Board [9d Qh 4d 3h Th]
Seat 1: s70n3fac3 (big blind) mucked [4s Ks]
Seat 2: FDIBA2009 (button) (small blind) showed [9s Kh] and won (1512) with a pair of Nines



PokerStars Home Game Hand #227142616267: {Club #4781089}  Hold'em No Limit (50/100) - 2021/05/28 23:58:33 EET [2021/05/28 16:58:33 ET]
Table 'VTPP NLHE 2805' 2-max (Play Money) Seat #1 is the button
Seat 1: s70n3fac3 (6086 in chips) 
Seat 2: FDIBA2009 (17696 in chips) 
s70n3fac3: posts small blind 50
FDIBA2009: posts big blind 100
*** HOLE CARDS ***
s70n3fac3: folds 
Uncalled bet (50) returned to FDIBA2009
FDIBA2009 collected 100 from pot
FDIBA2009: doesn't show hand 
*** SUMMARY ***
Total pot 100 | Rake 0 
Seat 1: s70n3fac3 (button) (small blind) folded before Flop
Seat 2: FDIBA2009 (big blind) collected (100)



PokerStars Home Game Hand #227142619623: {Club #4781089}  Hold'em No Limit (50/100) - 2021/05/28 23:58:41 EET [2021/05/28 16:58:41 ET]
Table 'VTPP NLHE 2805' 2-max (Play Money) Seat #2 is the button
Seat 1: s70n3fac3 (6036 in chips) 
Seat 2: FDIBA2009 (17746 in chips) 
FDIBA2009: posts small blind 50
s70n3fac3: posts big blind 100
*** HOLE CARDS ***
FDIBA2009: raises 100 to 200
s70n3fac3: folds 
Uncalled bet (100) returned to FDIBA2009
FDIBA2009 collected 200 from pot
FDIBA2009: doesn't show hand 
*** SUMMARY ***
Total pot 200 | Rake 0 
Seat 1: s70n3fac3 (big blind) folded before Flop
Seat 2: FDIBA2009 (button) (small blind) collected (200)



PokerStars Home Game Hand #227142622996: {Club #4781089}  Hold'em No Limit (50/100) - 2021/05/28 23:58:50 EET [2021/05/28 16:58:50 ET]
Table 'VTPP NLHE 2805' 2-max (Play Money) Seat #1 is the button
Seat 1: s70n3fac3 (5936 in chips) 
Seat 2: FDIBA2009 (17846 in chips) 
s70n3fac3: posts small blind 50
FDIBA2009: posts big blind 100
*** HOLE CARDS ***
s70n3fac3: raises 150 to 250
FDIBA2009: calls 150
*** FLOP *** [5h Js 3d]
FDIBA2009: checks 
s70n3fac3: checks 
*** TURN *** [5h Js 3d] [8c]
FDIBA2009: bets 250
s70n3fac3: folds 
Uncalled bet (250) returned to FDIBA2009
FDIBA2009 collected 472 from pot
FDIBA2009: doesn't show hand 
*** SUMMARY ***
Total pot 500 | Rake 28 
Board [5h Js 3d 8c]
Seat 1: s70n3fac3 (button) (small blind) folded on the Turn
Seat 2: FDIBA2009 (big blind) collected (472)



PokerStars Home Game Hand #227142630560: {Club #4781089}  Hold'em No Limit (50/100) - 2021/05/28 23:59:09 EET [2021/05/28 16:59:09 ET]
Table 'VTPP NLHE 2805' 2-max (Play Money) Seat #2 is the button
Seat 1: s70n3fac3 (5686 in chips) 
Seat 2: FDIBA2009 (18068 in chips) 
FDIBA2009: posts small blind 50
s70n3fac3: posts big blind 100
*** HOLE CARDS ***
FDIBA2009: raises 100 to 200
s70n3fac3: raises 400 to 600
FDIBA2009: calls 400
*** FLOP *** [Qd Jh 5h]
s70n3fac3: bets 650
FDIBA2009: folds 
Uncalled bet (650) returned to s70n3fac3
s70n3fac3 collected 1134 from pot
s70n3fac3: doesn't show hand 
*** SUMMARY ***
Total pot 1200 | Rake 66 
Board [Qd Jh 5h]
Seat 1: s70n3fac3 (big blind) collected (1134)
Seat 2: FDIBA2009 (button) (small blind) folded on the Flop



PokerStars Home Game Hand #227142637110: {Club #4781089}  Hold'em No Limit (50/100) - 2021/05/28 23:59:25 EET [2021/05/28 16:59:25 ET]
Table 'VTPP NLHE 2805' 2-max (Play Money) Seat #1 is the button
Seat 1: s70n3fac3 (6220 in chips) 
Seat 2: FDIBA2009 (17468 in chips) 
s70n3fac3: posts small blind 50
FDIBA2009: posts big blind 100
*** HOLE CARDS ***
s70n3fac3: folds 
Uncalled bet (50) returned to FDIBA2009
FDIBA2009 collected 100 from pot
FDIBA2009: doesn't show hand 
*** SUMMARY ***
Total pot 100 | Rake 0 
Seat 1: s70n3fac3 (button) (small blind) folded before Flop
Seat 2: FDIBA2009 (big blind) collected (100)



PokerStars Home Game Hand #227142638657: {Club #4781089}  Hold'em No Limit (50/100) - 2021/05/28 23:59:29 EET [2021/05/28 16:59:29 ET]
Table 'VTPP NLHE 2805' 2-max (Play Money) Seat #2 is the button
Seat 1: s70n3fac3 (6170 in chips) 
Seat 2: FDIBA2009 (17518 in chips) 
FDIBA2009: posts small blind 50
s70n3fac3: posts big blind 100
*** HOLE CARDS ***
FDIBA2009: raises 100 to 200
s70n3fac3: folds 
Uncalled bet (100) returned to FDIBA2009
FDIBA2009 collected 200 from pot
FDIBA2009: doesn't show hand 
*** SUMMARY ***
Total pot 200 | Rake 0 
Seat 1: s70n3fac3 (big blind) folded before Flop
Seat 2: FDIBA2009 (button) (small blind) collected (200)



PokerStars Home Game Hand #227142641368: {Club #4781089}  Hold'em No Limit (50/100) - 2021/05/28 23:59:36 EET [2021/05/28 16:59:36 ET]
Table 'VTPP NLHE 2805' 2-max (Play Money) Seat #1 is the button
Seat 1: s70n3fac3 (6070 in chips) 
Seat 2: FDIBA2009 (17618 in chips) 
s70n3fac3: posts small blind 50
FDIBA2009: posts big blind 100
*** HOLE CARDS ***
s70n3fac3: raises 150 to 250
FDIBA2009: calls 150
*** FLOP *** [Kh Th Ah]
FDIBA2009: checks 
s70n3fac3: bets 200
FDIBA2009: calls 200
*** TURN *** [Kh Th Ah] [Ks]
FDIBA2009: checks 
s70n3fac3: bets 400
FDIBA2009: calls 400
*** RIVER *** [Kh Th Ah Ks] [8s]
FDIBA2009: checks 
s70n3fac3: checks 
*** SHOW DOWN ***
FDIBA2009: shows [Kc 3c] (three of a kind, Kings)
s70n3fac3: mucks hand 
FDIBA2009 collected 1606 from pot
*** SUMMARY ***
Total pot 1700 | Rake 94 
Board [Kh Th Ah Ks 8s]
Seat 1: s70n3fac3 (button) (small blind) mucked [7d Qd]
Seat 2: FDIBA2009 (big blind) showed [Kc 3c] and won (1606) with three of a kind, Kings



PokerStars Home Game Hand #227142653494: {Club #4781089}  Hold'em No Limit (50/100) - 2021/05/29 0:00:07 EET [2021/05/28 17:00:07 ET]
Table 'VTPP NLHE 2805' 2-max (Play Money) Seat #2 is the button
Seat 1: s70n3fac3 (5220 in chips) 
Seat 2: FDIBA2009 (18374 in chips) 
FDIBA2009: posts small blind 50
s70n3fac3: posts big blind 100
*** HOLE CARDS ***
FDIBA2009: raises 100 to 200
s70n3fac3: calls 100
*** FLOP *** [Kc 3s 4s]
s70n3fac3: checks 
FDIBA2009: checks 
*** TURN *** [Kc 3s 4s] [2d]
s70n3fac3: bets 200
FDIBA2009: folds 
Uncalled bet (200) returned to s70n3fac3
s70n3fac3 collected 378 from pot
s70n3fac3: doesn't show hand 
*** SUMMARY ***
Total pot 400 | Rake 22 
Board [Kc 3s 4s 2d]
Seat 1: s70n3fac3 (big blind) collected (378)
Seat 2: FDIBA2009 (button) (small blind) folded on the Turn



PokerStars Home Game Hand #227142661995: {Club #4781089}  Hold'em No Limit (50/100) - 2021/05/29 0:00:27 EET [2021/05/28 17:00:27 ET]
Table 'VTPP NLHE 2805' 2-max (Play Money) Seat #1 is the button
Seat 1: s70n3fac3 (5398 in chips) 
Seat 2: FDIBA2009 (18174 in chips) 
s70n3fac3: posts small blind 50
FDIBA2009: posts big blind 100
*** HOLE CARDS ***
s70n3fac3: folds 
Uncalled bet (50) returned to FDIBA2009
FDIBA2009 collected 100 from pot
FDIBA2009: doesn't show hand 
*** SUMMARY ***
Total pot 100 | Rake 0 
Seat 1: s70n3fac3 (button) (small blind) folded before Flop
Seat 2: FDIBA2009 (big blind) collected (100)



PokerStars Home Game Hand #227142663452: {Club #4781089}  Hold'em No Limit (50/100) - 2021/05/29 0:00:31 EET [2021/05/28 17:00:31 ET]
Table 'VTPP NLHE 2805' 2-max (Play Money) Seat #2 is the button
Seat 1: s70n3fac3 (5348 in chips) 
Seat 2: FDIBA2009 (18224 in chips) 
FDIBA2009: posts small blind 50
s70n3fac3: posts big blind 100
*** HOLE CARDS ***
FDIBA2009: raises 100 to 200
s70n3fac3: calls 100
*** FLOP *** [7d 5s Ks]
s70n3fac3: checks 
FDIBA2009: checks 
*** TURN *** [7d 5s Ks] [3s]
s70n3fac3: bets 200
FDIBA2009: raises 550 to 750
s70n3fac3: folds 
Uncalled bet (550) returned to FDIBA2009
FDIBA2009 collected 756 from pot
FDIBA2009: doesn't show hand 
*** SUMMARY ***
Total pot 800 | Rake 44 
Board [7d 5s Ks 3s]
Seat 1: s70n3fac3 (big blind) folded on the Turn
Seat 2: FDIBA2009 (button) (small blind) collected (756)



PokerStars Home Game Hand #227142678674: {Club #4781089}  Hold'em No Limit (50/100) - 2021/05/29 0:01:05 EET [2021/05/28 17:01:05 ET]
Table 'VTPP NLHE 2805' 2-max (Play Money) Seat #1 is the button
Seat 1: s70n3fac3 (4948 in chips) 
Seat 2: FDIBA2009 (18580 in chips) 
s70n3fac3: posts small blind 50
FDIBA2009: posts big blind 100
*** HOLE CARDS ***
s70n3fac3: raises 150 to 250
FDIBA2009: folds 
Uncalled bet (150) returned to s70n3fac3
s70n3fac3 collected 200 from pot
s70n3fac3: doesn't show hand 
*** SUMMARY ***
Total pot 200 | Rake 0 
Seat 1: s70n3fac3 (button) (small blind) collected (200)
Seat 2: FDIBA2009 (big blind) folded before Flop



PokerStars Home Game Hand #227142682420: {Club #4781089}  Hold'em No Limit (50/100) - 2021/05/29 0:01:13 EET [2021/05/28 17:01:13 ET]
Table 'VTPP NLHE 2805' 2-max (Play Money) Seat #2 is the button
Seat 1: s70n3fac3 (5048 in chips) 
Seat 2: FDIBA2009 (18480 in chips) 
FDIBA2009: posts small blind 50
s70n3fac3: posts big blind 100
*** HOLE CARDS ***
FDIBA2009: raises 100 to 200
s70n3fac3: raises 450 to 650
FDIBA2009: folds 
Uncalled bet (450) returned to s70n3fac3
s70n3fac3 collected 400 from pot
s70n3fac3: doesn't show hand 
*** SUMMARY ***
Total pot 400 | Rake 0 
Seat 1: s70n3fac3 (big blind) collected (400)
Seat 2: FDIBA2009 (button) (small blind) folded before Flop



PokerStars Home Game Hand #227142688563: {Club #4781089}  Hold'em No Limit (50/100) - 2021/05/29 0:01:26 EET [2021/05/28 17:01:26 ET]
Table 'VTPP NLHE 2805' 2-max (Play Money) Seat #1 is the button
Seat 1: s70n3fac3 (5248 in chips) 
Seat 2: FDIBA2009 (18280 in chips) 
s70n3fac3: posts small blind 50
FDIBA2009: posts big blind 100
*** HOLE CARDS ***
s70n3fac3: raises 150 to 250
FDIBA2009: calls 150
*** FLOP *** [3c Ks 7s]
FDIBA2009: checks 
s70n3fac3: checks 
*** TURN *** [3c Ks 7s] [6s]
FDIBA2009: bets 250
s70n3fac3: calls 250
*** RIVER *** [3c Ks 7s 6s] [4h]
FDIBA2009: checks 
s70n3fac3: checks 
*** SHOW DOWN ***
FDIBA2009: shows [Qs Ts] (a flush, King high)
s70n3fac3: mucks hand 
FDIBA2009 collected 945 from pot
*** SUMMARY ***
Total pot 1000 | Rake 55 
Board [3c Ks 7s 6s 4h]
Seat 1: s70n3fac3 (button) (small blind) mucked [Js 9d]
Seat 2: FDIBA2009 (big blind) showed [Qs Ts] and won (945) with a flush, King high



PokerStars Home Game Hand #227142702010: {Club #4781089}  Hold'em No Limit (50/100) - 2021/05/29 0:01:53 EET [2021/05/28 17:01:53 ET]
Table 'VTPP NLHE 2805' 2-max (Play Money) Seat #2 is the button
Seat 1: s70n3fac3 (4748 in chips) 
Seat 2: FDIBA2009 (18725 in chips) 
FDIBA2009: posts small blind 50
s70n3fac3: posts big blind 100
*** HOLE CARDS ***
FDIBA2009: raises 100 to 200
s70n3fac3: calls 100
*** FLOP *** [4s Tc Th]
s70n3fac3: checks 
FDIBA2009: checks 
*** TURN *** [4s Tc Th] [Ts]
s70n3fac3: checks 
FDIBA2009: bets 200
s70n3fac3: folds 
Uncalled bet (200) returned to FDIBA2009
FDIBA2009 collected 378 from pot
FDIBA2009: doesn't show hand 
*** SUMMARY ***
Total pot 400 | Rake 22 
Board [4s Tc Th Ts]
Seat 1: s70n3fac3 (big blind) folded on the Turn
Seat 2: FDIBA2009 (button) (small blind) collected (378)



PokerStars Home Game Hand #227142710360: {Club #4781089}  Hold'em No Limit (50/100) - 2021/05/29 0:02:10 EET [2021/05/28 17:02:10 ET]
Table 'VTPP NLHE 2805' 2-max (Play Money) Seat #1 is the button
Seat 1: s70n3fac3 (4548 in chips) 
Seat 2: FDIBA2009 (18903 in chips) 
s70n3fac3: posts small blind 50
FDIBA2009: posts big blind 100
*** HOLE CARDS ***
s70n3fac3: folds 
Uncalled bet (50) returned to FDIBA2009
FDIBA2009 collected 100 from pot
FDIBA2009: doesn't show hand 
*** SUMMARY ***
Total pot 100 | Rake 0 
Seat 1: s70n3fac3 (button) (small blind) folded before Flop
Seat 2: FDIBA2009 (big blind) collected (100)



PokerStars Home Game Hand #227142712462: {Club #4781089}  Hold'em No Limit (50/100) - 2021/05/29 0:02:13 EET [2021/05/28 17:02:13 ET]
Table 'VTPP NLHE 2805' 2-max (Play Money) Seat #2 is the button
Seat 1: s70n3fac3 (4498 in chips) 
Seat 2: FDIBA2009 (18953 in chips) 
FDIBA2009: posts small blind 50
s70n3fac3: posts big blind 100
*** HOLE CARDS ***
FDIBA2009: raises 100 to 200
s70n3fac3: folds 
Uncalled bet (100) returned to FDIBA2009
FDIBA2009 collected 200 from pot
FDIBA2009: doesn't show hand 
*** SUMMARY ***
Total pot 200 | Rake 0 
Seat 1: s70n3fac3 (big blind) folded before Flop
Seat 2: FDIBA2009 (button) (small blind) collected (200)



PokerStars Home Game Hand #227142715701: {Club #4781089}  Hold'em No Limit (50/100) - 2021/05/29 0:02:20 EET [2021/05/28 17:02:20 ET]
Table 'VTPP NLHE 2805' 2-max (Play Money) Seat #1 is the button
Seat 1: s70n3fac3 (4398 in chips) 
Seat 2: FDIBA2009 (19053 in chips) 
s70n3fac3: posts small blind 50
FDIBA2009: posts big blind 100
*** HOLE CARDS ***
s70n3fac3: raises 150 to 250
FDIBA2009: calls 150
*** FLOP *** [Th Ad 5h]
FDIBA2009: checks 
s70n3fac3: bets 300
FDIBA2009: folds 
Uncalled bet (300) returned to s70n3fac3
s70n3fac3 collected 472 from pot
s70n3fac3: doesn't show hand 
*** SUMMARY ***
Total pot 500 | Rake 28 
Board [Th Ad 5h]
Seat 1: s70n3fac3 (button) (small blind) collected (472)
Seat 2: FDIBA2009 (big blind) folded on the Flop



PokerStars Home Game Hand #227142723327: {Club #4781089}  Hold'em No Limit (50/100) - 2021/05/29 0:02:35 EET [2021/05/28 17:02:35 ET]
Table 'VTPP NLHE 2805' 2-max (Play Money) Seat #2 is the button
Seat 1: s70n3fac3 (4620 in chips) 
Seat 2: FDIBA2009 (18803 in chips) 
FDIBA2009: posts small blind 50
s70n3fac3: posts big blind 100
*** HOLE CARDS ***
FDIBA2009: folds 
Uncalled bet (50) returned to s70n3fac3
s70n3fac3 collected 100 from pot
s70n3fac3: doesn't show hand 
*** SUMMARY ***
Total pot 100 | Rake 0 
Seat 1: s70n3fac3 (big blind) collected (100)
Seat 2: FDIBA2009 (button) (small blind) folded before Flop



PokerStars Home Game Hand #227142726330: {Club #4781089}  Hold'em No Limit (50/100) - 2021/05/29 0:02:41 EET [2021/05/28 17:02:41 ET]
Table 'VTPP NLHE 2805' 2-max (Play Money) Seat #1 is the button
Seat 1: s70n3fac3 (4670 in chips) 
Seat 2: FDIBA2009 (18753 in chips) 
s70n3fac3: posts small blind 50
FDIBA2009: posts big blind 100
*** HOLE CARDS ***
s70n3fac3: folds 
Uncalled bet (50) returned to FDIBA2009
FDIBA2009 collected 100 from pot
FDIBA2009: doesn't show hand 
*** SUMMARY ***
Total pot 100 | Rake 0 
Seat 1: s70n3fac3 (button) (small blind) folded before Flop
Seat 2: FDIBA2009 (big blind) collected (100)



PokerStars Home Game Hand #227142728154: {Club #4781089}  Hold'em No Limit (50/100) - 2021/05/29 0:02:44 EET [2021/05/28 17:02:44 ET]
Table 'VTPP NLHE 2805' 2-max (Play Money) Seat #2 is the button
Seat 1: s70n3fac3 (4620 in chips) 
Seat 2: FDIBA2009 (18803 in chips) 
FDIBA2009: posts small blind 50
s70n3fac3: posts big blind 100
*** HOLE CARDS ***
FDIBA2009: raises 100 to 200
s70n3fac3: raises 450 to 650
FDIBA2009: calls 450
*** FLOP *** [Ks 7d 5s]
s70n3fac3: checks 
FDIBA2009: bets 1050
s70n3fac3 has timed out
s70n3fac3: folds 
Uncalled bet (1050) returned to FDIBA2009
FDIBA2009 collected 1228 from pot
FDIBA2009: doesn't show hand 
*** SUMMARY ***
Total pot 1300 | Rake 72 
Board [Ks 7d 5s]
Seat 1: s70n3fac3 (big blind) folded on the Flop
Seat 2: FDIBA2009 (button) (small blind) collected (1228)



PokerStars Home Game Hand #227142762691: {Club #4781089}  Hold'em No Limit (50/100) - 2021/05/29 0:03:47 EET [2021/05/28 17:03:47 ET]
Table 'VTPP NLHE 2805' 2-max (Play Money) Seat #1 is the button
Seat 1: s70n3fac3 (9970 in chips) 
Seat 2: FDIBA2009 (19381 in chips) 
s70n3fac3: posts small blind 50
FDIBA2009: posts big blind 100
*** HOLE CARDS ***
s70n3fac3: folds 
Uncalled bet (50) returned to FDIBA2009
FDIBA2009 collected 100 from pot
FDIBA2009: doesn't show hand 
*** SUMMARY ***
Total pot 100 | Rake 0 
Seat 1: s70n3fac3 (button) (small blind) folded before Flop
Seat 2: FDIBA2009 (big blind) collected (100)



PokerStars Home Game Hand #227142764727: {Club #4781089}  Hold'em No Limit (50/100) - 2021/05/29 0:03:51 EET [2021/05/28 17:03:51 ET]
Table 'VTPP NLHE 2805' 2-max (Play Money) Seat #2 is the button
Seat 1: s70n3fac3 (9920 in chips) 
Seat 2: FDIBA2009 (19431 in chips) 
FDIBA2009: posts small blind 50
s70n3fac3: posts big blind 100
*** HOLE CARDS ***
FDIBA2009: raises 100 to 200
s70n3fac3: folds 
Uncalled bet (100) returned to FDIBA2009
FDIBA2009 collected 200 from pot
FDIBA2009: doesn't show hand 
*** SUMMARY ***
Total pot 200 | Rake 0 
Seat 1: s70n3fac3 (big blind) folded before Flop
Seat 2: FDIBA2009 (button) (small blind) collected (200)



PokerStars Home Game Hand #227142768306: {Club #4781089}  Hold'em No Limit (50/100) - 2021/05/29 0:03:57 EET [2021/05/28 17:03:57 ET]
Table 'VTPP NLHE 2805' 2-max (Play Money) Seat #1 is the button
Seat 1: s70n3fac3 (9820 in chips) 
Seat 2: FDIBA2009 (19531 in chips) 
s70n3fac3: posts small blind 50
FDIBA2009: posts big blind 100
*** HOLE CARDS ***
s70n3fac3: raises 150 to 250
FDIBA2009: calls 150
*** FLOP *** [Kh 5c 3c]
FDIBA2009: checks 
s70n3fac3: bets 300
FDIBA2009: folds 
Uncalled bet (300) returned to s70n3fac3
s70n3fac3 collected 472 from pot
s70n3fac3: doesn't show hand 
*** SUMMARY ***
Total pot 500 | Rake 28 
Board [Kh 5c 3c]
Seat 1: s70n3fac3 (button) (small blind) collected (472)
Seat 2: FDIBA2009 (big blind) folded on the Flop



PokerStars Home Game Hand #227142780773: {Club #4781089}  Hold'em No Limit (50/100) - 2021/05/29 0:04:20 EET [2021/05/28 17:04:20 ET]
Table 'VTPP NLHE 2805' 2-max (Play Money) Seat #2 is the button
Seat 1: s70n3fac3 (10042 in chips) 
Seat 2: FDIBA2009 (19281 in chips) 
FDIBA2009: posts small blind 50
s70n3fac3: posts big blind 100
*** HOLE CARDS ***
FDIBA2009: raises 100 to 200
s70n3fac3: calls 100
*** FLOP *** [Kc Jh Jd]
s70n3fac3: checks 
FDIBA2009: bets 200
s70n3fac3: folds 
Uncalled bet (200) returned to FDIBA2009
FDIBA2009 collected 378 from pot
FDIBA2009: doesn't show hand 
*** SUMMARY ***
Total pot 400 | Rake 22 
Board [Kc Jh Jd]
Seat 1: s70n3fac3 (big blind) folded on the Flop
Seat 2: FDIBA2009 (button) (small blind) collected (378)



PokerStars Home Game Hand #227142792261: {Club #4781089}  Hold'em No Limit (50/100) - 2021/05/29 0:04:41 EET [2021/05/28 17:04:41 ET]
Table 'VTPP NLHE 2805' 2-max (Play Money) Seat #1 is the button
Seat 1: s70n3fac3 (9842 in chips) 
Seat 2: FDIBA2009 (19459 in chips) 
s70n3fac3: posts small blind 50
FDIBA2009: posts big blind 100
*** HOLE CARDS ***
s70n3fac3: raises 150 to 250
FDIBA2009: calls 150
*** FLOP *** [Jc Ts Jh]
FDIBA2009: checks 
s70n3fac3: checks 
*** TURN *** [Jc Ts Jh] [7h]
FDIBA2009: bets 200
s70n3fac3: raises 365 to 565
FDIBA2009: calls 365
*** RIVER *** [Jc Ts Jh 7h] [3h]
FDIBA2009: checks 
s70n3fac3: bets 950
FDIBA2009: calls 950
*** SHOW DOWN ***
s70n3fac3: shows [8s Kh] (a pair of Jacks)
FDIBA2009: shows [Ad 7d] (two pair, Jacks and Sevens)
FDIBA2009 collected 3336 from pot
*** SUMMARY ***
Total pot 3530 | Rake 194 
Board [Jc Ts Jh 7h 3h]
Seat 1: s70n3fac3 (button) (small blind) showed [8s Kh] and lost with a pair of Jacks
Seat 2: FDIBA2009 (big blind) showed [Ad 7d] and won (3336) with two pair, Jacks and Sevens



PokerStars Home Game Hand #227142818675: {Club #4781089}  Hold'em No Limit (50/100) - 2021/05/29 0:05:29 EET [2021/05/28 17:05:29 ET]
Table 'VTPP NLHE 2805' 2-max (Play Money) Seat #2 is the button
Seat 1: s70n3fac3 (8077 in chips) 
Seat 2: FDIBA2009 (21030 in chips) 
FDIBA2009: posts small blind 50
s70n3fac3: posts big blind 100
*** HOLE CARDS ***
FDIBA2009: raises 100 to 200
s70n3fac3: calls 100
*** FLOP *** [Qh 6h Ts]
s70n3fac3: checks 
FDIBA2009: bets 200
s70n3fac3: folds 
Uncalled bet (200) returned to FDIBA2009
FDIBA2009 collected 378 from pot
FDIBA2009: doesn't show hand 
*** SUMMARY ***
Total pot 400 | Rake 22 
Board [Qh 6h Ts]
Seat 1: s70n3fac3 (big blind) folded on the Flop
Seat 2: FDIBA2009 (button) (small blind) collected (378)



PokerStars Home Game Hand #227142832621: {Club #4781089}  Hold'em No Limit (50/100) - 2021/05/29 0:05:55 EET [2021/05/28 17:05:55 ET]
Table 'VTPP NLHE 2805' 2-max (Play Money) Seat #1 is the button
Seat 1: s70n3fac3 (7877 in chips) 
Seat 2: FDIBA2009 (21208 in chips) 
s70n3fac3: posts small blind 50
FDIBA2009: posts big blind 100
*** HOLE CARDS ***
s70n3fac3: raises 150 to 250
FDIBA2009: folds 
Uncalled bet (150) returned to s70n3fac3
s70n3fac3 collected 200 from pot
s70n3fac3: doesn't show hand 
*** SUMMARY ***
Total pot 200 | Rake 0 
Seat 1: s70n3fac3 (button) (small blind) collected (200)
Seat 2: FDIBA2009 (big blind) folded before Flop



PokerStars Home Game Hand #227142835681: {Club #4781089}  Hold'em No Limit (50/100) - 2021/05/29 0:06:00 EET [2021/05/28 17:06:00 ET]
Table 'VTPP NLHE 2805' 2-max (Play Money) Seat #2 is the button
Seat 1: s70n3fac3 (7977 in chips) 
Seat 2: FDIBA2009 (21108 in chips) 
FDIBA2009: posts small blind 50
s70n3fac3: posts big blind 100
*** HOLE CARDS ***
FDIBA2009: raises 100 to 200
s70n3fac3: folds 
Uncalled bet (100) returned to FDIBA2009
FDIBA2009 collected 200 from pot
FDIBA2009: doesn't show hand 
*** SUMMARY ***
Total pot 200 | Rake 0 
Seat 1: s70n3fac3 (big blind) folded before Flop
Seat 2: FDIBA2009 (button) (small blind) collected (200)



PokerStars Home Game Hand #227142839558: {Club #4781089}  Hold'em No Limit (50/100) - 2021/05/29 0:06:07 EET [2021/05/28 17:06:07 ET]
Table 'VTPP NLHE 2805' 2-max (Play Money) Seat #1 is the button
Seat 1: s70n3fac3 (7877 in chips) 
Seat 2: FDIBA2009 (21208 in chips) 
s70n3fac3: posts small blind 50
FDIBA2009: posts big blind 100
*** HOLE CARDS ***
s70n3fac3: raises 200 to 300
FDIBA2009: folds 
Uncalled bet (200) returned to s70n3fac3
s70n3fac3 collected 200 from pot
s70n3fac3: doesn't show hand 
*** SUMMARY ***
Total pot 200 | Rake 0 
Seat 1: s70n3fac3 (button) (small blind) collected (200)
Seat 2: FDIBA2009 (big blind) folded before Flop



PokerStars Home Game Hand #227142843761: {Club #4781089}  Hold'em No Limit (50/100) - 2021/05/29 0:06:15 EET [2021/05/28 17:06:15 ET]
Table 'VTPP NLHE 2805' 2-max (Play Money) Seat #2 is the button
Seat 1: s70n3fac3 (7977 in chips) 
Seat 2: FDIBA2009 (21108 in chips) 
FDIBA2009: posts small blind 50
s70n3fac3: posts big blind 100
*** HOLE CARDS ***
FDIBA2009: raises 100 to 200
s70n3fac3: raises 400 to 600
FDIBA2009: calls 400
*** FLOP *** [8c Td Jh]
s70n3fac3: checks 
FDIBA2009: checks 
*** TURN *** [8c Td Jh] [Ts]
s70n3fac3: checks 
FDIBA2009: checks 
*** RIVER *** [8c Td Jh Ts] [Ah]
s70n3fac3: checks 
FDIBA2009: bets 800
s70n3fac3: calls 800
*** SHOW DOWN ***
FDIBA2009: shows [4h 5d] (a pair of Tens)
s70n3fac3: shows [Ad 6s] (two pair, Aces and Tens)
s70n3fac3 collected 2646 from pot
*** SUMMARY ***
Total pot 2800 | Rake 154 
Board [8c Td Jh Ts Ah]
Seat 1: s70n3fac3 (big blind) showed [Ad 6s] and won (2646) with two pair, Aces and Tens
Seat 2: FDIBA2009 (button) (small blind) showed [4h 5d] and lost with a pair of Tens



PokerStars Home Game Hand #227142863057: {Club #4781089}  Hold'em No Limit (50/100) - 2021/05/29 0:06:50 EET [2021/05/28 17:06:50 ET]
Table 'VTPP NLHE 2805' 2-max (Play Money) Seat #1 is the button
Seat 1: s70n3fac3 (9223 in chips) 
Seat 2: FDIBA2009 (19708 in chips) 
s70n3fac3: posts small blind 50
FDIBA2009: posts big blind 100
*** HOLE CARDS ***
s70n3fac3: calls 50
FDIBA2009: checks 
*** FLOP *** [Ad Kd Kc]
FDIBA2009: checks 
s70n3fac3: checks 
*** TURN *** [Ad Kd Kc] [Ts]
FDIBA2009: checks 
s70n3fac3: checks 
*** RIVER *** [Ad Kd Kc Ts] [Kh]
FDIBA2009: checks 
s70n3fac3: checks 
*** SHOW DOWN ***
FDIBA2009: shows [9d 7c] (three of a kind, Kings)
s70n3fac3: shows [5d 8h] (three of a kind, Kings)
FDIBA2009 collected 95 from pot
s70n3fac3 collected 94 from pot
*** SUMMARY ***
Total pot 200 | Rake 11 
Board [Ad Kd Kc Ts Kh]
Seat 1: s70n3fac3 (button) (small blind) showed [5d 8h] and won (94) with three of a kind, Kings
Seat 2: FDIBA2009 (big blind) showed [9d 7c] and won (95) with three of a kind, Kings



PokerStars Home Game Hand #227142872862: {Club #4781089}  Hold'em No Limit (50/100) - 2021/05/29 0:07:07 EET [2021/05/28 17:07:07 ET]
Table 'VTPP NLHE 2805' 2-max (Play Money) Seat #2 is the button
Seat 1: s70n3fac3 (9217 in chips) 
Seat 2: FDIBA2009 (19703 in chips) 
FDIBA2009: posts small blind 50
s70n3fac3: posts big blind 100
*** HOLE CARDS ***
FDIBA2009: raises 100 to 200
s70n3fac3: calls 100
*** FLOP *** [6s 7c 5h]
s70n3fac3: checks 
FDIBA2009: bets 200
s70n3fac3: calls 200
*** TURN *** [6s 7c 5h] [Qc]
s70n3fac3: checks 
FDIBA2009: bets 400
s70n3fac3: calls 400
*** RIVER *** [6s 7c 5h Qc] [9h]
s70n3fac3: checks 
FDIBA2009: checks 
*** SHOW DOWN ***
s70n3fac3: shows [6c 8d] (a straight, Five to Nine)
FDIBA2009: mucks hand 
s70n3fac3 collected 1512 from pot
*** SUMMARY ***
Total pot 1600 | Rake 88 
Board [6s 7c 5h Qc 9h]
Seat 1: s70n3fac3 (big blind) showed [6c 8d] and won (1512) with a straight, Five to Nine
Seat 2: FDIBA2009 (button) (small blind) mucked [7h Td]



PokerStars Home Game Hand #227142890858: {Club #4781089}  Hold'em No Limit (50/100) - 2021/05/29 0:07:41 EET [2021/05/28 17:07:41 ET]
Table 'VTPP NLHE 2805' 2-max (Play Money) Seat #1 is the button
Seat 1: s70n3fac3 (9929 in chips) 
Seat 2: FDIBA2009 (18903 in chips) 
s70n3fac3: posts small blind 50
FDIBA2009: posts big blind 100
*** HOLE CARDS ***
s70n3fac3: calls 50
FDIBA2009: checks 
*** FLOP *** [4h 5h Js]
FDIBA2009: checks 
s70n3fac3: checks 
*** TURN *** [4h 5h Js] [Ts]
FDIBA2009: checks 
s70n3fac3: checks 
*** RIVER *** [4h 5h Js Ts] [Tc]
FDIBA2009: checks 
s70n3fac3: checks 
*** SHOW DOWN ***
FDIBA2009: shows [5d 3s] (two pair, Tens and Fives)
s70n3fac3: mucks hand 
FDIBA2009 collected 189 from pot
*** SUMMARY ***
Total pot 200 | Rake 11 
Board [4h 5h Js Ts Tc]
Seat 1: s70n3fac3 (button) (small blind) mucked [6s 9d]
Seat 2: FDIBA2009 (big blind) showed [5d 3s] and won (189) with two pair, Tens and Fives



PokerStars Home Game Hand #227142907045: {Club #4781089}  Hold'em No Limit (50/100) - 2021/05/29 0:08:10 EET [2021/05/28 17:08:10 ET]
Table 'VTPP NLHE 2805' 2-max (Play Money) Seat #2 is the button
Seat 1: s70n3fac3 (9829 in chips) 
Seat 2: FDIBA2009 (18992 in chips) 
FDIBA2009: posts small blind 50
s70n3fac3: posts big blind 100
*** HOLE CARDS ***
FDIBA2009: raises 100 to 200
s70n3fac3: folds 
Uncalled bet (100) returned to FDIBA2009
FDIBA2009 collected 200 from pot
FDIBA2009: doesn't show hand 
*** SUMMARY ***
Total pot 200 | Rake 0 
Seat 1: s70n3fac3 (big blind) folded before Flop
Seat 2: FDIBA2009 (button) (small blind) collected (200)



PokerStars Home Game Hand #227142911107: {Club #4781089}  Hold'em No Limit (50/100) - 2021/05/29 0:08:18 EET [2021/05/28 17:08:18 ET]
Table 'VTPP NLHE 2805' 2-max (Play Money) Seat #1 is the button
Seat 1: s70n3fac3 (9729 in chips) 
Seat 2: FDIBA2009 (19092 in chips) 
s70n3fac3: posts small blind 50
FDIBA2009: posts big blind 100
*** HOLE CARDS ***
s70n3fac3: raises 150 to 250
FDIBA2009: calls 150
*** FLOP *** [4s 4d 6d]
FDIBA2009: checks 
s70n3fac3: checks 
*** TURN *** [4s 4d 6d] [Qh]
FDIBA2009: checks 
s70n3fac3: bets 200
FDIBA2009: folds 
Uncalled bet (200) returned to s70n3fac3
s70n3fac3 collected 472 from pot
s70n3fac3: doesn't show hand 
*** SUMMARY ***
Total pot 500 | Rake 28 
Board [4s 4d 6d Qh]
Seat 1: s70n3fac3 (button) (small blind) collected (472)
Seat 2: FDIBA2009 (big blind) folded on the Turn



PokerStars Home Game Hand #227142921457: {Club #4781089}  Hold'em No Limit (50/100) - 2021/05/29 0:08:36 EET [2021/05/28 17:08:36 ET]
Table 'VTPP NLHE 2805' 2-max (Play Money) Seat #2 is the button
Seat 1: s70n3fac3 (9951 in chips) 
Seat 2: FDIBA2009 (18842 in chips) 
FDIBA2009: posts small blind 50
s70n3fac3: posts big blind 100
*** HOLE CARDS ***
FDIBA2009: raises 100 to 200
s70n3fac3: calls 100
*** FLOP *** [5c 3d Kh]
s70n3fac3: checks 
FDIBA2009: bets 200
s70n3fac3: raises 400 to 600
FDIBA2009: calls 400
*** TURN *** [5c 3d Kh] [6s]
s70n3fac3: checks 
FDIBA2009: bets 800
s70n3fac3: calls 800
*** RIVER *** [5c 3d Kh 6s] [3s]
s70n3fac3: checks 
FDIBA2009: checks 
*** SHOW DOWN ***
s70n3fac3: shows [5s 7s] (two pair, Fives and Threes)
FDIBA2009: shows [Kc 5d] (two pair, Kings and Fives)
FDIBA2009 collected 3024 from pot
*** SUMMARY ***
Total pot 3200 | Rake 176 
Board [5c 3d Kh 6s 3s]
Seat 1: s70n3fac3 (big blind) showed [5s 7s] and lost with two pair, Fives and Threes
Seat 2: FDIBA2009 (button) (small blind) showed [Kc 5d] and won (3024) with two pair, Kings and Fives



PokerStars Home Game Hand #227142944699: {Club #4781089}  Hold'em No Limit (50/100) - 2021/05/29 0:09:19 EET [2021/05/28 17:09:19 ET]
Table 'VTPP NLHE 2805' 2-max (Play Money) Seat #1 is the button
Seat 1: s70n3fac3 (8351 in chips) 
Seat 2: FDIBA2009 (20266 in chips) 
s70n3fac3: posts small blind 50
FDIBA2009: posts big blind 100
*** HOLE CARDS ***
s70n3fac3: raises 150 to 250
FDIBA2009: folds 
Uncalled bet (150) returned to s70n3fac3
s70n3fac3 collected 200 from pot
s70n3fac3: doesn't show hand 
*** SUMMARY ***
Total pot 200 | Rake 0 
Seat 1: s70n3fac3 (button) (small blind) collected (200)
Seat 2: FDIBA2009 (big blind) folded before Flop



PokerStars Home Game Hand #227142951376: {Club #4781089}  Hold'em No Limit (50/100) - 2021/05/29 0:09:31 EET [2021/05/28 17:09:31 ET]
Table 'VTPP NLHE 2805' 2-max (Play Money) Seat #2 is the button
Seat 1: s70n3fac3 (8451 in chips) 
Seat 2: FDIBA2009 (20166 in chips) 
FDIBA2009: posts small blind 50
s70n3fac3: posts big blind 100
*** HOLE CARDS ***
FDIBA2009: raises 100 to 200
s70n3fac3: calls 100
*** FLOP *** [8s Td 8h]
s70n3fac3: checks 
FDIBA2009: bets 189
s70n3fac3: folds 
Uncalled bet (189) returned to FDIBA2009
FDIBA2009 collected 378 from pot
FDIBA2009: doesn't show hand 
*** SUMMARY ***
Total pot 400 | Rake 22 
Board [8s Td 8h]
Seat 1: s70n3fac3 (big blind) folded on the Flop
Seat 2: FDIBA2009 (button) (small blind) collected (378)



PokerStars Home Game Hand #227142967443: {Club #4781089}  Hold'em No Limit (50/100) - 2021/05/29 0:09:50 EET [2021/05/28 17:09:50 ET]
Table 'VTPP NLHE 2805' 2-max (Play Money) Seat #1 is the button
Seat 1: s70n3fac3 (8251 in chips) 
Seat 2: FDIBA2009 (20344 in chips) 
s70n3fac3: posts small blind 50
FDIBA2009: posts big blind 100
*** HOLE CARDS ***
s70n3fac3: calls 50
FDIBA2009: raises 200 to 300
s70n3fac3: folds 
Uncalled bet (200) returned to FDIBA2009
FDIBA2009 collected 200 from pot
FDIBA2009: doesn't show hand 
*** SUMMARY ***
Total pot 200 | Rake 0 
Seat 1: s70n3fac3 (button) (small blind) folded before Flop
Seat 2: FDIBA2009 (big blind) collected (200)



PokerStars Home Game Hand #227142973034: {Club #4781089}  Hold'em No Limit (50/100) - 2021/05/29 0:10:00 EET [2021/05/28 17:10:00 ET]
Table 'VTPP NLHE 2805' 2-max (Play Money) Seat #2 is the button
Seat 1: s70n3fac3 (8151 in chips) 
Seat 2: FDIBA2009 (20444 in chips) 
FDIBA2009: posts small blind 50
s70n3fac3: posts big blind 100
*** HOLE CARDS ***
FDIBA2009: raises 100 to 200
s70n3fac3: calls 100
*** FLOP *** [Jd 8c 3h]
s70n3fac3: checks 
FDIBA2009: checks 
*** TURN *** [Jd 8c 3h] [7c]
s70n3fac3: checks 
FDIBA2009: checks 
*** RIVER *** [Jd 8c 3h 7c] [6c]
s70n3fac3: bets 300
FDIBA2009: folds 
Uncalled bet (300) returned to s70n3fac3
s70n3fac3 collected 378 from pot
s70n3fac3: doesn't show hand 
*** SUMMARY ***
Total pot 400 | Rake 22 
Board [Jd 8c 3h 7c 6c]
Seat 1: s70n3fac3 (big blind) collected (378)
Seat 2: FDIBA2009 (button) (small blind) folded on the River



PokerStars Home Game Hand #227142986959: {Club #4781089}  Hold'em No Limit (50/100) - 2021/05/29 0:10:26 EET [2021/05/28 17:10:26 ET]
Table 'VTPP NLHE 2805' 2-max (Play Money) Seat #1 is the button
Seat 1: s70n3fac3 (8329 in chips) 
Seat 2: FDIBA2009 (20244 in chips) 
s70n3fac3: posts small blind 50
FDIBA2009: posts big blind 100
*** HOLE CARDS ***
s70n3fac3: raises 150 to 250
FDIBA2009: raises 400 to 650
s70n3fac3: folds 
Uncalled bet (400) returned to FDIBA2009
FDIBA2009 collected 500 from pot
FDIBA2009: doesn't show hand 
*** SUMMARY ***
Total pot 500 | Rake 0 
Seat 1: s70n3fac3 (button) (small blind) folded before Flop
Seat 2: FDIBA2009 (big blind) collected (500)



PokerStars Home Game Hand #227142993371: {Club #4781089}  Hold'em No Limit (50/100) - 2021/05/29 0:10:37 EET [2021/05/28 17:10:37 ET]
Table 'VTPP NLHE 2805' 2-max (Play Money) Seat #2 is the button
Seat 1: s70n3fac3 (8079 in chips) 
Seat 2: FDIBA2009 (20494 in chips) 
FDIBA2009: posts small blind 50
s70n3fac3: posts big blind 100
*** HOLE CARDS ***
FDIBA2009: raises 100 to 200
s70n3fac3: raises 450 to 650
FDIBA2009: calls 450
*** FLOP *** [Qs Js Ts]
s70n3fac3: bets 650
FDIBA2009: calls 650
*** TURN *** [Qs Js Ts] [4s]
s70n3fac3: bets 950
FDIBA2009: calls 950
*** RIVER *** [Qs Js Ts 4s] [4d]
s70n3fac3: bets 1800
FDIBA2009 has timed out
FDIBA2009: folds 
Uncalled bet (1800) returned to s70n3fac3
s70n3fac3 collected 4252 from pot
s70n3fac3: doesn't show hand 
*** SUMMARY ***
Total pot 4500 | Rake 248 
Board [Qs Js Ts 4s 4d]
Seat 1: s70n3fac3 (big blind) collected (4252)
Seat 2: FDIBA2009 (button) (small blind) folded on the River



PokerStars Home Game Hand #227143032054: {Club #4781089}  Hold'em No Limit (50/100) - 2021/05/29 0:11:46 EET [2021/05/28 17:11:46 ET]
Table 'VTPP NLHE 2805' 2-max (Play Money) Seat #1 is the button
Seat 1: s70n3fac3 (10081 in chips) 
Seat 2: FDIBA2009 (18244 in chips) 
s70n3fac3: posts small blind 50
FDIBA2009: posts big blind 100
*** HOLE CARDS ***
s70n3fac3: folds 
Uncalled bet (50) returned to FDIBA2009
FDIBA2009 collected 100 from pot
FDIBA2009: doesn't show hand 
*** SUMMARY ***
Total pot 100 | Rake 0 
Seat 1: s70n3fac3 (button) (small blind) folded before Flop
Seat 2: FDIBA2009 (big blind) collected (100)



PokerStars Home Game Hand #227143034131: {Club #4781089}  Hold'em No Limit (50/100) - 2021/05/29 0:11:50 EET [2021/05/28 17:11:50 ET]
Table 'VTPP NLHE 2805' 2-max (Play Money) Seat #2 is the button
Seat 1: s70n3fac3 (10031 in chips) 
Seat 2: FDIBA2009 (18294 in chips) 
FDIBA2009: posts small blind 50
s70n3fac3: posts big blind 100
*** HOLE CARDS ***
FDIBA2009: raises 100 to 200
s70n3fac3: calls 100
*** FLOP *** [9h Qc Qs]
s70n3fac3: checks 
FDIBA2009: checks 
*** TURN *** [9h Qc Qs] [8d]
s70n3fac3: bets 200
FDIBA2009: calls 200
*** RIVER *** [9h Qc Qs 8d] [9c]
s70n3fac3: checks 
FDIBA2009: checks 
*** SHOW DOWN ***
s70n3fac3: shows [Th Js] (a straight, Eight to Queen)
FDIBA2009: mucks hand 
s70n3fac3 collected 756 from pot
*** SUMMARY ***
Total pot 800 | Rake 44 
Board [9h Qc Qs 8d 9c]
Seat 1: s70n3fac3 (big blind) showed [Th Js] and won (756) with a straight, Eight to Queen
Seat 2: FDIBA2009 (button) (small blind) mucked [2s 8c]



PokerStars Home Game Hand #227143043972: {Club #4781089}  Hold'em No Limit (50/100) - 2021/05/29 0:12:08 EET [2021/05/28 17:12:08 ET]
Table 'VTPP NLHE 2805' 2-max (Play Money) Seat #1 is the button
Seat 1: s70n3fac3 (10387 in chips) 
Seat 2: FDIBA2009 (17894 in chips) 
s70n3fac3: posts small blind 50
FDIBA2009: posts big blind 100
*** HOLE CARDS ***
s70n3fac3: calls 50
FDIBA2009: raises 200 to 300
s70n3fac3: folds 
Uncalled bet (200) returned to FDIBA2009
FDIBA2009 collected 200 from pot
FDIBA2009: doesn't show hand 
*** SUMMARY ***
Total pot 200 | Rake 0 
Seat 1: s70n3fac3 (button) (small blind) folded before Flop
Seat 2: FDIBA2009 (big blind) collected (200)



PokerStars Home Game Hand #227143047957: {Club #4781089}  Hold'em No Limit (50/100) - 2021/05/29 0:12:16 EET [2021/05/28 17:12:16 ET]
Table 'VTPP NLHE 2805' 2-max (Play Money) Seat #2 is the button
Seat 1: s70n3fac3 (10287 in chips) 
Seat 2: FDIBA2009 (17994 in chips) 
FDIBA2009: posts small blind 50
s70n3fac3: posts big blind 100
*** HOLE CARDS ***
FDIBA2009: raises 100 to 200
s70n3fac3: calls 100
*** FLOP *** [Td Jc 4c]
s70n3fac3: checks 
FDIBA2009: bets 200
s70n3fac3: folds 
Uncalled bet (200) returned to FDIBA2009
FDIBA2009 collected 378 from pot
FDIBA2009: doesn't show hand 
*** SUMMARY ***
Total pot 400 | Rake 22 
Board [Td Jc 4c]
Seat 1: s70n3fac3 (big blind) folded on the Flop
Seat 2: FDIBA2009 (button) (small blind) collected (378)



PokerStars Home Game Hand #227143057353: {Club #4781089}  Hold'em No Limit (50/100) - 2021/05/29 0:12:33 EET [2021/05/28 17:12:33 ET]
Table 'VTPP NLHE 2805' 2-max (Play Money) Seat #1 is the button
Seat 1: s70n3fac3 (10087 in chips) 
Seat 2: FDIBA2009 (18172 in chips) 
s70n3fac3: posts small blind 50
FDIBA2009: posts big blind 100
*** HOLE CARDS ***
s70n3fac3: raises 150 to 250
FDIBA2009: calls 150
*** FLOP *** [3d 9h 4h]
FDIBA2009: checks 
s70n3fac3: bets 300
FDIBA2009: calls 300
*** TURN *** [3d 9h 4h] [Tc]
FDIBA2009: checks 
s70n3fac3: bets 555
FDIBA2009: calls 555
*** RIVER *** [3d 9h 4h Tc] [Td]
FDIBA2009: checks 
s70n3fac3: bets 1025
FDIBA2009: folds 
Uncalled bet (1025) returned to s70n3fac3
s70n3fac3 collected 2088 from pot
s70n3fac3: doesn't show hand 
*** SUMMARY ***
Total pot 2210 | Rake 122 
Board [3d 9h 4h Tc Td]
Seat 1: s70n3fac3 (button) (small blind) collected (2088)
Seat 2: FDIBA2009 (big blind) folded on the River



PokerStars Home Game Hand #227143080033: {Club #4781089}  Hold'em No Limit (50/100) - 2021/05/29 0:13:15 EET [2021/05/28 17:13:15 ET]
Table 'VTPP NLHE 2805' 2-max (Play Money) Seat #2 is the button
Seat 1: s70n3fac3 (11070 in chips) 
Seat 2: FDIBA2009 (17067 in chips) 
FDIBA2009: posts small blind 50
s70n3fac3: posts big blind 100
*** HOLE CARDS ***
FDIBA2009: raises 100 to 200
s70n3fac3: folds 
Uncalled bet (100) returned to FDIBA2009
FDIBA2009 collected 200 from pot
FDIBA2009: doesn't show hand 
*** SUMMARY ***
Total pot 200 | Rake 0 
Seat 1: s70n3fac3 (big blind) folded before Flop
Seat 2: FDIBA2009 (button) (small blind) collected (200)



PokerStars Home Game Hand #227143083593: {Club #4781089}  Hold'em No Limit (50/100) - 2021/05/29 0:13:22 EET [2021/05/28 17:13:22 ET]
Table 'VTPP NLHE 2805' 2-max (Play Money) Seat #1 is the button
Seat 1: s70n3fac3 (10970 in chips) 
Seat 2: FDIBA2009 (17167 in chips) 
s70n3fac3: posts small blind 50
FDIBA2009: posts big blind 100
*** HOLE CARDS ***
s70n3fac3: calls 50
FDIBA2009: checks 
*** FLOP *** [6h Kh 8d]
FDIBA2009: checks 
s70n3fac3: checks 
*** TURN *** [6h Kh 8d] [4c]
FDIBA2009: bets 189
s70n3fac3: raises 311 to 500
FDIBA2009: calls 311
*** RIVER *** [6h Kh 8d 4c] [6d]
FDIBA2009: checks 
s70n3fac3: bets 1350
FDIBA2009: calls 1350
*** SHOW DOWN ***
s70n3fac3: shows [5h 7c] (a straight, Four to Eight)
FDIBA2009: mucks hand 
s70n3fac3 collected 3685 from pot
*** SUMMARY ***
Total pot 3900 | Rake 215 
Board [6h Kh 8d 4c 6d]
Seat 1: s70n3fac3 (button) (small blind) showed [5h 7c] and won (3685) with a straight, Four to Eight
Seat 2: FDIBA2009 (big blind) mucked [Ks 5d]



PokerStars Home Game Hand #227143104280: {Club #4781089}  Hold'em No Limit (50/100) - 2021/05/29 0:14:00 EET [2021/05/28 17:14:00 ET]
Table 'VTPP NLHE 2805' 2-max (Play Money) Seat #2 is the button
Seat 1: s70n3fac3 (12705 in chips) 
Seat 2: FDIBA2009 (15217 in chips) 
FDIBA2009: posts small blind 50
s70n3fac3: posts big blind 100
*** HOLE CARDS ***
FDIBA2009: raises 100 to 200
s70n3fac3: calls 100
*** FLOP *** [2h 6c Qd]
s70n3fac3: checks 
FDIBA2009: bets 378
s70n3fac3: calls 378
*** TURN *** [2h 6c Qd] [Jc]
s70n3fac3: checks 
FDIBA2009: checks 
*** RIVER *** [2h 6c Qd Jc] [Ad]
s70n3fac3: checks 
FDIBA2009: checks 
*** SHOW DOWN ***
s70n3fac3: shows [Qc 7h] (a pair of Queens)
FDIBA2009: mucks hand 
s70n3fac3 collected 1092 from pot
*** SUMMARY ***
Total pot 1156 | Rake 64 
Board [2h 6c Qd Jc Ad]
Seat 1: s70n3fac3 (big blind) showed [Qc 7h] and won (1092) with a pair of Queens
Seat 2: FDIBA2009 (button) (small blind) mucked [6s 8c]



PokerStars Home Game Hand #227143123495: {Club #4781089}  Hold'em No Limit (50/100) - 2021/05/29 0:14:24 EET [2021/05/28 17:14:24 ET]
Table 'VTPP NLHE 2805' 2-max (Play Money) Seat #1 is the button
Seat 1: s70n3fac3 (13219 in chips) 
Seat 2: FDIBA2009 (14639 in chips) 
s70n3fac3: posts small blind 50
FDIBA2009: posts big blind 100
*** HOLE CARDS ***
s70n3fac3: raises 150 to 250
FDIBA2009: calls 150
*** FLOP *** [Jd 8d 8h]
FDIBA2009: bets 472
s70n3fac3: folds 
Uncalled bet (472) returned to FDIBA2009
FDIBA2009 collected 472 from pot
FDIBA2009: doesn't show hand 
*** SUMMARY ***
Total pot 500 | Rake 28 
Board [Jd 8d 8h]
Seat 1: s70n3fac3 (button) (small blind) folded on the Flop
Seat 2: FDIBA2009 (big blind) collected (472)



PokerStars Home Game Hand #227143134953: {Club #4781089}  Hold'em No Limit (50/100) - 2021/05/29 0:14:45 EET [2021/05/28 17:14:45 ET]
Table 'VTPP NLHE 2805' 2-max (Play Money) Seat #2 is the button
Seat 1: s70n3fac3 (12969 in chips) 
Seat 2: FDIBA2009 (14861 in chips) 
FDIBA2009: posts small blind 50
s70n3fac3: posts big blind 100
*** HOLE CARDS ***
FDIBA2009: raises 100 to 200
s70n3fac3: calls 100
*** FLOP *** [4c 6c 7h]
s70n3fac3: checks 
FDIBA2009: bets 378
s70n3fac3: calls 378
*** TURN *** [4c 6c 7h] [3h]
s70n3fac3: checks 
FDIBA2009: checks 
*** RIVER *** [4c 6c 7h 3h] [7s]
s70n3fac3: checks 
FDIBA2009: bets 850
s70n3fac3: calls 850
*** SHOW DOWN ***
FDIBA2009: shows [9d 5s] (a straight, Three to Seven)
s70n3fac3: mucks hand 
FDIBA2009 collected 2699 from pot
*** SUMMARY ***
Total pot 2856 | Rake 157 
Board [4c 6c 7h 3h 7s]
Seat 1: s70n3fac3 (big blind) mucked [6d Ah]
Seat 2: FDIBA2009 (button) (small blind) showed [9d 5s] and won (2699) with a straight, Three to Seven



PokerStars Home Game Hand #227143152800: {Club #4781089}  Hold'em No Limit (50/100) - 2021/05/29 0:15:18 EET [2021/05/28 17:15:18 ET]
Table 'VTPP NLHE 2805' 2-max (Play Money) Seat #1 is the button
Seat 1: s70n3fac3 (11541 in chips) 
Seat 2: FDIBA2009 (16132 in chips) 
s70n3fac3: posts small blind 50
FDIBA2009: posts big blind 100
*** HOLE CARDS ***
s70n3fac3: folds 
Uncalled bet (50) returned to FDIBA2009
FDIBA2009 collected 100 from pot
FDIBA2009: doesn't show hand 
*** SUMMARY ***
Total pot 100 | Rake 0 
Seat 1: s70n3fac3 (button) (small blind) folded before Flop
Seat 2: FDIBA2009 (big blind) collected (100)



PokerStars Home Game Hand #227143154996: {Club #4781089}  Hold'em No Limit (50/100) - 2021/05/29 0:15:22 EET [2021/05/28 17:15:22 ET]
Table 'VTPP NLHE 2805' 2-max (Play Money) Seat #2 is the button
Seat 1: s70n3fac3 (11491 in chips) 
Seat 2: FDIBA2009 (16182 in chips) 
FDIBA2009: posts small blind 50
s70n3fac3: posts big blind 100
*** HOLE CARDS ***
FDIBA2009: raises 100 to 200
s70n3fac3: raises 450 to 650
FDIBA2009: folds 
Uncalled bet (450) returned to s70n3fac3
s70n3fac3 collected 400 from pot
s70n3fac3: doesn't show hand 
*** SUMMARY ***
Total pot 400 | Rake 0 
Seat 1: s70n3fac3 (big blind) collected (400)
Seat 2: FDIBA2009 (button) (small blind) folded before Flop



PokerStars Home Game Hand #227143161700: {Club #4781089}  Hold'em No Limit (50/100) - 2021/05/29 0:15:34 EET [2021/05/28 17:15:34 ET]
Table 'VTPP NLHE 2805' 2-max (Play Money) Seat #1 is the button
Seat 1: s70n3fac3 (11691 in chips) 
Seat 2: FDIBA2009 (15982 in chips) 
s70n3fac3: posts small blind 50
FDIBA2009: posts big blind 100
*** HOLE CARDS ***
s70n3fac3: folds 
Uncalled bet (50) returned to FDIBA2009
FDIBA2009 collected 100 from pot
FDIBA2009: doesn't show hand 
*** SUMMARY ***
Total pot 100 | Rake 0 
Seat 1: s70n3fac3 (button) (small blind) folded before Flop
Seat 2: FDIBA2009 (big blind) collected (100)



PokerStars Home Game Hand #227143164258: {Club #4781089}  Hold'em No Limit (50/100) - 2021/05/29 0:15:39 EET [2021/05/28 17:15:39 ET]
Table 'VTPP NLHE 2805' 2-max (Play Money) Seat #2 is the button
Seat 1: s70n3fac3 (11641 in chips) 
Seat 2: FDIBA2009 (16032 in chips) 
FDIBA2009: posts small blind 50
s70n3fac3: posts big blind 100
*** HOLE CARDS ***
FDIBA2009: raises 100 to 200
s70n3fac3: folds 
Uncalled bet (100) returned to FDIBA2009
FDIBA2009 collected 200 from pot
FDIBA2009: doesn't show hand 
*** SUMMARY ***
Total pot 200 | Rake 0 
Seat 1: s70n3fac3 (big blind) folded before Flop
Seat 2: FDIBA2009 (button) (small blind) collected (200)



PokerStars Home Game Hand #227143167729: {Club #4781089}  Hold'em No Limit (50/100) - 2021/05/29 0:15:46 EET [2021/05/28 17:15:46 ET]
Table 'VTPP NLHE 2805' 2-max (Play Money) Seat #1 is the button
Seat 1: s70n3fac3 (11541 in chips) 
Seat 2: FDIBA2009 (16132 in chips) 
s70n3fac3: posts small blind 50
FDIBA2009: posts big blind 100
*** HOLE CARDS ***
s70n3fac3: folds 
Uncalled bet (50) returned to FDIBA2009
FDIBA2009 collected 100 from pot
FDIBA2009: doesn't show hand 
*** SUMMARY ***
Total pot 100 | Rake 0 
Seat 1: s70n3fac3 (button) (small blind) folded before Flop
Seat 2: FDIBA2009 (big blind) collected (100)



PokerStars Home Game Hand #227143169741: {Club #4781089}  Hold'em No Limit (50/100) - 2021/05/29 0:15:49 EET [2021/05/28 17:15:49 ET]
Table 'VTPP NLHE 2805' 2-max (Play Money) Seat #2 is the button
Seat 1: s70n3fac3 (11491 in chips) 
Seat 2: FDIBA2009 (16182 in chips) 
FDIBA2009: posts small blind 50
s70n3fac3: posts big blind 100
*** HOLE CARDS ***
FDIBA2009: raises 100 to 200
s70n3fac3: calls 100
*** FLOP *** [8d 8h Ts]
s70n3fac3: checks 
FDIBA2009: checks 
*** TURN *** [8d 8h Ts] [7h]
s70n3fac3: checks 
FDIBA2009: checks 
*** RIVER *** [8d 8h Ts 7h] [3s]
s70n3fac3: checks 
FDIBA2009: bets 378
s70n3fac3: folds 
Uncalled bet (378) returned to FDIBA2009
FDIBA2009 collected 378 from pot
FDIBA2009: doesn't show hand 
*** SUMMARY ***
Total pot 400 | Rake 22 
Board [8d 8h Ts 7h 3s]
Seat 1: s70n3fac3 (big blind) folded on the River
Seat 2: FDIBA2009 (button) (small blind) collected (378)



PokerStars Home Game Hand #227143180714: {Club #4781089}  Hold'em No Limit (50/100) - 2021/05/29 0:16:10 EET [2021/05/28 17:16:10 ET]
Table 'VTPP NLHE 2805' 2-max (Play Money) Seat #1 is the button
Seat 1: s70n3fac3 (11291 in chips) 
Seat 2: FDIBA2009 (16360 in chips) 
s70n3fac3: posts small blind 50
FDIBA2009: posts big blind 100
*** HOLE CARDS ***
s70n3fac3: raises 150 to 250
FDIBA2009: calls 150
*** FLOP *** [Ts 4d Td]
FDIBA2009: checks 
s70n3fac3: bets 200
FDIBA2009: folds 
Uncalled bet (200) returned to s70n3fac3
s70n3fac3 collected 472 from pot
s70n3fac3: doesn't show hand 
*** SUMMARY ***
Total pot 500 | Rake 28 
Board [Ts 4d Td]
Seat 1: s70n3fac3 (button) (small blind) collected (472)
Seat 2: FDIBA2009 (big blind) folded on the Flop



PokerStars Home Game Hand #227143192334: {Club #4781089}  Hold'em No Limit (50/100) - 2021/05/29 0:16:31 EET [2021/05/28 17:16:31 ET]
Table 'VTPP NLHE 2805' 2-max (Play Money) Seat #2 is the button
Seat 1: s70n3fac3 (11513 in chips) 
Seat 2: FDIBA2009 (16110 in chips) 
FDIBA2009: posts small blind 50
s70n3fac3: posts big blind 100
*** HOLE CARDS ***
FDIBA2009: raises 100 to 200
s70n3fac3: calls 100
*** FLOP *** [8s Th 4h]
s70n3fac3: checks 
FDIBA2009: bets 200
s70n3fac3: folds 
Uncalled bet (200) returned to FDIBA2009
FDIBA2009 collected 378 from pot
FDIBA2009: doesn't show hand 
*** SUMMARY ***
Total pot 400 | Rake 22 
Board [8s Th 4h]
Seat 1: s70n3fac3 (big blind) folded on the Flop
Seat 2: FDIBA2009 (button) (small blind) collected (378)



PokerStars Home Game Hand #227143199459: {Club #4781089}  Hold'em No Limit (50/100) - 2021/05/29 0:16:44 EET [2021/05/28 17:16:44 ET]
Table 'VTPP NLHE 2805' 2-max (Play Money) Seat #1 is the button
Seat 1: s70n3fac3 (11313 in chips) 
Seat 2: FDIBA2009 (16288 in chips) 
s70n3fac3: posts small blind 50
FDIBA2009: posts big blind 100
*** HOLE CARDS ***
s70n3fac3: folds 
Uncalled bet (50) returned to FDIBA2009
FDIBA2009 collected 100 from pot
FDIBA2009: doesn't show hand 
*** SUMMARY ***
Total pot 100 | Rake 0 
Seat 1: s70n3fac3 (button) (small blind) folded before Flop
Seat 2: FDIBA2009 (big blind) collected (100)



PokerStars Home Game Hand #227143201415: {Club #4781089}  Hold'em No Limit (50/100) - 2021/05/29 0:16:48 EET [2021/05/28 17:16:48 ET]
Table 'VTPP NLHE 2805' 2-max (Play Money) Seat #2 is the button
Seat 1: s70n3fac3 (11263 in chips) 
Seat 2: FDIBA2009 (16338 in chips) 
FDIBA2009: posts small blind 50
s70n3fac3: posts big blind 100
*** HOLE CARDS ***
FDIBA2009: raises 100 to 200
s70n3fac3: calls 100
*** FLOP *** [7s As 3s]
s70n3fac3: checks 
FDIBA2009: checks 
*** TURN *** [7s As 3s] [Qh]
s70n3fac3: checks 
FDIBA2009: checks 
*** RIVER *** [7s As 3s Qh] [8c]
s70n3fac3: bets 200
FDIBA2009: calls 200
*** SHOW DOWN ***
s70n3fac3: shows [Th Qd] (a pair of Queens)
FDIBA2009: mucks hand 
s70n3fac3 collected 756 from pot
*** SUMMARY ***
Total pot 800 | Rake 44 
Board [7s As 3s Qh 8c]
Seat 1: s70n3fac3 (big blind) showed [Th Qd] and won (756) with a pair of Queens
Seat 2: FDIBA2009 (button) (small blind) mucked [Kd 7h]



PokerStars Home Game Hand #227143210920: {Club #4781089}  Hold'em No Limit (50/100) - 2021/05/29 0:17:06 EET [2021/05/28 17:17:06 ET]
Table 'VTPP NLHE 2805' 2-max (Play Money) Seat #1 is the button
Seat 1: s70n3fac3 (11619 in chips) 
Seat 2: FDIBA2009 (15938 in chips) 
s70n3fac3: posts small blind 50
FDIBA2009: posts big blind 100
*** HOLE CARDS ***
s70n3fac3: folds 
Uncalled bet (50) returned to FDIBA2009
FDIBA2009 collected 100 from pot
FDIBA2009: doesn't show hand 
*** SUMMARY ***
Total pot 100 | Rake 0 
Seat 1: s70n3fac3 (button) (small blind) folded before Flop
Seat 2: FDIBA2009 (big blind) collected (100)



PokerStars Home Game Hand #227143212928: {Club #4781089}  Hold'em No Limit (50/100) - 2021/05/29 0:17:09 EET [2021/05/28 17:17:09 ET]
Table 'VTPP NLHE 2805' 2-max (Play Money) Seat #2 is the button
Seat 1: s70n3fac3 (11569 in chips) 
Seat 2: FDIBA2009 (15988 in chips) 
FDIBA2009: posts small blind 50
s70n3fac3: posts big blind 100
*** HOLE CARDS ***
FDIBA2009: raises 100 to 200
s70n3fac3: folds 
Uncalled bet (100) returned to FDIBA2009
FDIBA2009 collected 200 from pot
FDIBA2009: doesn't show hand 
*** SUMMARY ***
Total pot 200 | Rake 0 
Seat 1: s70n3fac3 (big blind) folded before Flop
Seat 2: FDIBA2009 (button) (small blind) collected (200)



PokerStars Home Game Hand #227143216084: {Club #4781089}  Hold'em No Limit (50/100) - 2021/05/29 0:17:15 EET [2021/05/28 17:17:15 ET]
Table 'VTPP NLHE 2805' 2-max (Play Money) Seat #1 is the button
Seat 1: s70n3fac3 (11469 in chips) 
Seat 2: FDIBA2009 (16088 in chips) 
s70n3fac3: posts small blind 50
FDIBA2009: posts big blind 100
*** HOLE CARDS ***
s70n3fac3: raises 150 to 250
FDIBA2009: calls 150
*** FLOP *** [Th Jd Tc]
FDIBA2009: checks 
s70n3fac3: bets 200
FDIBA2009: folds 
Uncalled bet (200) returned to s70n3fac3
s70n3fac3 collected 472 from pot
s70n3fac3: doesn't show hand 
*** SUMMARY ***
Total pot 500 | Rake 28 
Board [Th Jd Tc]
Seat 1: s70n3fac3 (button) (small blind) collected (472)
Seat 2: FDIBA2009 (big blind) folded on the Flop



PokerStars Home Game Hand #227143224149: {Club #4781089}  Hold'em No Limit (50/100) - 2021/05/29 0:17:30 EET [2021/05/28 17:17:30 ET]
Table 'VTPP NLHE 2805' 2-max (Play Money) Seat #2 is the button
Seat 1: s70n3fac3 (11691 in chips) 
Seat 2: FDIBA2009 (15838 in chips) 
FDIBA2009: posts small blind 50
s70n3fac3: posts big blind 100
*** HOLE CARDS ***
FDIBA2009: raises 100 to 200
s70n3fac3: calls 100
*** FLOP *** [4d 9s Ah]
s70n3fac3: checks 
FDIBA2009: bets 200
s70n3fac3: folds 
Uncalled bet (200) returned to FDIBA2009
FDIBA2009 collected 378 from pot
FDIBA2009: doesn't show hand 
*** SUMMARY ***
Total pot 400 | Rake 22 
Board [4d 9s Ah]
Seat 1: s70n3fac3 (big blind) folded on the Flop
Seat 2: FDIBA2009 (button) (small blind) collected (378)



PokerStars Home Game Hand #227143235220: {Club #4781089}  Hold'em No Limit (50/100) - 2021/05/29 0:17:51 EET [2021/05/28 17:17:51 ET]
Table 'VTPP NLHE 2805' 2-max (Play Money) Seat #1 is the button
Seat 1: s70n3fac3 (11491 in chips) 
Seat 2: FDIBA2009 (16016 in chips) 
s70n3fac3: posts small blind 50
FDIBA2009: posts big blind 100
*** HOLE CARDS ***
s70n3fac3: raises 100 to 200
FDIBA2009: calls 100
*** FLOP *** [Tc 3s Kc]
FDIBA2009: checks 
s70n3fac3: checks 
*** TURN *** [Tc 3s Kc] [7c]
FDIBA2009: bets 189
s70n3fac3: calls 189
*** RIVER *** [Tc 3s Kc 7c] [7h]
FDIBA2009: checks 
s70n3fac3: checks 
*** SHOW DOWN ***
FDIBA2009: shows [9s Qs] (a pair of Sevens)
s70n3fac3: shows [6d Ac] (a pair of Sevens - Ace kicker)
s70n3fac3 collected 735 from pot
*** SUMMARY ***
Total pot 778 | Rake 43 
Board [Tc 3s Kc 7c 7h]
Seat 1: s70n3fac3 (button) (small blind) showed [6d Ac] and won (735) with a pair of Sevens
Seat 2: FDIBA2009 (big blind) showed [9s Qs] and lost with a pair of Sevens



PokerStars Home Game Hand #227143254170: {Club #4781089}  Hold'em No Limit (50/100) - 2021/05/29 0:18:25 EET [2021/05/28 17:18:25 ET]
Table 'VTPP NLHE 2805' 2-max (Play Money) Seat #2 is the button
Seat 1: s70n3fac3 (11837 in chips) 
Seat 2: FDIBA2009 (15627 in chips) 
FDIBA2009: posts small blind 50
s70n3fac3: posts big blind 100
*** HOLE CARDS ***
FDIBA2009: raises 100 to 200
s70n3fac3: calls 100
*** FLOP *** [5d 7h 4s]
s70n3fac3: checks 
FDIBA2009: bets 378
s70n3fac3: folds 
Uncalled bet (378) returned to FDIBA2009
FDIBA2009 collected 378 from pot
FDIBA2009: doesn't show hand 
*** SUMMARY ***
Total pot 400 | Rake 22 
Board [5d 7h 4s]
Seat 1: s70n3fac3 (big blind) folded on the Flop
Seat 2: FDIBA2009 (button) (small blind) collected (378)



PokerStars Home Game Hand #227143265429: {Club #4781089}  Hold'em No Limit (50/100) - 2021/05/29 0:18:46 EET [2021/05/28 17:18:46 ET]
Table 'VTPP NLHE 2805' 2-max (Play Money) Seat #1 is the button
Seat 1: s70n3fac3 (11637 in chips) 
Seat 2: FDIBA2009 (15805 in chips) 
s70n3fac3: posts small blind 50
FDIBA2009: posts big blind 100
*** HOLE CARDS ***
s70n3fac3: raises 150 to 250
FDIBA2009: raises 150 to 400
s70n3fac3: calls 150
*** FLOP *** [9c 6d Td]
FDIBA2009: checks 
s70n3fac3: bets 450
FDIBA2009: raises 450 to 900
s70n3fac3: calls 450
*** TURN *** [9c 6d Td] [5h]
FDIBA2009: bets 1350
s70n3fac3: calls 1350
*** RIVER *** [9c 6d Td 5h] [Qc]
FDIBA2009: bets 2650
s70n3fac3: calls 2650
*** SHOW DOWN ***
FDIBA2009: shows [8c 7d] (a straight, Six to Ten)
s70n3fac3: mucks hand 
FDIBA2009 collected 10017 from pot
*** SUMMARY ***
Total pot 10600 | Rake 583 
Board [9c 6d Td 5h Qc]
Seat 1: s70n3fac3 (button) (small blind) mucked [Jh Ts]
Seat 2: FDIBA2009 (big blind) showed [8c 7d] and won (10017) with a straight, Six to Ten



PokerStars Home Game Hand #227143297458: {Club #4781089}  Hold'em No Limit (50/100) - 2021/05/29 0:19:45 EET [2021/05/28 17:19:45 ET]
Table 'VTPP NLHE 2805' 2-max (Play Money) Seat #2 is the button
Seat 1: s70n3fac3 (6337 in chips) 
Seat 2: FDIBA2009 (20522 in chips) 
FDIBA2009: posts small blind 50
s70n3fac3: posts big blind 100
*** HOLE CARDS ***
FDIBA2009: raises 100 to 200
s70n3fac3: raises 300 to 500
FDIBA2009: calls 300
*** FLOP *** [4s 8h 2c]
s70n3fac3: checks 
FDIBA2009: checks 
*** TURN *** [4s 8h 2c] [Js]
s70n3fac3: checks 
FDIBA2009: checks 
*** RIVER *** [4s 8h 2c Js] [6c]
s70n3fac3: checks 
FDIBA2009: checks 
*** SHOW DOWN ***
s70n3fac3: shows [Tc Qd] (high card Queen)
FDIBA2009: shows [3h Ac] (high card Ace)
FDIBA2009 collected 945 from pot
*** SUMMARY ***
Total pot 1000 | Rake 55 
Board [4s 8h 2c Js 6c]
Seat 1: s70n3fac3 (big blind) showed [Tc Qd] and lost with high card Queen
Seat 2: FDIBA2009 (button) (small blind) showed [3h Ac] and won (945) with high card Ace



PokerStars Home Game Hand #227143315421: {Club #4781089}  Hold'em No Limit (50/100) - 2021/05/29 0:20:19 EET [2021/05/28 17:20:19 ET]
Table 'VTPP NLHE 2805' 2-max (Play Money) Seat #1 is the button
Seat 1: s70n3fac3 (5837 in chips) 
Seat 2: FDIBA2009 (20967 in chips) 
s70n3fac3: posts small blind 50
FDIBA2009: posts big blind 100
*** HOLE CARDS ***
s70n3fac3: folds 
Uncalled bet (50) returned to FDIBA2009
FDIBA2009 collected 100 from pot
FDIBA2009: doesn't show hand 
*** SUMMARY ***
Total pot 100 | Rake 0 
Seat 1: s70n3fac3 (button) (small blind) folded before Flop
Seat 2: FDIBA2009 (big blind) collected (100)



PokerStars Home Game Hand #227143320384: {Club #4781089}  Hold'em No Limit (50/100) - 2021/05/29 0:20:28 EET [2021/05/28 17:20:28 ET]
Table 'VTPP NLHE 2805' 2-max (Play Money) Seat #2 is the button
Seat 1: s70n3fac3 (5787 in chips) 
Seat 2: FDIBA2009 (21017 in chips) 
FDIBA2009: posts small blind 50
s70n3fac3: posts big blind 100
*** HOLE CARDS ***
FDIBA2009: raises 100 to 200
s70n3fac3: raises 400 to 600
FDIBA2009: calls 400
*** FLOP *** [2s 2d Qs]
s70n3fac3: checks 
FDIBA2009: checks 
*** TURN *** [2s 2d Qs] [9s]
s70n3fac3: checks 
FDIBA2009: bets 300
s70n3fac3: calls 300
*** RIVER *** [2s 2d Qs 9s] [6c]
s70n3fac3: checks 
FDIBA2009: checks 
*** SHOW DOWN ***
s70n3fac3: shows [Ad Kd] (a pair of Deuces)
FDIBA2009: shows [9d Jh] (two pair, Nines and Deuces)
FDIBA2009 collected 1701 from pot
*** SUMMARY ***
Total pot 1800 | Rake 99 
Board [2s 2d Qs 9s 6c]
Seat 1: s70n3fac3 (big blind) showed [Ad Kd] and lost with a pair of Deuces
Seat 2: FDIBA2009 (button) (small blind) showed [9d Jh] and won (1701) with two pair, Nines and Deuces



PokerStars Home Game Hand #227143338111: {Club #4781089}  Hold'em No Limit (50/100) - 2021/05/29 0:21:01 EET [2021/05/28 17:21:01 ET]
Table 'VTPP NLHE 2805' 2-max (Play Money) Seat #1 is the button
Seat 1: s70n3fac3 (4887 in chips) 
Seat 2: FDIBA2009 (21818 in chips) 
s70n3fac3: posts small blind 50
FDIBA2009: posts big blind 100
*** HOLE CARDS ***
s70n3fac3: raises 150 to 250
FDIBA2009: calls 150
*** FLOP *** [7d 3d Qd]
FDIBA2009: checks 
s70n3fac3: checks 
*** TURN *** [7d 3d Qd] [9s]
FDIBA2009: checks 
s70n3fac3: bets 300
FDIBA2009: folds 
Uncalled bet (300) returned to s70n3fac3
s70n3fac3 collected 472 from pot
s70n3fac3: doesn't show hand 
*** SUMMARY ***
Total pot 500 | Rake 28 
Board [7d 3d Qd 9s]
Seat 1: s70n3fac3 (button) (small blind) collected (472)
Seat 2: FDIBA2009 (big blind) folded on the Turn



PokerStars Home Game Hand #227143346550: {Club #4781089}  Hold'em No Limit (50/100) - 2021/05/29 0:21:16 EET [2021/05/28 17:21:16 ET]
Table 'VTPP NLHE 2805' 2-max (Play Money) Seat #2 is the button
Seat 1: s70n3fac3 (5109 in chips) 
Seat 2: FDIBA2009 (21568 in chips) 
FDIBA2009: posts small blind 50
s70n3fac3: posts big blind 100
*** HOLE CARDS ***
FDIBA2009: raises 100 to 200
s70n3fac3: calls 100
*** FLOP *** [6s Ks 5c]
s70n3fac3: checks 
FDIBA2009: bets 378
s70n3fac3: calls 378
*** TURN *** [6s Ks 5c] [Jd]
s70n3fac3: checks 
FDIBA2009: bets 1000
s70n3fac3: calls 1000
*** RIVER *** [6s Ks 5c Jd] [Jc]
s70n3fac3: checks 
FDIBA2009: checks 
*** SHOW DOWN ***
s70n3fac3: shows [6c Kd] (two pair, Kings and Jacks)
FDIBA2009: mucks hand 
s70n3fac3 collected 2982 from pot
*** SUMMARY ***
Total pot 3156 | Rake 174 
Board [6s Ks 5c Jd Jc]
Seat 1: s70n3fac3 (big blind) showed [6c Kd] and won (2982) with two pair, Kings and Jacks
Seat 2: FDIBA2009 (button) (small blind) mucked [5s 2s]



PokerStars Home Game Hand #227143371870: {Club #4781089}  Hold'em No Limit (50/100) - 2021/05/29 0:22:04 EET [2021/05/28 17:22:04 ET]
Table 'VTPP NLHE 2805' 2-max (Play Money) Seat #1 is the button
Seat 1: s70n3fac3 (6513 in chips) 
Seat 2: FDIBA2009 (19990 in chips) 
s70n3fac3: posts small blind 50
FDIBA2009: posts big blind 100
*** HOLE CARDS ***
s70n3fac3: calls 50
FDIBA2009: checks 
*** FLOP *** [Ac Tc 7s]
FDIBA2009: checks 
s70n3fac3: checks 
*** TURN *** [Ac Tc 7s] [9c]
FDIBA2009: checks 
s70n3fac3: checks 
*** RIVER *** [Ac Tc 7s 9c] [Ad]
FDIBA2009: checks 
s70n3fac3: checks 
*** SHOW DOWN ***
FDIBA2009: shows [4d 5s] (a pair of Aces)
s70n3fac3: shows [4c 5d] (a pair of Aces)
FDIBA2009 collected 95 from pot
s70n3fac3 collected 94 from pot
*** SUMMARY ***
Total pot 200 | Rake 11 
Board [Ac Tc 7s 9c Ad]
Seat 1: s70n3fac3 (button) (small blind) showed [4c 5d] and won (94) with a pair of Aces
Seat 2: FDIBA2009 (big blind) showed [4d 5s] and won (95) with a pair of Aces



PokerStars Home Game Hand #227143380573: {Club #4781089}  Hold'em No Limit (50/100) - 2021/05/29 0:22:20 EET [2021/05/28 17:22:20 ET]
Table 'VTPP NLHE 2805' 2-max (Play Money) Seat #2 is the button
Seat 1: s70n3fac3 (6507 in chips) 
Seat 2: FDIBA2009 (19985 in chips) 
FDIBA2009: posts small blind 50
s70n3fac3: posts big blind 100
*** HOLE CARDS ***
FDIBA2009: raises 100 to 200
s70n3fac3: folds 
Uncalled bet (100) returned to FDIBA2009
FDIBA2009 collected 200 from pot
FDIBA2009: doesn't show hand 
*** SUMMARY ***
Total pot 200 | Rake 0 
Seat 1: s70n3fac3 (big blind) folded before Flop
Seat 2: FDIBA2009 (button) (small blind) collected (200)



PokerStars Home Game Hand #227143384302: {Club #4781089}  Hold'em No Limit (50/100) - 2021/05/29 0:22:27 EET [2021/05/28 17:22:27 ET]
Table 'VTPP NLHE 2805' 2-max (Play Money) Seat #1 is the button
Seat 1: s70n3fac3 (6407 in chips) 
Seat 2: FDIBA2009 (20085 in chips) 
s70n3fac3: posts small blind 50
FDIBA2009: posts big blind 100
*** HOLE CARDS ***
s70n3fac3: calls 50
FDIBA2009: checks 
*** FLOP *** [9h Ac Qc]
FDIBA2009: checks 
s70n3fac3: bets 100
FDIBA2009: folds 
Uncalled bet (100) returned to s70n3fac3
s70n3fac3 collected 189 from pot
s70n3fac3: doesn't show hand 
*** SUMMARY ***
Total pot 200 | Rake 11 
Board [9h Ac Qc]
Seat 1: s70n3fac3 (button) (small blind) collected (189)
Seat 2: FDIBA2009 (big blind) folded on the Flop



PokerStars Home Game Hand #227143390004: {Club #4781089}  Hold'em No Limit (50/100) - 2021/05/29 0:22:38 EET [2021/05/28 17:22:38 ET]
Table 'VTPP NLHE 2805' 2-max (Play Money) Seat #2 is the button
Seat 1: s70n3fac3 (6496 in chips) 
Seat 2: FDIBA2009 (19985 in chips) 
FDIBA2009: posts small blind 50
s70n3fac3: posts big blind 100
*** HOLE CARDS ***
FDIBA2009: raises 100 to 200
s70n3fac3: folds 
Uncalled bet (100) returned to FDIBA2009
FDIBA2009 collected 200 from pot
FDIBA2009: doesn't show hand 
*** SUMMARY ***
Total pot 200 | Rake 0 
Seat 1: s70n3fac3 (big blind) folded before Flop
Seat 2: FDIBA2009 (button) (small blind) collected (200)



PokerStars Home Game Hand #227143393202: {Club #4781089}  Hold'em No Limit (50/100) - 2021/05/29 0:22:44 EET [2021/05/28 17:22:44 ET]
Table 'VTPP NLHE 2805' 2-max (Play Money) Seat #1 is the button
Seat 1: s70n3fac3 (6396 in chips) 
Seat 2: FDIBA2009 (20085 in chips) 
s70n3fac3: posts small blind 50
FDIBA2009: posts big blind 100
*** HOLE CARDS ***
s70n3fac3: folds 
Uncalled bet (50) returned to FDIBA2009
FDIBA2009 collected 100 from pot
FDIBA2009: doesn't show hand 
*** SUMMARY ***
Total pot 100 | Rake 0 
Seat 1: s70n3fac3 (button) (small blind) folded before Flop
Seat 2: FDIBA2009 (big blind) collected (100)



PokerStars Home Game Hand #227143395040: {Club #4781089}  Hold'em No Limit (50/100) - 2021/05/29 0:22:47 EET [2021/05/28 17:22:47 ET]
Table 'VTPP NLHE 2805' 2-max (Play Money) Seat #2 is the button
Seat 1: s70n3fac3 (6346 in chips) 
Seat 2: FDIBA2009 (20135 in chips) 
FDIBA2009: posts small blind 50
s70n3fac3: posts big blind 100
*** HOLE CARDS ***
FDIBA2009: raises 100 to 200
s70n3fac3: raises 400 to 600
FDIBA2009: calls 400
*** FLOP *** [Kd Ad 4c]
s70n3fac3: bets 700
FDIBA2009: calls 700
*** TURN *** [Kd Ad 4c] [Jd]
s70n3fac3: checks 
FDIBA2009: bets 1750
s70n3fac3: folds 
Uncalled bet (1750) returned to FDIBA2009
FDIBA2009 collected 2457 from pot
FDIBA2009: doesn't show hand 
*** SUMMARY ***
Total pot 2600 | Rake 143 
Board [Kd Ad 4c Jd]
Seat 1: s70n3fac3 (big blind) folded on the Turn
Seat 2: FDIBA2009 (button) (small blind) collected (2457)



PokerStars Home Game Hand #227143411547: {Club #4781089}  Hold'em No Limit (50/100) - 2021/05/29 0:23:18 EET [2021/05/28 17:23:18 ET]
Table 'VTPP NLHE 2805' 2-max (Play Money) Seat #1 is the button
Seat 1: s70n3fac3 (5046 in chips) 
Seat 2: FDIBA2009 (21292 in chips) 
s70n3fac3: posts small blind 50
FDIBA2009: posts big blind 100
*** HOLE CARDS ***
s70n3fac3: raises 150 to 250
FDIBA2009: folds 
Uncalled bet (150) returned to s70n3fac3
s70n3fac3 collected 200 from pot
s70n3fac3: doesn't show hand 
*** SUMMARY ***
Total pot 200 | Rake 0 
Seat 1: s70n3fac3 (button) (small blind) collected (200)
Seat 2: FDIBA2009 (big blind) folded before Flop



PokerStars Home Game Hand #227143414411: {Club #4781089}  Hold'em No Limit (50/100) - 2021/05/29 0:23:24 EET [2021/05/28 17:23:24 ET]
Table 'VTPP NLHE 2805' 2-max (Play Money) Seat #2 is the button
Seat 1: s70n3fac3 (5146 in chips) 
Seat 2: FDIBA2009 (21192 in chips) 
FDIBA2009: posts small blind 50
s70n3fac3: posts big blind 100
*** HOLE CARDS ***
FDIBA2009: raises 100 to 200
s70n3fac3: folds 
Uncalled bet (100) returned to FDIBA2009
FDIBA2009 collected 200 from pot
FDIBA2009: doesn't show hand 
*** SUMMARY ***
Total pot 200 | Rake 0 
Seat 1: s70n3fac3 (big blind) folded before Flop
Seat 2: FDIBA2009 (button) (small blind) collected (200)



PokerStars Home Game Hand #227143422983: {Club #4781089}  Hold'em No Limit (50/100) - 2021/05/29 0:23:29 EET [2021/05/28 17:23:29 ET]
Table 'VTPP NLHE 2805' 2-max (Play Money) Seat #1 is the button
Seat 1: s70n3fac3 (5046 in chips) 
Seat 2: FDIBA2009 (21292 in chips) 
s70n3fac3: posts small blind 50
FDIBA2009: posts big blind 100
*** HOLE CARDS ***
s70n3fac3: folds 
Uncalled bet (50) returned to FDIBA2009
FDIBA2009 collected 100 from pot
FDIBA2009: doesn't show hand 
*** SUMMARY ***
Total pot 100 | Rake 0 
Seat 1: s70n3fac3 (button) (small blind) folded before Flop
Seat 2: FDIBA2009 (big blind) collected (100)



PokerStars Home Game Hand #227143424868: {Club #4781089}  Hold'em No Limit (50/100) - 2021/05/29 0:23:33 EET [2021/05/28 17:23:33 ET]
Table 'VTPP NLHE 2805' 2-max (Play Money) Seat #2 is the button
Seat 1: s70n3fac3 (4996 in chips) 
Seat 2: FDIBA2009 (21342 in chips) 
FDIBA2009: posts small blind 50
s70n3fac3: posts big blind 100
*** HOLE CARDS ***
FDIBA2009: raises 100 to 200
s70n3fac3: folds 
Uncalled bet (100) returned to FDIBA2009
FDIBA2009 collected 200 from pot
FDIBA2009: doesn't show hand 
*** SUMMARY ***
Total pot 200 | Rake 0 
Seat 1: s70n3fac3 (big blind) folded before Flop
Seat 2: FDIBA2009 (button) (small blind) collected (200)



PokerStars Home Game Hand #227143429119: {Club #4781089}  Hold'em No Limit (50/100) - 2021/05/29 0:23:41 EET [2021/05/28 17:23:41 ET]
Table 'VTPP NLHE 2805' 2-max (Play Money) Seat #1 is the button
Seat 1: s70n3fac3 (4896 in chips) 
Seat 2: FDIBA2009 (21442 in chips) 
s70n3fac3: posts small blind 50
FDIBA2009: posts big blind 100
*** HOLE CARDS ***
s70n3fac3: raises 150 to 250
FDIBA2009: calls 150
*** FLOP *** [4c Qc 7d]
FDIBA2009: checks 
s70n3fac3: bets 200
FDIBA2009: calls 200
*** TURN *** [4c Qc 7d] [4d]
FDIBA2009: checks 
s70n3fac3: checks 
*** RIVER *** [4c Qc 7d 4d] [5d]
FDIBA2009: checks 
s70n3fac3: checks 
*** SHOW DOWN ***
FDIBA2009: shows [9s 7c] (two pair, Sevens and Fours)
s70n3fac3: mucks hand 
FDIBA2009 collected 850 from pot
*** SUMMARY ***
Total pot 900 | Rake 50 
Board [4c Qc 7d 4d 5d]
Seat 1: s70n3fac3 (button) (small blind) mucked [5c 3h]
Seat 2: FDIBA2009 (big blind) showed [9s 7c] and won (850) with two pair, Sevens and Fours



PokerStars Home Game Hand #227143441240: {Club #4781089}  Hold'em No Limit (50/100) - 2021/05/29 0:24:04 EET [2021/05/28 17:24:04 ET]
Table 'VTPP NLHE 2805' 2-max (Play Money) Seat #2 is the button
Seat 1: s70n3fac3 (4446 in chips) 
Seat 2: FDIBA2009 (21842 in chips) 
FDIBA2009: posts small blind 50
s70n3fac3: posts big blind 100
*** HOLE CARDS ***
FDIBA2009: raises 100 to 200
s70n3fac3: calls 100
*** FLOP *** [7s 2d Jh]
s70n3fac3: checks 
FDIBA2009: checks 
*** TURN *** [7s 2d Jh] [4s]
s70n3fac3: bets 200
FDIBA2009: folds 
Uncalled bet (200) returned to s70n3fac3
s70n3fac3 collected 378 from pot
s70n3fac3: doesn't show hand 
*** SUMMARY ***
Total pot 400 | Rake 22 
Board [7s 2d Jh 4s]
Seat 1: s70n3fac3 (big blind) collected (378)
Seat 2: FDIBA2009 (button) (small blind) folded on the Turn



PokerStars Home Game Hand #227143448777: {Club #4781089}  Hold'em No Limit (50/100) - 2021/05/29 0:24:18 EET [2021/05/28 17:24:18 ET]
Table 'VTPP NLHE 2805' 2-max (Play Money) Seat #1 is the button
Seat 1: s70n3fac3 (4624 in chips) 
Seat 2: FDIBA2009 (21642 in chips) 
s70n3fac3: posts small blind 50
FDIBA2009: posts big blind 100
*** HOLE CARDS ***
s70n3fac3: folds 
Uncalled bet (50) returned to FDIBA2009
FDIBA2009 collected 100 from pot
FDIBA2009: doesn't show hand 
*** SUMMARY ***
Total pot 100 | Rake 0 
Seat 1: s70n3fac3 (button) (small blind) folded before Flop
Seat 2: FDIBA2009 (big blind) collected (100)



PokerStars Home Game Hand #227143450724: {Club #4781089}  Hold'em No Limit (50/100) - 2021/05/29 0:24:21 EET [2021/05/28 17:24:21 ET]
Table 'VTPP NLHE 2805' 2-max (Play Money) Seat #2 is the button
Seat 1: s70n3fac3 (4574 in chips) 
Seat 2: FDIBA2009 (21692 in chips) 
FDIBA2009: posts small blind 50
s70n3fac3: posts big blind 100
*** HOLE CARDS ***
FDIBA2009: raises 100 to 200
s70n3fac3: folds 
Uncalled bet (100) returned to FDIBA2009
FDIBA2009 collected 200 from pot
FDIBA2009: doesn't show hand 
*** SUMMARY ***
Total pot 200 | Rake 0 
Seat 1: s70n3fac3 (big blind) folded before Flop
Seat 2: FDIBA2009 (button) (small blind) collected (200)



PokerStars Home Game Hand #227143461930: {Club #4781089}  Hold'em No Limit (50/100) - 2021/05/29 0:24:42 EET [2021/05/28 17:24:42 ET]
Table 'VTPP NLHE 2805' 2-max (Play Money) Seat #1 is the button
Seat 1: s70n3fac3 (9474 in chips) 
Seat 2: FDIBA2009 (21792 in chips) 
s70n3fac3: posts small blind 50
FDIBA2009: posts big blind 100
*** HOLE CARDS ***
s70n3fac3: raises 150 to 250
FDIBA2009: calls 150
*** FLOP *** [As Qc Th]
FDIBA2009: checks 
s70n3fac3: bets 300
FDIBA2009: calls 300
*** TURN *** [As Qc Th] [3d]
FDIBA2009: checks 
s70n3fac3: bets 565
FDIBA2009: folds 
Uncalled bet (565) returned to s70n3fac3
s70n3fac3 collected 1039 from pot
s70n3fac3: doesn't show hand 
*** SUMMARY ***
Total pot 1100 | Rake 61 
Board [As Qc Th 3d]
Seat 1: s70n3fac3 (button) (small blind) collected (1039)
Seat 2: FDIBA2009 (big blind) folded on the Turn



PokerStars Home Game Hand #227143476434: {Club #4781089}  Hold'em No Limit (50/100) - 2021/05/29 0:25:10 EET [2021/05/28 17:25:10 ET]
Table 'VTPP NLHE 2805' 2-max (Play Money) Seat #2 is the button
Seat 1: s70n3fac3 (9963 in chips) 
Seat 2: FDIBA2009 (21242 in chips) 
FDIBA2009: posts small blind 50
s70n3fac3: posts big blind 100
*** HOLE CARDS ***
FDIBA2009: raises 250 to 350
s70n3fac3: folds 
Uncalled bet (250) returned to FDIBA2009
FDIBA2009 collected 200 from pot
FDIBA2009: doesn't show hand 
*** SUMMARY ***
Total pot 200 | Rake 0 
Seat 1: s70n3fac3 (big blind) folded before Flop
Seat 2: FDIBA2009 (button) (small blind) collected (200)



PokerStars Home Game Hand #227143480494: {Club #4781089}  Hold'em No Limit (50/100) - 2021/05/29 0:25:18 EET [2021/05/28 17:25:18 ET]
Table 'VTPP NLHE 2805' 2-max (Play Money) Seat #1 is the button
Seat 1: s70n3fac3 (9863 in chips) 
Seat 2: FDIBA2009 (21342 in chips) 
s70n3fac3: posts small blind 50
FDIBA2009: posts big blind 100
*** HOLE CARDS ***
s70n3fac3: folds 
Uncalled bet (50) returned to FDIBA2009
FDIBA2009 collected 100 from pot
FDIBA2009: doesn't show hand 
*** SUMMARY ***
Total pot 100 | Rake 0 
Seat 1: s70n3fac3 (button) (small blind) folded before Flop
Seat 2: FDIBA2009 (big blind) collected (100)



PokerStars Home Game Hand #227143482418: {Club #4781089}  Hold'em No Limit (50/100) - 2021/05/29 0:25:21 EET [2021/05/28 17:25:21 ET]
Table 'VTPP NLHE 2805' 2-max (Play Money) Seat #2 is the button
Seat 1: s70n3fac3 (9813 in chips) 
Seat 2: FDIBA2009 (21392 in chips) 
FDIBA2009: posts small blind 50
s70n3fac3: posts big blind 100
*** HOLE CARDS ***
FDIBA2009: raises 100 to 200
s70n3fac3: calls 100
*** FLOP *** [6h 5s Qd]
s70n3fac3: checks 
FDIBA2009: bets 200
s70n3fac3: calls 200
*** TURN *** [6h 5s Qd] [9s]
s70n3fac3: checks 
FDIBA2009: checks 
*** RIVER *** [6h 5s Qd 9s] [Kd]
s70n3fac3: checks 
FDIBA2009: bets 850
s70n3fac3: folds 
Uncalled bet (850) returned to FDIBA2009
FDIBA2009 collected 756 from pot
FDIBA2009: doesn't show hand 
*** SUMMARY ***
Total pot 800 | Rake 44 
Board [6h 5s Qd 9s Kd]
Seat 1: s70n3fac3 (big blind) folded on the River
Seat 2: FDIBA2009 (button) (small blind) collected (756)



PokerStars Home Game Hand #227143496345: {Club #4781089}  Hold'em No Limit (50/100) - 2021/05/29 0:25:47 EET [2021/05/28 17:25:47 ET]
Table 'VTPP NLHE 2805' 2-max (Play Money) Seat #1 is the button
Seat 1: s70n3fac3 (9413 in chips) 
Seat 2: FDIBA2009 (21748 in chips) 
s70n3fac3: posts small blind 50
FDIBA2009: posts big blind 100
*** HOLE CARDS ***
s70n3fac3: raises 150 to 250
FDIBA2009: folds 
Uncalled bet (150) returned to s70n3fac3
s70n3fac3 collected 200 from pot
s70n3fac3: doesn't show hand 
*** SUMMARY ***
Total pot 200 | Rake 0 
Seat 1: s70n3fac3 (button) (small blind) collected (200)
Seat 2: FDIBA2009 (big blind) folded before Flop



PokerStars Home Game Hand #227143500974: {Club #4781089}  Hold'em No Limit (50/100) - 2021/05/29 0:25:56 EET [2021/05/28 17:25:56 ET]
Table 'VTPP NLHE 2805' 2-max (Play Money) Seat #2 is the button
Seat 1: s70n3fac3 (9513 in chips) 
Seat 2: FDIBA2009 (21648 in chips) 
FDIBA2009: posts small blind 50
s70n3fac3: posts big blind 100
*** HOLE CARDS ***
FDIBA2009: raises 100 to 200
s70n3fac3: raises 450 to 650
FDIBA2009: folds 
Uncalled bet (450) returned to s70n3fac3
s70n3fac3 collected 400 from pot
s70n3fac3: doesn't show hand 
*** SUMMARY ***
Total pot 400 | Rake 0 
Seat 1: s70n3fac3 (big blind) collected (400)
Seat 2: FDIBA2009 (button) (small blind) folded before Flop



PokerStars Home Game Hand #227143506046: {Club #4781089}  Hold'em No Limit (50/100) - 2021/05/29 0:26:06 EET [2021/05/28 17:26:06 ET]
Table 'VTPP NLHE 2805' 2-max (Play Money) Seat #1 is the button
Seat 1: s70n3fac3 (9713 in chips) 
Seat 2: FDIBA2009 (21448 in chips) 
s70n3fac3: posts small blind 50
FDIBA2009: posts big blind 100
*** HOLE CARDS ***
s70n3fac3: calls 50
FDIBA2009: checks 
*** FLOP *** [Jc 8d 3h]
FDIBA2009: checks 
s70n3fac3: checks 
*** TURN *** [Jc 8d 3h] [Qs]
FDIBA2009: checks 
s70n3fac3: bets 100
FDIBA2009: calls 100
*** RIVER *** [Jc 8d 3h Qs] [Qd]
FDIBA2009: checks 
s70n3fac3: bets 400
FDIBA2009: calls 400
*** SHOW DOWN ***
s70n3fac3: shows [2h Qh] (three of a kind, Queens)
FDIBA2009: mucks hand 
s70n3fac3 collected 1134 from pot
*** SUMMARY ***
Total pot 1200 | Rake 66 
Board [Jc 8d 3h Qs Qd]
Seat 1: s70n3fac3 (button) (small blind) showed [2h Qh] and won (1134) with three of a kind, Queens
Seat 2: FDIBA2009 (big blind) mucked [3s 6d]



PokerStars Home Game Hand #227143518444: {Club #4781089}  Hold'em No Limit (50/100) - 2021/05/29 0:26:29 EET [2021/05/28 17:26:29 ET]
Table 'VTPP NLHE 2805' 2-max (Play Money) Seat #2 is the button
Seat 1: s70n3fac3 (10247 in chips) 
Seat 2: FDIBA2009 (20848 in chips) 
FDIBA2009: posts small blind 50
s70n3fac3: posts big blind 100
*** HOLE CARDS ***
FDIBA2009: raises 100 to 200
s70n3fac3: calls 100
*** FLOP *** [9h 9d Qh]
s70n3fac3: checks 
FDIBA2009: checks 
*** TURN *** [9h 9d Qh] [Ts]
s70n3fac3: bets 200
FDIBA2009: raises 300 to 500
s70n3fac3: calls 300
*** RIVER *** [9h 9d Qh Ts] [8d]
s70n3fac3: checks 
FDIBA2009: checks 
*** SHOW DOWN ***
s70n3fac3: shows [Qd 8s] (two pair, Queens and Nines)
FDIBA2009: shows [9s 6c] (three of a kind, Nines)
FDIBA2009 collected 1323 from pot
*** SUMMARY ***
Total pot 1400 | Rake 77 
Board [9h 9d Qh Ts 8d]
Seat 1: s70n3fac3 (big blind) showed [Qd 8s] and lost with two pair, Queens and Nines
Seat 2: FDIBA2009 (button) (small blind) showed [9s 6c] and won (1323) with three of a kind, Nines



PokerStars Home Game Hand #227143531850: {Club #4781089}  Hold'em No Limit (50/100) - 2021/05/29 0:26:54 EET [2021/05/28 17:26:54 ET]
Table 'VTPP NLHE 2805' 2-max (Play Money) Seat #1 is the button
Seat 1: s70n3fac3 (9547 in chips) 
Seat 2: FDIBA2009 (21471 in chips) 
s70n3fac3: posts small blind 50
FDIBA2009: posts big blind 100
*** HOLE CARDS ***
s70n3fac3: calls 50
FDIBA2009: raises 200 to 300
s70n3fac3: calls 200
*** FLOP *** [7d 3d 2d]
FDIBA2009: bets 400
s70n3fac3: calls 400
*** TURN *** [7d 3d 2d] [Kc]
FDIBA2009: checks 
s70n3fac3: bets 750
FDIBA2009: calls 750
*** RIVER *** [7d 3d 2d Kc] [Kd]
FDIBA2009: bets 400
s70n3fac3: calls 400
*** SHOW DOWN ***
FDIBA2009: shows [Qc Qs] (two pair, Kings and Queens)
s70n3fac3: shows [8h Qd] (a flush, King high)
s70n3fac3 collected 3496 from pot
*** SUMMARY ***
Total pot 3700 | Rake 204 
Board [7d 3d 2d Kc Kd]
Seat 1: s70n3fac3 (button) (small blind) showed [8h Qd] and won (3496) with a flush, King high
Seat 2: FDIBA2009 (big blind) showed [Qc Qs] and lost with two pair, Kings and Queens



PokerStars Home Game Hand #227143569399: {Club #4781089}  Hold'em No Limit (50/100) - 2021/05/29 0:27:51 EET [2021/05/28 17:27:51 ET]
Table 'VTPP NLHE 2805' 2-max (Play Money) Seat #2 is the button
Seat 1: s70n3fac3 (11193 in chips) 
Seat 2: FDIBA2009 (19621 in chips) 
FDIBA2009: posts small blind 50
s70n3fac3: posts big blind 100
*** HOLE CARDS ***
FDIBA2009: raises 100 to 200
s70n3fac3: raises 450 to 650
FDIBA2009: folds 
Uncalled bet (450) returned to s70n3fac3
s70n3fac3 collected 400 from pot
s70n3fac3: doesn't show hand 
*** SUMMARY ***
Total pot 400 | Rake 0 
Seat 1: s70n3fac3 (big blind) collected (400)
Seat 2: FDIBA2009 (button) (small blind) folded before Flop



PokerStars Home Game Hand #227143578531: {Club #4781089}  Hold'em No Limit (50/100) - 2021/05/29 0:28:08 EET [2021/05/28 17:28:08 ET]
Table 'VTPP NLHE 2805' 2-max (Play Money) Seat #1 is the button
Seat 1: s70n3fac3 (11393 in chips) 
Seat 2: FDIBA2009 (19421 in chips) 
s70n3fac3: posts small blind 50
FDIBA2009: posts big blind 100
*** HOLE CARDS ***
s70n3fac3: folds 
Uncalled bet (50) returned to FDIBA2009
FDIBA2009 collected 100 from pot
FDIBA2009: doesn't show hand 
*** SUMMARY ***
Total pot 100 | Rake 0 
Seat 1: s70n3fac3 (button) (small blind) folded before Flop
Seat 2: FDIBA2009 (big blind) collected (100)



PokerStars Home Game Hand #227143580675: {Club #4781089}  Hold'em No Limit (50/100) - 2021/05/29 0:28:12 EET [2021/05/28 17:28:12 ET]
Table 'VTPP NLHE 2805' 2-max (Play Money) Seat #2 is the button
Seat 1: s70n3fac3 (11343 in chips) 
Seat 2: FDIBA2009 (19471 in chips) 
FDIBA2009: posts small blind 50
s70n3fac3: posts big blind 100
*** HOLE CARDS ***
FDIBA2009: raises 100 to 200
s70n3fac3: calls 100
*** FLOP *** [6s 6h Ad]
s70n3fac3: checks 
FDIBA2009: bets 200
s70n3fac3: folds 
Uncalled bet (200) returned to FDIBA2009
FDIBA2009 collected 378 from pot
FDIBA2009: doesn't show hand 
*** SUMMARY ***
Total pot 400 | Rake 22 
Board [6s 6h Ad]
Seat 1: s70n3fac3 (big blind) folded on the Flop
Seat 2: FDIBA2009 (button) (small blind) collected (378)



PokerStars Home Game Hand #227143587403: {Club #4781089}  Hold'em No Limit (50/100) - 2021/05/29 0:28:25 EET [2021/05/28 17:28:25 ET]
Table 'VTPP NLHE 2805' 2-max (Play Money) Seat #1 is the button
Seat 1: s70n3fac3 (11143 in chips) 
Seat 2: FDIBA2009 (19649 in chips) 
s70n3fac3: posts small blind 50
FDIBA2009: posts big blind 100
*** HOLE CARDS ***
s70n3fac3: raises 150 to 250
FDIBA2009: calls 150
*** FLOP *** [8d 9d 4s]
FDIBA2009: checks 
s70n3fac3: checks 
*** TURN *** [8d 9d 4s] [7d]
FDIBA2009: bets 472
s70n3fac3: folds 
Uncalled bet (472) returned to FDIBA2009
FDIBA2009 collected 472 from pot
FDIBA2009: doesn't show hand 
*** SUMMARY ***
Total pot 500 | Rake 28 
Board [8d 9d 4s 7d]
Seat 1: s70n3fac3 (button) (small blind) folded on the Turn
Seat 2: FDIBA2009 (big blind) collected (472)



PokerStars Home Game Hand #227143601118: {Club #4781089}  Hold'em No Limit (50/100) - 2021/05/29 0:28:51 EET [2021/05/28 17:28:51 ET]
Table 'VTPP NLHE 2805' 2-max (Play Money) Seat #2 is the button
Seat 1: s70n3fac3 (10893 in chips) 
Seat 2: FDIBA2009 (19871 in chips) 
FDIBA2009: posts small blind 50
s70n3fac3: posts big blind 100
*** HOLE CARDS ***
FDIBA2009: raises 100 to 200
s70n3fac3: calls 100
*** FLOP *** [Ah Td Js]
s70n3fac3: checks 
FDIBA2009: bets 200
s70n3fac3: folds 
Uncalled bet (200) returned to FDIBA2009
FDIBA2009 collected 378 from pot
FDIBA2009: doesn't show hand 
*** SUMMARY ***
Total pot 400 | Rake 22 
Board [Ah Td Js]
Seat 1: s70n3fac3 (big blind) folded on the Flop
Seat 2: FDIBA2009 (button) (small blind) collected (378)



PokerStars Home Game Hand #227143611748: {Club #4781089}  Hold'em No Limit (50/100) - 2021/05/29 0:29:11 EET [2021/05/28 17:29:11 ET]
Table 'VTPP NLHE 2805' 2-max (Play Money) Seat #1 is the button
Seat 1: s70n3fac3 (10693 in chips) 
Seat 2: FDIBA2009 (20049 in chips) 
s70n3fac3: posts small blind 50
FDIBA2009: posts big blind 100
*** HOLE CARDS ***
s70n3fac3: raises 150 to 250
FDIBA2009: calls 150
*** FLOP *** [8c 4d Th]
FDIBA2009: checks 
s70n3fac3: checks 
*** TURN *** [8c 4d Th] [9h]
FDIBA2009: checks 
s70n3fac3: bets 300
FDIBA2009: folds 
Uncalled bet (300) returned to s70n3fac3
s70n3fac3 collected 472 from pot
s70n3fac3: doesn't show hand 
*** SUMMARY ***
Total pot 500 | Rake 28 
Board [8c 4d Th 9h]
Seat 1: s70n3fac3 (button) (small blind) collected (472)
Seat 2: FDIBA2009 (big blind) folded on the Turn



PokerStars Home Game Hand #227143621120: {Club #4781089}  Hold'em No Limit (50/100) - 2021/05/29 0:29:29 EET [2021/05/28 17:29:29 ET]
Table 'VTPP NLHE 2805' 2-max (Play Money) Seat #2 is the button
Seat 1: s70n3fac3 (10915 in chips) 
Seat 2: FDIBA2009 (19799 in chips) 
FDIBA2009: posts small blind 50
s70n3fac3: posts big blind 100
*** HOLE CARDS ***
FDIBA2009: raises 100 to 200
s70n3fac3: folds 
Uncalled bet (100) returned to FDIBA2009
FDIBA2009 collected 200 from pot
FDIBA2009: doesn't show hand 
*** SUMMARY ***
Total pot 200 | Rake 0 
Seat 1: s70n3fac3 (big blind) folded before Flop
Seat 2: FDIBA2009 (button) (small blind) collected (200)



PokerStars Home Game Hand #227143624159: {Club #4781089}  Hold'em No Limit (50/100) - 2021/05/29 0:29:34 EET [2021/05/28 17:29:34 ET]
Table 'VTPP NLHE 2805' 2-max (Play Money) Seat #1 is the button
Seat 1: s70n3fac3 (10815 in chips) 
Seat 2: FDIBA2009 (19899 in chips) 
s70n3fac3: posts small blind 50
FDIBA2009: posts big blind 100
*** HOLE CARDS ***
s70n3fac3: folds 
Uncalled bet (50) returned to FDIBA2009
FDIBA2009 collected 100 from pot
FDIBA2009: doesn't show hand 
*** SUMMARY ***
Total pot 100 | Rake 0 
Seat 1: s70n3fac3 (button) (small blind) folded before Flop
Seat 2: FDIBA2009 (big blind) collected (100)



PokerStars Home Game Hand #227143626667: {Club #4781089}  Hold'em No Limit (50/100) - 2021/05/29 0:29:39 EET [2021/05/28 17:29:39 ET]
Table 'VTPP NLHE 2805' 2-max (Play Money) Seat #2 is the button
Seat 1: s70n3fac3 (10765 in chips) 
Seat 2: FDIBA2009 (19949 in chips) 
FDIBA2009: posts small blind 50
s70n3fac3: posts big blind 100
*** HOLE CARDS ***
FDIBA2009: raises 100 to 200
s70n3fac3: calls 100
*** FLOP *** [3d 7c Jd]
s70n3fac3: checks 
FDIBA2009: bets 200
s70n3fac3: folds 
Uncalled bet (200) returned to FDIBA2009
FDIBA2009 collected 378 from pot
FDIBA2009: doesn't show hand 
*** SUMMARY ***
Total pot 400 | Rake 22 
Board [3d 7c Jd]
Seat 1: s70n3fac3 (big blind) folded on the Flop
Seat 2: FDIBA2009 (button) (small blind) collected (378)



PokerStars Home Game Hand #227143633309: {Club #4781089}  Hold'em No Limit (50/100) - 2021/05/29 0:29:51 EET [2021/05/28 17:29:51 ET]
Table 'VTPP NLHE 2805' 2-max (Play Money) Seat #1 is the button
Seat 1: s70n3fac3 (10565 in chips) 
Seat 2: FDIBA2009 (20127 in chips) 
s70n3fac3: posts small blind 50
FDIBA2009: posts big blind 100
*** HOLE CARDS ***
s70n3fac3: raises 150 to 250
FDIBA2009: calls 150
*** FLOP *** [7s 2d Ks]
FDIBA2009: checks 
s70n3fac3: bets 200
FDIBA2009: folds 
Uncalled bet (200) returned to s70n3fac3
s70n3fac3 collected 472 from pot
s70n3fac3: doesn't show hand 
*** SUMMARY ***
Total pot 500 | Rake 28 
Board [7s 2d Ks]
Seat 1: s70n3fac3 (button) (small blind) collected (472)
Seat 2: FDIBA2009 (big blind) folded on the Flop



PokerStars Home Game Hand #227143639805: {Club #4781089}  Hold'em No Limit (50/100) - 2021/05/29 0:30:04 EET [2021/05/28 17:30:04 ET]
Table 'VTPP NLHE 2805' 2-max (Play Money) Seat #2 is the button
Seat 1: s70n3fac3 (10787 in chips) 
Seat 2: FDIBA2009 (19877 in chips) 
FDIBA2009: posts small blind 50
s70n3fac3: posts big blind 100
*** HOLE CARDS ***
FDIBA2009: raises 100 to 200
s70n3fac3: calls 100
*** FLOP *** [9s 6s 7c]
s70n3fac3: checks 
FDIBA2009: checks 
*** TURN *** [9s 6s 7c] [Ts]
s70n3fac3: bets 200
FDIBA2009: calls 200
*** RIVER *** [9s 6s 7c Ts] [Ks]
s70n3fac3: bets 400
FDIBA2009: folds 
Uncalled bet (400) returned to s70n3fac3
s70n3fac3 collected 756 from pot
s70n3fac3: doesn't show hand 
*** SUMMARY ***
Total pot 800 | Rake 44 
Board [9s 6s 7c Ts Ks]
Seat 1: s70n3fac3 (big blind) collected (756)
Seat 2: FDIBA2009 (button) (small blind) folded on the River



PokerStars Home Game Hand #227143649899: {Club #4781089}  Hold'em No Limit (50/100) - 2021/05/29 0:30:23 EET [2021/05/28 17:30:23 ET]
Table 'VTPP NLHE 2805' 2-max (Play Money) Seat #1 is the button
Seat 1: s70n3fac3 (11143 in chips) 
Seat 2: FDIBA2009 (19477 in chips) 
s70n3fac3: posts small blind 50
FDIBA2009: posts big blind 100
*** HOLE CARDS ***
s70n3fac3: folds 
Uncalled bet (50) returned to FDIBA2009
FDIBA2009 collected 100 from pot
FDIBA2009: doesn't show hand 
*** SUMMARY ***
Total pot 100 | Rake 0 
Seat 1: s70n3fac3 (button) (small blind) folded before Flop
Seat 2: FDIBA2009 (big blind) collected (100)



PokerStars Home Game Hand #227143651874: {Club #4781089}  Hold'em No Limit (50/100) - 2021/05/29 0:30:27 EET [2021/05/28 17:30:27 ET]
Table 'VTPP NLHE 2805' 2-max (Play Money) Seat #2 is the button
Seat 1: s70n3fac3 (11093 in chips) 
Seat 2: FDIBA2009 (19527 in chips) 
FDIBA2009: posts small blind 50
s70n3fac3: posts big blind 100
*** HOLE CARDS ***
FDIBA2009: raises 100 to 200
s70n3fac3: folds 
Uncalled bet (100) returned to FDIBA2009
FDIBA2009 collected 200 from pot
FDIBA2009: doesn't show hand 
*** SUMMARY ***
Total pot 200 | Rake 0 
Seat 1: s70n3fac3 (big blind) folded before Flop
Seat 2: FDIBA2009 (button) (small blind) collected (200)



PokerStars Home Game Hand #227143654864: {Club #4781089}  Hold'em No Limit (50/100) - 2021/05/29 0:30:32 EET [2021/05/28 17:30:32 ET]
Table 'VTPP NLHE 2805' 2-max (Play Money) Seat #1 is the button
Seat 1: s70n3fac3 (10993 in chips) 
Seat 2: FDIBA2009 (19627 in chips) 
s70n3fac3: posts small blind 50
FDIBA2009: posts big blind 100
*** HOLE CARDS ***
s70n3fac3: raises 150 to 250
FDIBA2009: calls 150
*** FLOP *** [3s 9c Qd]
FDIBA2009: checks 
s70n3fac3: checks 
*** TURN *** [3s 9c Qd] [3c]
FDIBA2009: checks 
s70n3fac3: bets 200
FDIBA2009: folds 
Uncalled bet (200) returned to s70n3fac3
s70n3fac3 collected 472 from pot
s70n3fac3: doesn't show hand 
*** SUMMARY ***
Total pot 500 | Rake 28 
Board [3s 9c Qd 3c]
Seat 1: s70n3fac3 (button) (small blind) collected (472)
Seat 2: FDIBA2009 (big blind) folded on the Turn



PokerStars Home Game Hand #227143663726: {Club #4781089}  Hold'em No Limit (50/100) - 2021/05/29 0:30:49 EET [2021/05/28 17:30:49 ET]
Table 'VTPP NLHE 2805' 2-max (Play Money) Seat #2 is the button
Seat 1: s70n3fac3 (11215 in chips) 
Seat 2: FDIBA2009 (19377 in chips) 
FDIBA2009: posts small blind 50
s70n3fac3: posts big blind 100
*** HOLE CARDS ***
FDIBA2009: raises 200 to 300
s70n3fac3: calls 200
*** FLOP *** [Qh 3c Ts]
s70n3fac3: checks 
FDIBA2009: bets 350
s70n3fac3: calls 350
*** TURN *** [Qh 3c Ts] [5c]
s70n3fac3: checks 
FDIBA2009: bets 900
s70n3fac3: folds 
Uncalled bet (900) returned to FDIBA2009
FDIBA2009 collected 1228 from pot
FDIBA2009: doesn't show hand 
*** SUMMARY ***
Total pot 1300 | Rake 72 
Board [Qh 3c Ts 5c]
Seat 1: s70n3fac3 (big blind) folded on the Turn
Seat 2: FDIBA2009 (button) (small blind) collected (1228)



PokerStars Home Game Hand #227143674788: {Club #4781089}  Hold'em No Limit (50/100) - 2021/05/29 0:31:11 EET [2021/05/28 17:31:11 ET]
Table 'VTPP NLHE 2805' 2-max (Play Money) Seat #1 is the button
Seat 1: s70n3fac3 (10565 in chips) 
Seat 2: FDIBA2009 (19955 in chips) 
s70n3fac3: posts small blind 50
FDIBA2009: posts big blind 100
*** HOLE CARDS ***
s70n3fac3: raises 100 to 200
FDIBA2009: raises 450 to 650
s70n3fac3: folds 
Uncalled bet (450) returned to FDIBA2009
FDIBA2009 collected 400 from pot
FDIBA2009: doesn't show hand 
*** SUMMARY ***
Total pot 400 | Rake 0 
Seat 1: s70n3fac3 (button) (small blind) folded before Flop
Seat 2: FDIBA2009 (big blind) collected (400)



PokerStars Home Game Hand #227143679721: {Club #4781089}  Hold'em No Limit (50/100) - 2021/05/29 0:31:20 EET [2021/05/28 17:31:20 ET]
Table 'VTPP NLHE 2805' 2-max (Play Money) Seat #2 is the button
Seat 1: s70n3fac3 (10365 in chips) 
Seat 2: FDIBA2009 (20155 in chips) 
FDIBA2009: posts small blind 50
s70n3fac3: posts big blind 100
*** HOLE CARDS ***
FDIBA2009: raises 100 to 200
s70n3fac3: folds 
Uncalled bet (100) returned to FDIBA2009
FDIBA2009 collected 200 from pot
FDIBA2009: doesn't show hand 
*** SUMMARY ***
Total pot 200 | Rake 0 
Seat 1: s70n3fac3 (big blind) folded before Flop
Seat 2: FDIBA2009 (button) (small blind) collected (200)



PokerStars Home Game Hand #227143682981: {Club #4781089}  Hold'em No Limit (50/100) - 2021/05/29 0:31:26 EET [2021/05/28 17:31:26 ET]
Table 'VTPP NLHE 2805' 2-max (Play Money) Seat #1 is the button
Seat 1: s70n3fac3 (10265 in chips) 
Seat 2: FDIBA2009 (20255 in chips) 
s70n3fac3: posts small blind 50
FDIBA2009: posts big blind 100
*** HOLE CARDS ***
s70n3fac3: raises 150 to 250
FDIBA2009: calls 150
*** FLOP *** [3c 8h Ac]
FDIBA2009: checks 
s70n3fac3: checks 
*** TURN *** [3c 8h Ac] [Jd]
FDIBA2009: bets 400
s70n3fac3: folds 
Uncalled bet (400) returned to FDIBA2009
FDIBA2009 collected 472 from pot
FDIBA2009: doesn't show hand 
*** SUMMARY ***
Total pot 500 | Rake 28 
Board [3c 8h Ac Jd]
Seat 1: s70n3fac3 (button) (small blind) folded on the Turn
Seat 2: FDIBA2009 (big blind) collected (472)



PokerStars Home Game Hand #227143691740: {Club #4781089}  Hold'em No Limit (50/100) - 2021/05/29 0:31:43 EET [2021/05/28 17:31:43 ET]
Table 'VTPP NLHE 2805' 2-max (Play Money) Seat #2 is the button
Seat 1: s70n3fac3 (10015 in chips) 
Seat 2: FDIBA2009 (20477 in chips) 
FDIBA2009: posts small blind 50
s70n3fac3: posts big blind 100
*** HOLE CARDS ***
FDIBA2009: raises 100 to 200
s70n3fac3: folds 
Uncalled bet (100) returned to FDIBA2009
FDIBA2009 collected 200 from pot
FDIBA2009: doesn't show hand 
*** SUMMARY ***
Total pot 200 | Rake 0 
Seat 1: s70n3fac3 (big blind) folded before Flop
Seat 2: FDIBA2009 (button) (small blind) collected (200)



PokerStars Home Game Hand #227143695880: {Club #4781089}  Hold'em No Limit (50/100) - 2021/05/29 0:31:51 EET [2021/05/28 17:31:51 ET]
Table 'VTPP NLHE 2805' 2-max (Play Money) Seat #1 is the button
Seat 1: s70n3fac3 (9915 in chips) 
Seat 2: FDIBA2009 (20577 in chips) 
s70n3fac3: posts small blind 50
FDIBA2009: posts big blind 100
*** HOLE CARDS ***
s70n3fac3: folds 
Uncalled bet (50) returned to FDIBA2009
FDIBA2009 collected 100 from pot
FDIBA2009: doesn't show hand 
*** SUMMARY ***
Total pot 100 | Rake 0 
Seat 1: s70n3fac3 (button) (small blind) folded before Flop
Seat 2: FDIBA2009 (big blind) collected (100)



PokerStars Home Game Hand #227143697834: {Club #4781089}  Hold'em No Limit (50/100) - 2021/05/29 0:31:54 EET [2021/05/28 17:31:54 ET]
Table 'VTPP NLHE 2805' 2-max (Play Money) Seat #2 is the button
Seat 1: s70n3fac3 (9865 in chips) 
Seat 2: FDIBA2009 (20627 in chips) 
FDIBA2009: posts small blind 50
s70n3fac3: posts big blind 100
*** HOLE CARDS ***
FDIBA2009: raises 100 to 200
s70n3fac3: calls 100
*** FLOP *** [5h 2d 3h]
s70n3fac3: checks 
FDIBA2009: checks 
*** TURN *** [5h 2d 3h] [3c]
s70n3fac3: checks 
FDIBA2009: bets 250
s70n3fac3: calls 250
*** RIVER *** [5h 2d 3h 3c] [Jh]
s70n3fac3: checks 
FDIBA2009: bets 500
s70n3fac3: raises 1050 to 1550
FDIBA2009: calls 1050
*** SHOW DOWN ***
s70n3fac3: shows [Qh 8h] (a flush, Queen high)
FDIBA2009: mucks hand 
s70n3fac3 collected 3780 from pot
*** SUMMARY ***
Total pot 4000 | Rake 220 
Board [5h 2d 3h 3c Jh]
Seat 1: s70n3fac3 (big blind) showed [Qh 8h] and won (3780) with a flush, Queen high
Seat 2: FDIBA2009 (button) (small blind) mucked [4d Ad]



PokerStars Home Game Hand #227143715273: {Club #4781089}  Hold'em No Limit (50/100) - 2021/05/29 0:32:28 EET [2021/05/28 17:32:28 ET]
Table 'VTPP NLHE 2805' 2-max (Play Money) Seat #1 is the button
Seat 1: s70n3fac3 (11645 in chips) 
Seat 2: FDIBA2009 (18627 in chips) 
s70n3fac3: posts small blind 50
FDIBA2009: posts big blind 100
*** HOLE CARDS ***
s70n3fac3: raises 100 to 200
FDIBA2009: raises 100 to 300
s70n3fac3: calls 100
*** FLOP *** [As 5c Qc]
FDIBA2009: checks 
s70n3fac3: checks 
*** TURN *** [As 5c Qc] [4s]
FDIBA2009: checks 
s70n3fac3: bets 400
FDIBA2009: folds 
Uncalled bet (400) returned to s70n3fac3
s70n3fac3 collected 567 from pot
s70n3fac3: doesn't show hand 
*** SUMMARY ***
Total pot 600 | Rake 33 
Board [As 5c Qc 4s]
Seat 1: s70n3fac3 (button) (small blind) collected (567)
Seat 2: FDIBA2009 (big blind) folded on the Turn



PokerStars Home Game Hand #227143727434: {Club #4781089}  Hold'em No Limit (50/100) - 2021/05/29 0:32:51 EET [2021/05/28 17:32:51 ET]
Table 'VTPP NLHE 2805' 2-max (Play Money) Seat #2 is the button
Seat 1: s70n3fac3 (11912 in chips) 
Seat 2: FDIBA2009 (18327 in chips) 
FDIBA2009: posts small blind 50
s70n3fac3: posts big blind 100
*** HOLE CARDS ***
FDIBA2009: raises 100 to 200
s70n3fac3: calls 100
*** FLOP *** [Kc 6c 5c]
s70n3fac3: checks 
FDIBA2009: bets 189
s70n3fac3: raises 411 to 600
FDIBA2009: calls 411
*** TURN *** [Kc 6c 5c] [6d]
s70n3fac3: checks 
FDIBA2009: checks 
*** RIVER *** [Kc 6c 5c 6d] [9h]
s70n3fac3: checks 
FDIBA2009: checks 
*** SHOW DOWN ***
s70n3fac3: shows [7h 7c] (two pair, Sevens and Sixes)
FDIBA2009: shows [Tc Th] (two pair, Tens and Sixes)
FDIBA2009 collected 1512 from pot
*** SUMMARY ***
Total pot 1600 | Rake 88 
Board [Kc 6c 5c 6d 9h]
Seat 1: s70n3fac3 (big blind) showed [7h 7c] and lost with two pair, Sevens and Sixes
Seat 2: FDIBA2009 (button) (small blind) showed [Tc Th] and won (1512) with two pair, Tens and Sixes



PokerStars Home Game Hand #227143741937: {Club #4781089}  Hold'em No Limit (50/100) - 2021/05/29 0:33:19 EET [2021/05/28 17:33:19 ET]
Table 'VTPP NLHE 2805' 2-max (Play Money) Seat #1 is the button
Seat 1: s70n3fac3 (11112 in chips) 
Seat 2: FDIBA2009 (19039 in chips) 
s70n3fac3: posts small blind 50
FDIBA2009: posts big blind 100
*** HOLE CARDS ***
s70n3fac3: folds 
Uncalled bet (50) returned to FDIBA2009
FDIBA2009 collected 100 from pot
FDIBA2009: doesn't show hand 
*** SUMMARY ***
Total pot 100 | Rake 0 
Seat 1: s70n3fac3 (button) (small blind) folded before Flop
Seat 2: FDIBA2009 (big blind) collected (100)



PokerStars Home Game Hand #227143743886: {Club #4781089}  Hold'em No Limit (50/100) - 2021/05/29 0:33:23 EET [2021/05/28 17:33:23 ET]
Table 'VTPP NLHE 2805' 2-max (Play Money) Seat #2 is the button
Seat 1: s70n3fac3 (11062 in chips) 
Seat 2: FDIBA2009 (19089 in chips) 
FDIBA2009: posts small blind 50
s70n3fac3: posts big blind 100
*** HOLE CARDS ***
FDIBA2009: raises 100 to 200
s70n3fac3: raises 400 to 600
FDIBA2009: calls 400
*** FLOP *** [Qs 9h Jh]
s70n3fac3: bets 650
FDIBA2009: folds 
Uncalled bet (650) returned to s70n3fac3
s70n3fac3 collected 1134 from pot
s70n3fac3: doesn't show hand 
*** SUMMARY ***
Total pot 1200 | Rake 66 
Board [Qs 9h Jh]
Seat 1: s70n3fac3 (big blind) collected (1134)
Seat 2: FDIBA2009 (button) (small blind) folded on the Flop



PokerStars Home Game Hand #227143752716: {Club #4781089}  Hold'em No Limit (50/100) - 2021/05/29 0:33:39 EET [2021/05/28 17:33:39 ET]
Table 'VTPP NLHE 2805' 2-max (Play Money) Seat #1 is the button
Seat 1: s70n3fac3 (11596 in chips) 
Seat 2: FDIBA2009 (18489 in chips) 
s70n3fac3: posts small blind 50
FDIBA2009: posts big blind 100
*** HOLE CARDS ***
s70n3fac3: raises 150 to 250
FDIBA2009: calls 150
*** FLOP *** [3h As 4h]
FDIBA2009: checks 
s70n3fac3: bets 200
FDIBA2009: calls 200
*** TURN *** [3h As 4h] [5d]
FDIBA2009: checks 
s70n3fac3: checks 
*** RIVER *** [3h As 4h 5d] [5s]
FDIBA2009: bets 650
s70n3fac3: folds 
Uncalled bet (650) returned to FDIBA2009
FDIBA2009 collected 850 from pot
FDIBA2009: doesn't show hand 
*** SUMMARY ***
Total pot 900 | Rake 50 
Board [3h As 4h 5d 5s]
Seat 1: s70n3fac3 (button) (small blind) folded on the River
Seat 2: FDIBA2009 (big blind) collected (850)



PokerStars Home Game Hand #227143769766: {Club #4781089}  Hold'em No Limit (50/100) - 2021/05/29 0:34:12 EET [2021/05/28 17:34:12 ET]
Table 'VTPP NLHE 2805' 2-max (Play Money) Seat #2 is the button
Seat 1: s70n3fac3 (11146 in chips) 
Seat 2: FDIBA2009 (18889 in chips) 
FDIBA2009: posts small blind 50
s70n3fac3: posts big blind 100
*** HOLE CARDS ***
FDIBA2009: raises 100 to 200
s70n3fac3: folds 
Uncalled bet (100) returned to FDIBA2009
FDIBA2009 collected 200 from pot
FDIBA2009: doesn't show hand 
*** SUMMARY ***
Total pot 200 | Rake 0 
Seat 1: s70n3fac3 (big blind) folded before Flop
Seat 2: FDIBA2009 (button) (small blind) collected (200)



PokerStars Home Game Hand #227143773452: {Club #4781089}  Hold'em No Limit (50/100) - 2021/05/29 0:34:19 EET [2021/05/28 17:34:19 ET]
Table 'VTPP NLHE 2805' 2-max (Play Money) Seat #1 is the button
Seat 1: s70n3fac3 (11046 in chips) 
Seat 2: FDIBA2009 (18989 in chips) 
s70n3fac3: posts small blind 50
FDIBA2009: posts big blind 100
*** HOLE CARDS ***
s70n3fac3: calls 50
FDIBA2009: checks 
*** FLOP *** [3d 9c Qh]
FDIBA2009: checks 
s70n3fac3: checks 
*** TURN *** [3d 9c Qh] [Qc]
FDIBA2009: bets 189
s70n3fac3: folds 
Uncalled bet (189) returned to FDIBA2009
FDIBA2009 collected 189 from pot
FDIBA2009: doesn't show hand 
*** SUMMARY ***
Total pot 200 | Rake 11 
Board [3d 9c Qh Qc]
Seat 1: s70n3fac3 (button) (small blind) folded on the Turn
Seat 2: FDIBA2009 (big blind) collected (189)



PokerStars Home Game Hand #227143780776: {Club #4781089}  Hold'em No Limit (50/100) - 2021/05/29 0:34:33 EET [2021/05/28 17:34:33 ET]
Table 'VTPP NLHE 2805' 2-max (Play Money) Seat #2 is the button
Seat 1: s70n3fac3 (10946 in chips) 
Seat 2: FDIBA2009 (19078 in chips) 
FDIBA2009: posts small blind 50
s70n3fac3: posts big blind 100
*** HOLE CARDS ***
FDIBA2009: raises 100 to 200
s70n3fac3: folds 
Uncalled bet (100) returned to FDIBA2009
FDIBA2009 collected 200 from pot
FDIBA2009: doesn't show hand 
*** SUMMARY ***
Total pot 200 | Rake 0 
Seat 1: s70n3fac3 (big blind) folded before Flop
Seat 2: FDIBA2009 (button) (small blind) collected (200)



PokerStars Home Game Hand #227143783874: {Club #4781089}  Hold'em No Limit (50/100) - 2021/05/29 0:34:39 EET [2021/05/28 17:34:39 ET]
Table 'VTPP NLHE 2805' 2-max (Play Money) Seat #1 is the button
Seat 1: s70n3fac3 (10846 in chips) 
Seat 2: FDIBA2009 (19178 in chips) 
s70n3fac3: posts small blind 50
FDIBA2009: posts big blind 100
*** HOLE CARDS ***
s70n3fac3: calls 50
FDIBA2009: checks 
*** FLOP *** [5s 5c 7h]
FDIBA2009: checks 
s70n3fac3: bets 200
FDIBA2009: folds 
Uncalled bet (200) returned to s70n3fac3
s70n3fac3 collected 189 from pot
s70n3fac3: doesn't show hand 
*** SUMMARY ***
Total pot 200 | Rake 11 
Board [5s 5c 7h]
Seat 1: s70n3fac3 (button) (small blind) collected (189)
Seat 2: FDIBA2009 (big blind) folded on the Flop



PokerStars Home Game Hand #227143789986: {Club #4781089}  Hold'em No Limit (50/100) - 2021/05/29 0:34:51 EET [2021/05/28 17:34:51 ET]
Table 'VTPP NLHE 2805' 2-max (Play Money) Seat #2 is the button
Seat 1: s70n3fac3 (10935 in chips) 
Seat 2: FDIBA2009 (19078 in chips) 
FDIBA2009: posts small blind 50
s70n3fac3: posts big blind 100
*** HOLE CARDS ***
FDIBA2009: raises 100 to 200
s70n3fac3: folds 
Uncalled bet (100) returned to FDIBA2009
FDIBA2009 collected 200 from pot
FDIBA2009: doesn't show hand 
*** SUMMARY ***
Total pot 200 | Rake 0 
Seat 1: s70n3fac3 (big blind) folded before Flop
Seat 2: FDIBA2009 (button) (small blind) collected (200)



PokerStars Home Game Hand #227143793301: {Club #4781089}  Hold'em No Limit (50/100) - 2021/05/29 0:34:57 EET [2021/05/28 17:34:57 ET]
Table 'VTPP NLHE 2805' 2-max (Play Money) Seat #1 is the button
Seat 1: s70n3fac3 (10835 in chips) 
Seat 2: FDIBA2009 (19178 in chips) 
s70n3fac3: posts small blind 50
FDIBA2009: posts big blind 100
*** HOLE CARDS ***
s70n3fac3: raises 150 to 250
FDIBA2009: raises 500 to 750
s70n3fac3: raises 750 to 1500
FDIBA2009: calls 750
*** FLOP *** [2c 5h 9s]
FDIBA2009: checks 
s70n3fac3: bets 1500
FDIBA2009: folds 
Uncalled bet (1500) returned to s70n3fac3
s70n3fac3 collected 2835 from pot
s70n3fac3: doesn't show hand 
*** SUMMARY ***
Total pot 3000 | Rake 165 
Board [2c 5h 9s]
Seat 1: s70n3fac3 (button) (small blind) collected (2835)
Seat 2: FDIBA2009 (big blind) folded on the Flop



PokerStars Home Game Hand #227143807635: {Club #4781089}  Hold'em No Limit (50/100) - 2021/05/29 0:35:24 EET [2021/05/28 17:35:24 ET]
Table 'VTPP NLHE 2805' 2-max (Play Money) Seat #2 is the button
Seat 1: s70n3fac3 (12170 in chips) 
Seat 2: FDIBA2009 (17678 in chips) 
FDIBA2009: posts small blind 50
s70n3fac3: posts big blind 100
*** HOLE CARDS ***
FDIBA2009: raises 100 to 200
s70n3fac3: raises 400 to 600
FDIBA2009: calls 400
*** FLOP *** [6s 7h 5s]
s70n3fac3: bets 700
FDIBA2009: folds 
Uncalled bet (700) returned to s70n3fac3
s70n3fac3 collected 1134 from pot
s70n3fac3: doesn't show hand 
*** SUMMARY ***
Total pot 1200 | Rake 66 
Board [6s 7h 5s]
Seat 1: s70n3fac3 (big blind) collected (1134)
Seat 2: FDIBA2009 (button) (small blind) folded on the Flop



PokerStars Home Game Hand #227143815138: {Club #4781089}  Hold'em No Limit (50/100) - 2021/05/29 0:35:39 EET [2021/05/28 17:35:39 ET]
Table 'VTPP NLHE 2805' 2-max (Play Money) Seat #1 is the button
Seat 1: s70n3fac3 (12704 in chips) 
Seat 2: FDIBA2009 (17078 in chips) 
s70n3fac3: posts small blind 50
FDIBA2009: posts big blind 100
*** HOLE CARDS ***
s70n3fac3: folds 
Uncalled bet (50) returned to FDIBA2009
FDIBA2009 collected 100 from pot
FDIBA2009: doesn't show hand 
*** SUMMARY ***
Total pot 100 | Rake 0 
Seat 1: s70n3fac3 (button) (small blind) folded before Flop
Seat 2: FDIBA2009 (big blind) collected (100)



PokerStars Home Game Hand #227143817119: {Club #4781089}  Hold'em No Limit (50/100) - 2021/05/29 0:35:43 EET [2021/05/28 17:35:43 ET]
Table 'VTPP NLHE 2805' 2-max (Play Money) Seat #2 is the button
Seat 1: s70n3fac3 (12654 in chips) 
Seat 2: FDIBA2009 (17128 in chips) 
FDIBA2009: posts small blind 50
s70n3fac3: posts big blind 100
*** HOLE CARDS ***
FDIBA2009: raises 100 to 200
s70n3fac3: calls 100
*** FLOP *** [Jh 2h Th]
s70n3fac3: checks 
FDIBA2009: bets 378
s70n3fac3: folds 
Uncalled bet (378) returned to FDIBA2009
FDIBA2009 collected 378 from pot
FDIBA2009: doesn't show hand 
*** SUMMARY ***
Total pot 400 | Rake 22 
Board [Jh 2h Th]
Seat 1: s70n3fac3 (big blind) folded on the Flop
Seat 2: FDIBA2009 (button) (small blind) collected (378)



PokerStars Home Game Hand #227143823557: {Club #4781089}  Hold'em No Limit (50/100) - 2021/05/29 0:35:55 EET [2021/05/28 17:35:55 ET]
Table 'VTPP NLHE 2805' 2-max (Play Money) Seat #1 is the button
Seat 1: s70n3fac3 (12454 in chips) 
Seat 2: FDIBA2009 (17306 in chips) 
s70n3fac3: posts small blind 50
FDIBA2009: posts big blind 100
*** HOLE CARDS ***
s70n3fac3: calls 50
FDIBA2009: raises 200 to 300
s70n3fac3: calls 200
*** FLOP *** [5h 9c 5c]
FDIBA2009: bets 350
s70n3fac3: calls 350
*** TURN *** [5h 9c 5c] [7c]
FDIBA2009: bets 800
s70n3fac3: calls 800
*** RIVER *** [5h 9c 5c 7c] [3h]
FDIBA2009: checks 
s70n3fac3: bets 650
FDIBA2009: calls 650
*** SHOW DOWN ***
s70n3fac3: shows [5d 6h] (three of a kind, Fives)
FDIBA2009: mucks hand 
s70n3fac3 collected 3969 from pot
*** SUMMARY ***
Total pot 4200 | Rake 231 
Board [5h 9c 5c 7c 3h]
Seat 1: s70n3fac3 (button) (small blind) showed [5d 6h] and won (3969) with three of a kind, Fives
Seat 2: FDIBA2009 (big blind) mucked [8c 8d]



PokerStars Home Game Hand #227143844852: {Club #4781089}  Hold'em No Limit (50/100) - 2021/05/29 0:36:36 EET [2021/05/28 17:36:36 ET]
Table 'VTPP NLHE 2805' 2-max (Play Money) Seat #2 is the button
Seat 1: s70n3fac3 (14323 in chips) 
Seat 2: FDIBA2009 (15206 in chips) 
FDIBA2009: posts small blind 50
s70n3fac3: posts big blind 100
*** HOLE CARDS ***
FDIBA2009: raises 100 to 200
s70n3fac3: calls 100
*** FLOP *** [3h 7h 5s]
s70n3fac3: checks 
FDIBA2009: checks 
*** TURN *** [3h 7h 5s] [Qd]
s70n3fac3: checks 
FDIBA2009: bets 378
s70n3fac3: folds 
Uncalled bet (378) returned to FDIBA2009
FDIBA2009 collected 378 from pot
FDIBA2009: doesn't show hand 
*** SUMMARY ***
Total pot 400 | Rake 22 
Board [3h 7h 5s Qd]
Seat 1: s70n3fac3 (big blind) folded on the Turn
Seat 2: FDIBA2009 (button) (small blind) collected (378)



PokerStars Home Game Hand #227143858587: {Club #4781089}  Hold'em No Limit (50/100) - 2021/05/29 0:37:03 EET [2021/05/28 17:37:03 ET]
Table 'VTPP NLHE 2805' 2-max (Play Money) Seat #1 is the button
Seat 1: s70n3fac3 (14123 in chips) 
Seat 2: FDIBA2009 (15384 in chips) 
s70n3fac3: posts small blind 50
FDIBA2009: posts big blind 100
*** HOLE CARDS ***
s70n3fac3: raises 100 to 200
FDIBA2009: folds 
Uncalled bet (100) returned to s70n3fac3
s70n3fac3 collected 200 from pot
s70n3fac3: doesn't show hand 
*** SUMMARY ***
Total pot 200 | Rake 0 
Seat 1: s70n3fac3 (button) (small blind) collected (200)
Seat 2: FDIBA2009 (big blind) folded before Flop



PokerStars Home Game Hand #227143861433: {Club #4781089}  Hold'em No Limit (50/100) - 2021/05/29 0:37:08 EET [2021/05/28 17:37:08 ET]
Table 'VTPP NLHE 2805' 2-max (Play Money) Seat #2 is the button
Seat 1: s70n3fac3 (14223 in chips) 
Seat 2: FDIBA2009 (15284 in chips) 
FDIBA2009: posts small blind 50
s70n3fac3: posts big blind 100
*** HOLE CARDS ***
FDIBA2009: raises 200 to 300
s70n3fac3: calls 200
*** FLOP *** [2c Ts 7s]
s70n3fac3: checks 
FDIBA2009: bets 350
s70n3fac3: calls 350
*** TURN *** [2c Ts 7s] [8d]
s70n3fac3: checks 
FDIBA2009: bets 850
s70n3fac3: folds 
Uncalled bet (850) returned to FDIBA2009
FDIBA2009 collected 1228 from pot
FDIBA2009: doesn't show hand 
*** SUMMARY ***
Total pot 1300 | Rake 72 
Board [2c Ts 7s 8d]
Seat 1: s70n3fac3 (big blind) folded on the Turn
Seat 2: FDIBA2009 (button) (small blind) collected (1228)



PokerStars Home Game Hand #227143881080: {Club #4781089}  Hold'em No Limit (50/100) - 2021/05/29 0:37:40 EET [2021/05/28 17:37:40 ET]
Table 'VTPP NLHE 2805' 2-max (Play Money) Seat #1 is the button
Seat 1: s70n3fac3 (13573 in chips) 
Seat 2: FDIBA2009 (15862 in chips) 
s70n3fac3: posts small blind 50
FDIBA2009: posts big blind 100
*** HOLE CARDS ***
s70n3fac3: raises 100 to 200
FDIBA2009: raises 450 to 650
s70n3fac3: folds 
Uncalled bet (450) returned to FDIBA2009
FDIBA2009 collected 400 from pot
FDIBA2009: doesn't show hand 
*** SUMMARY ***
Total pot 400 | Rake 0 
Seat 1: s70n3fac3 (button) (small blind) folded before Flop
Seat 2: FDIBA2009 (big blind) collected (400)



PokerStars Home Game Hand #227143885578: {Club #4781089}  Hold'em No Limit (50/100) - 2021/05/29 0:37:48 EET [2021/05/28 17:37:48 ET]
Table 'VTPP NLHE 2805' 2-max (Play Money) Seat #2 is the button
Seat 1: s70n3fac3 (13373 in chips) 
Seat 2: FDIBA2009 (16062 in chips) 
FDIBA2009: posts small blind 50
s70n3fac3: posts big blind 100
*** HOLE CARDS ***
FDIBA2009: raises 100 to 200
s70n3fac3: calls 100
*** FLOP *** [Js 2s Jc]
s70n3fac3: checks 
FDIBA2009: checks 
*** TURN *** [Js 2s Jc] [8h]
s70n3fac3: checks 
FDIBA2009: bets 378
s70n3fac3: folds 
Uncalled bet (378) returned to FDIBA2009
FDIBA2009 collected 378 from pot
FDIBA2009: doesn't show hand 
*** SUMMARY ***
Total pot 400 | Rake 22 
Board [Js 2s Jc 8h]
Seat 1: s70n3fac3 (big blind) folded on the Turn
Seat 2: FDIBA2009 (button) (small blind) collected (378)



PokerStars Home Game Hand #227143892543: {Club #4781089}  Hold'em No Limit (50/100) - 2021/05/29 0:38:02 EET [2021/05/28 17:38:02 ET]
Table 'VTPP NLHE 2805' 2-max (Play Money) Seat #1 is the button
Seat 1: s70n3fac3 (13173 in chips) 
Seat 2: FDIBA2009 (16240 in chips) 
s70n3fac3: posts small blind 50
FDIBA2009: posts big blind 100
*** HOLE CARDS ***
s70n3fac3: raises 100 to 200
FDIBA2009: raises 400 to 600
s70n3fac3: calls 400
*** FLOP *** [Jd Qs Qc]
FDIBA2009: bets 600
s70n3fac3: calls 600
*** TURN *** [Jd Qs Qc] [9d]
FDIBA2009: bets 1850
s70n3fac3: folds 
Uncalled bet (1850) returned to FDIBA2009
FDIBA2009 collected 2268 from pot
FDIBA2009: doesn't show hand 
*** SUMMARY ***
Total pot 2400 | Rake 132 
Board [Jd Qs Qc 9d]
Seat 1: s70n3fac3 (button) (small blind) folded on the Turn
Seat 2: FDIBA2009 (big blind) collected (2268)



PokerStars Home Game Hand #227143912212: {Club #4781089}  Hold'em No Limit (50/100) - 2021/05/29 0:38:40 EET [2021/05/28 17:38:40 ET]
Table 'VTPP NLHE 2805' 2-max (Play Money) Seat #2 is the button
Seat 1: s70n3fac3 (11973 in chips) 
Seat 2: FDIBA2009 (17308 in chips) 
FDIBA2009: posts small blind 50
s70n3fac3: posts big blind 100
*** HOLE CARDS ***
FDIBA2009: raises 100 to 200
s70n3fac3: folds 
Uncalled bet (100) returned to FDIBA2009
FDIBA2009 collected 200 from pot
FDIBA2009: doesn't show hand 
*** SUMMARY ***
Total pot 200 | Rake 0 
Seat 1: s70n3fac3 (big blind) folded before Flop
Seat 2: FDIBA2009 (button) (small blind) collected (200)



PokerStars Home Game Hand #227143915733: {Club #4781089}  Hold'em No Limit (50/100) - 2021/05/29 0:38:47 EET [2021/05/28 17:38:47 ET]
Table 'VTPP NLHE 2805' 2-max (Play Money) Seat #1 is the button
Seat 1: s70n3fac3 (11873 in chips) 
Seat 2: FDIBA2009 (17408 in chips) 
s70n3fac3: posts small blind 50
FDIBA2009: posts big blind 100
*** HOLE CARDS ***
s70n3fac3: raises 100 to 200
FDIBA2009: raises 100 to 300
s70n3fac3: calls 100
*** FLOP *** [Jd 4c 9d]
FDIBA2009: bets 300
s70n3fac3: folds 
Uncalled bet (300) returned to FDIBA2009
FDIBA2009 collected 567 from pot
FDIBA2009: doesn't show hand 
*** SUMMARY ***
Total pot 600 | Rake 33 
Board [Jd 4c 9d]
Seat 1: s70n3fac3 (button) (small blind) folded on the Flop
Seat 2: FDIBA2009 (big blind) collected (567)



PokerStars Home Game Hand #227143921613: {Club #4781089}  Hold'em No Limit (50/100) - 2021/05/29 0:38:58 EET [2021/05/28 17:38:58 ET]
Table 'VTPP NLHE 2805' 2-max (Play Money) Seat #2 is the button
Seat 1: s70n3fac3 (11573 in chips) 
Seat 2: FDIBA2009 (17675 in chips) 
FDIBA2009: posts small blind 50
s70n3fac3: posts big blind 100
*** HOLE CARDS ***
FDIBA2009: raises 100 to 200
s70n3fac3: calls 100
*** FLOP *** [Kd 5d 8d]
s70n3fac3: checks 
FDIBA2009: bets 200
s70n3fac3: calls 200
*** TURN *** [Kd 5d 8d] [2c]
s70n3fac3: checks 
FDIBA2009: bets 756
s70n3fac3: calls 756
*** RIVER *** [Kd 5d 8d 2c] [Tc]
s70n3fac3: checks 
FDIBA2009: checks 
*** SHOW DOWN ***
s70n3fac3: shows [8c 7h] (a pair of Eights)
FDIBA2009: shows [Ad 8h] (a pair of Eights - Ace kicker)
FDIBA2009 collected 2185 from pot
*** SUMMARY ***
Total pot 2312 | Rake 127 
Board [Kd 5d 8d 2c Tc]
Seat 1: s70n3fac3 (big blind) showed [8c 7h] and lost with a pair of Eights
Seat 2: FDIBA2009 (button) (small blind) showed [Ad 8h] and won (2185) with a pair of Eights



PokerStars Home Game Hand #227143932613: {Club #4781089}  Hold'em No Limit (50/100) - 2021/05/29 0:39:20 EET [2021/05/28 17:39:20 ET]
Table 'VTPP NLHE 2805' 2-max (Play Money) Seat #1 is the button
Seat 1: s70n3fac3 (10417 in chips) 
Seat 2: FDIBA2009 (18704 in chips) 
s70n3fac3: posts small blind 50
FDIBA2009: posts big blind 100
*** HOLE CARDS ***
s70n3fac3: folds 
Uncalled bet (50) returned to FDIBA2009
FDIBA2009 collected 100 from pot
FDIBA2009: doesn't show hand 
*** SUMMARY ***
Total pot 100 | Rake 0 
Seat 1: s70n3fac3 (button) (small blind) folded before Flop
Seat 2: FDIBA2009 (big blind) collected (100)



PokerStars Home Game Hand #227143934551: {Club #4781089}  Hold'em No Limit (50/100) - 2021/05/29 0:39:24 EET [2021/05/28 17:39:24 ET]
Table 'VTPP NLHE 2805' 2-max (Play Money) Seat #2 is the button
Seat 1: s70n3fac3 (10367 in chips) 
Seat 2: FDIBA2009 (18754 in chips) 
FDIBA2009: posts small blind 50
s70n3fac3: posts big blind 100
*** HOLE CARDS ***
FDIBA2009: raises 100 to 200
s70n3fac3: calls 100
*** FLOP *** [7d 7h Kc]
s70n3fac3: checks 
FDIBA2009: checks 
*** TURN *** [7d 7h Kc] [9s]
s70n3fac3: checks 
FDIBA2009: bets 378
s70n3fac3: calls 378
*** RIVER *** [7d 7h Kc 9s] [8h]
s70n3fac3: checks 
FDIBA2009: bets 350
s70n3fac3: calls 350
*** SHOW DOWN ***
FDIBA2009: shows [Ks 2c] (two pair, Kings and Sevens)
s70n3fac3: mucks hand 
FDIBA2009 collected 1754 from pot
*** SUMMARY ***
Total pot 1856 | Rake 102 
Board [7d 7h Kc 9s 8h]
Seat 1: s70n3fac3 (big blind) mucked [9h Ts]
Seat 2: FDIBA2009 (button) (small blind) showed [Ks 2c] and won (1754) with two pair, Kings and Sevens



PokerStars Home Game Hand #227143947189: {Club #4781089}  Hold'em No Limit (50/100) - 2021/05/29 0:39:48 EET [2021/05/28 17:39:48 ET]
Table 'VTPP NLHE 2805' 2-max (Play Money) Seat #1 is the button
Seat 1: s70n3fac3 (9439 in chips) 
Seat 2: FDIBA2009 (19580 in chips) 
s70n3fac3: posts small blind 50
FDIBA2009: posts big blind 100
*** HOLE CARDS ***
s70n3fac3: raises 150 to 250
FDIBA2009: raises 500 to 750
s70n3fac3: folds 
Uncalled bet (500) returned to FDIBA2009
FDIBA2009 collected 500 from pot
FDIBA2009: doesn't show hand 
*** SUMMARY ***
Total pot 500 | Rake 0 
Seat 1: s70n3fac3 (button) (small blind) folded before Flop
Seat 2: FDIBA2009 (big blind) collected (500)



PokerStars Home Game Hand #227143953144: {Club #4781089}  Hold'em No Limit (50/100) - 2021/05/29 0:40:00 EET [2021/05/28 17:40:00 ET]
Table 'VTPP NLHE 2805' 2-max (Play Money) Seat #2 is the button
Seat 1: s70n3fac3 (9189 in chips) 
Seat 2: FDIBA2009 (19830 in chips) 
FDIBA2009: posts small blind 50
s70n3fac3: posts big blind 100
*** HOLE CARDS ***
FDIBA2009: raises 100 to 200
s70n3fac3: calls 100
*** FLOP *** [Ts 6h 6c]
s70n3fac3: checks 
FDIBA2009: checks 
*** TURN *** [Ts 6h 6c] [Th]
s70n3fac3: checks 
FDIBA2009: checks 
*** RIVER *** [Ts 6h 6c Th] [8h]
s70n3fac3: checks 
FDIBA2009: bets 100
s70n3fac3: folds 
Uncalled bet (100) returned to FDIBA2009
FDIBA2009 collected 378 from pot
FDIBA2009: doesn't show hand 
*** SUMMARY ***
Total pot 400 | Rake 22 
Board [Ts 6h 6c Th 8h]
Seat 1: s70n3fac3 (big blind) folded on the River
Seat 2: FDIBA2009 (button) (small blind) collected (378)



PokerStars Home Game Hand #227143960906: {Club #4781089}  Hold'em No Limit (50/100) - 2021/05/29 0:40:15 EET [2021/05/28 17:40:15 ET]
Table 'VTPP NLHE 2805' 2-max (Play Money) Seat #1 is the button
Seat 1: s70n3fac3 (8989 in chips) 
Seat 2: FDIBA2009 (20008 in chips) 
s70n3fac3: posts small blind 50
FDIBA2009: posts big blind 100
*** HOLE CARDS ***
s70n3fac3: folds 
Uncalled bet (50) returned to FDIBA2009
FDIBA2009 collected 100 from pot
FDIBA2009: doesn't show hand 
*** SUMMARY ***
Total pot 100 | Rake 0 
Seat 1: s70n3fac3 (button) (small blind) folded before Flop
Seat 2: FDIBA2009 (big blind) collected (100)



PokerStars Home Game Hand #227143962678: {Club #4781089}  Hold'em No Limit (50/100) - 2021/05/29 0:40:19 EET [2021/05/28 17:40:19 ET]
Table 'VTPP NLHE 2805' 2-max (Play Money) Seat #2 is the button
Seat 1: s70n3fac3 (8939 in chips) 
Seat 2: FDIBA2009 (20058 in chips) 
FDIBA2009: posts small blind 50
s70n3fac3: posts big blind 100
*** HOLE CARDS ***
FDIBA2009: raises 100 to 200
s70n3fac3: calls 100
*** FLOP *** [Qs 7d 2c]
s70n3fac3: checks 
FDIBA2009: checks 
*** TURN *** [Qs 7d 2c] [9d]
s70n3fac3: checks 
FDIBA2009: bets 378
s70n3fac3: folds 
Uncalled bet (378) returned to FDIBA2009
FDIBA2009 collected 378 from pot
FDIBA2009: doesn't show hand 
*** SUMMARY ***
Total pot 400 | Rake 22 
Board [Qs 7d 2c 9d]
Seat 1: s70n3fac3 (big blind) folded on the Turn
Seat 2: FDIBA2009 (button) (small blind) collected (378)



PokerStars Home Game Hand #227143969948: {Club #4781089}  Hold'em No Limit (50/100) - 2021/05/29 0:40:33 EET [2021/05/28 17:40:33 ET]
Table 'VTPP NLHE 2805' 2-max (Play Money) Seat #1 is the button
Seat 1: s70n3fac3 (8739 in chips) 
Seat 2: FDIBA2009 (20236 in chips) 
s70n3fac3: posts small blind 50
FDIBA2009: posts big blind 100
*** HOLE CARDS ***
s70n3fac3: folds 
Uncalled bet (50) returned to FDIBA2009
FDIBA2009 collected 100 from pot
FDIBA2009: doesn't show hand 
*** SUMMARY ***
Total pot 100 | Rake 0 
Seat 1: s70n3fac3 (button) (small blind) folded before Flop
Seat 2: FDIBA2009 (big blind) collected (100)



PokerStars Home Game Hand #227143972055: {Club #4781089}  Hold'em No Limit (50/100) - 2021/05/29 0:40:37 EET [2021/05/28 17:40:37 ET]
Table 'VTPP NLHE 2805' 2-max (Play Money) Seat #2 is the button
Seat 1: s70n3fac3 (8689 in chips) 
Seat 2: FDIBA2009 (20286 in chips) 
FDIBA2009: posts small blind 50
s70n3fac3: posts big blind 100
*** HOLE CARDS ***
FDIBA2009: raises 100 to 200
s70n3fac3: calls 100
*** FLOP *** [7d Kc Tc]
s70n3fac3: checks 
FDIBA2009: checks 
*** TURN *** [7d Kc Tc] [Qd]
s70n3fac3: checks 
FDIBA2009: checks 
*** RIVER *** [7d Kc Tc Qd] [Js]
s70n3fac3: checks 
FDIBA2009: checks 
*** SHOW DOWN ***
s70n3fac3: shows [4d 4h] (a pair of Fours)
FDIBA2009: mucks hand 
s70n3fac3 collected 378 from pot
*** SUMMARY ***
Total pot 400 | Rake 22 
Board [7d Kc Tc Qd Js]
Seat 1: s70n3fac3 (big blind) showed [4d 4h] and won (378) with a pair of Fours
Seat 2: FDIBA2009 (button) (small blind) mucked [5c 2s]



PokerStars Home Game Hand #227143979969: {Club #4781089}  Hold'em No Limit (50/100) - 2021/05/29 0:40:53 EET [2021/05/28 17:40:53 ET]
Table 'VTPP NLHE 2805' 2-max (Play Money) Seat #1 is the button
Seat 1: s70n3fac3 (8867 in chips) 
Seat 2: FDIBA2009 (20086 in chips) 
s70n3fac3: posts small blind 50
FDIBA2009: posts big blind 100
*** HOLE CARDS ***
s70n3fac3: raises 100 to 200
FDIBA2009: raises 100 to 300
s70n3fac3: calls 100
*** FLOP *** [3h 4s Js]
FDIBA2009: bets 567
s70n3fac3: raises 833 to 1400
FDIBA2009: folds 
Uncalled bet (833) returned to s70n3fac3
s70n3fac3 collected 1639 from pot
s70n3fac3: doesn't show hand 
*** SUMMARY ***
Total pot 1734 | Rake 95 
Board [3h 4s Js]
Seat 1: s70n3fac3 (button) (small blind) collected (1639)
Seat 2: FDIBA2009 (big blind) folded on the Flop



PokerStars Home Game Hand #227143987870: {Club #4781089}  Hold'em No Limit (50/100) - 2021/05/29 0:41:08 EET [2021/05/28 17:41:08 ET]
Table 'VTPP NLHE 2805' 2-max (Play Money) Seat #2 is the button
Seat 1: s70n3fac3 (9639 in chips) 
Seat 2: FDIBA2009 (19219 in chips) 
FDIBA2009: posts small blind 50
s70n3fac3: posts big blind 100
*** HOLE CARDS ***
FDIBA2009: raises 100 to 200
s70n3fac3: calls 100
*** FLOP *** [Jc Qc 6d]
s70n3fac3: checks 
FDIBA2009: bets 378
s70n3fac3: raises 622 to 1000
FDIBA2009: calls 622
*** TURN *** [Jc Qc 6d] [6s]
s70n3fac3: checks 
FDIBA2009: bets 2268
s70n3fac3: raises 6171 to 8439 and is all-in
FDIBA2009 has timed out
FDIBA2009: folds 
Uncalled bet (6171) returned to s70n3fac3
s70n3fac3 collected 6555 from pot
s70n3fac3: doesn't show hand 
*** SUMMARY ***
Total pot 6936 | Rake 381 
Board [Jc Qc 6d 6s]
Seat 1: s70n3fac3 (big blind) collected (6555)
Seat 2: FDIBA2009 (button) (small blind) folded on the Turn



PokerStars Home Game Hand #227144011815: {Club #4781089}  Hold'em No Limit (50/100) - 2021/05/29 0:41:55 EET [2021/05/28 17:41:55 ET]
Table 'VTPP NLHE 2805' 2-max (Play Money) Seat #1 is the button
Seat 1: s70n3fac3 (12726 in chips) 
Seat 2: FDIBA2009 (15751 in chips) 
s70n3fac3: posts small blind 50
FDIBA2009: posts big blind 100
*** HOLE CARDS ***
s70n3fac3: calls 50
FDIBA2009: checks 
*** FLOP *** [6d 4c 9h]
FDIBA2009: checks 
s70n3fac3: bets 200
FDIBA2009: raises 589 to 789
s70n3fac3: calls 589
*** TURN *** [6d 4c 9h] [Jh]
FDIBA2009: bets 1450
s70n3fac3: calls 1450
*** RIVER *** [6d 4c 9h Jh] [As]
FDIBA2009: checks 
s70n3fac3: checks 
*** SHOW DOWN ***
FDIBA2009: shows [7h 5h] (high card Ace)
s70n3fac3: shows [7c 9c] (a pair of Nines)
s70n3fac3 collected 4421 from pot
*** SUMMARY ***
Total pot 4678 | Rake 257 
Board [6d 4c 9h Jh As]
Seat 1: s70n3fac3 (button) (small blind) showed [7c 9c] and won (4421) with a pair of Nines
Seat 2: FDIBA2009 (big blind) showed [7h 5h] and lost with high card Ace



PokerStars Home Game Hand #227144031337: {Club #4781089}  Hold'em No Limit (50/100) - 2021/05/29 0:42:33 EET [2021/05/28 17:42:33 ET]
Table 'VTPP NLHE 2805' 2-max (Play Money) Seat #2 is the button
Seat 1: s70n3fac3 (14808 in chips) 
Seat 2: FDIBA2009 (13412 in chips) 
FDIBA2009: posts small blind 50
s70n3fac3: posts big blind 100
*** HOLE CARDS ***
FDIBA2009: raises 200 to 300
s70n3fac3: calls 200
*** FLOP *** [Qh As 6h]
s70n3fac3: checks 
FDIBA2009: bets 300
s70n3fac3: folds 
Uncalled bet (300) returned to FDIBA2009
FDIBA2009 collected 567 from pot
FDIBA2009: doesn't show hand 
*** SUMMARY ***
Total pot 600 | Rake 33 
Board [Qh As 6h]
Seat 1: s70n3fac3 (big blind) folded on the Flop
Seat 2: FDIBA2009 (button) (small blind) collected (567)



PokerStars Home Game Hand #227144041192: {Club #4781089}  Hold'em No Limit (50/100) - 2021/05/29 0:42:52 EET [2021/05/28 17:42:52 ET]
Table 'VTPP NLHE 2805' 2-max (Play Money) Seat #1 is the button
Seat 1: s70n3fac3 (14508 in chips) 
Seat 2: FDIBA2009 (13679 in chips) 
s70n3fac3: posts small blind 50
FDIBA2009: posts big blind 100
*** HOLE CARDS ***
s70n3fac3: folds 
Uncalled bet (50) returned to FDIBA2009
FDIBA2009 collected 100 from pot
FDIBA2009: doesn't show hand 
*** SUMMARY ***
Total pot 100 | Rake 0 
Seat 1: s70n3fac3 (button) (small blind) folded before Flop
Seat 2: FDIBA2009 (big blind) collected (100)



PokerStars Home Game Hand #227144043020: {Club #4781089}  Hold'em No Limit (50/100) - 2021/05/29 0:42:56 EET [2021/05/28 17:42:56 ET]
Table 'VTPP NLHE 2805' 2-max (Play Money) Seat #2 is the button
Seat 1: s70n3fac3 (14458 in chips) 
Seat 2: FDIBA2009 (13729 in chips) 
FDIBA2009: posts small blind 50
s70n3fac3: posts big blind 100
*** HOLE CARDS ***
FDIBA2009: raises 100 to 200
s70n3fac3: raises 400 to 600
FDIBA2009: raises 1200 to 1800
s70n3fac3: raises 2500 to 4300
FDIBA2009: raises 9429 to 13729 and is all-in
s70n3fac3: calls 9429
*** FLOP *** [4h 2c Jh]
*** TURN *** [4h 2c Jh] [7s]
*** RIVER *** [4h 2c Jh 7s] [6d]
*** SHOW DOWN ***
s70n3fac3: shows [Ks Kd] (a pair of Kings)
FDIBA2009: shows [Th Td] (a pair of Tens)
s70n3fac3 collected 25948 from pot
*** SUMMARY ***
Total pot 27458 | Rake 1510 
Board [4h 2c Jh 7s 6d]
Seat 1: s70n3fac3 (big blind) showed [Ks Kd] and won (25948) with a pair of Kings
Seat 2: FDIBA2009 (button) (small blind) showed [Th Td] and lost with a pair of Tens



