PokerStars Home Game Hand #226757073204: {Club #4781089}  Hold'em No Limit (50/100) - 2021/05/14 23:39:15 EET [2021/05/14 16:39:15 ET]
Table 'VTTP NLHE' 2-max (Play Money) Seat #2 is the button
Seat 1: s70n3fac3 (10000 in chips) 
Seat 2: FDIBA2009 (10000 in chips) 
FDIBA2009: posts small blind 50
s70n3fac3: posts big blind 100
*** HOLE CARDS ***
FDIBA2009: raises 100 to 200
s70n3fac3: calls 100
*** FLOP *** [Th 4h 3h]
s70n3fac3: checks 
FDIBA2009: bets 200
s70n3fac3: calls 200
*** TURN *** [Th 4h 3h] [2h]
s70n3fac3: checks 
FDIBA2009: checks 
*** RIVER *** [Th 4h 3h 2h] [Js]
s70n3fac3: bets 450
FDIBA2009: folds 
Uncalled bet (450) returned to s70n3fac3
s70n3fac3 collected 756 from pot
s70n3fac3: doesn't show hand 
*** SUMMARY ***
Total pot 800 | Rake 44 
Board [Th 4h 3h 2h Js]
Seat 1: s70n3fac3 (big blind) collected (756)
Seat 2: FDIBA2009 (button) (small blind) folded on the River



PokerStars Home Game Hand #226757098142: {Club #4781089}  Hold'em No Limit (50/100) - 2021/05/14 23:39:56 EET [2021/05/14 16:39:56 ET]
Table 'VTTP NLHE' 2-max (Play Money) Seat #1 is the button
Seat 1: s70n3fac3 (10356 in chips) 
Seat 2: FDIBA2009 (9600 in chips) 
s70n3fac3: posts small blind 50
FDIBA2009: posts big blind 100
*** HOLE CARDS ***
s70n3fac3: raises 150 to 250
FDIBA2009: folds 
Uncalled bet (150) returned to s70n3fac3
s70n3fac3 collected 200 from pot
s70n3fac3: doesn't show hand 
*** SUMMARY ***
Total pot 200 | Rake 0 
Seat 1: s70n3fac3 (button) (small blind) collected (200)
Seat 2: FDIBA2009 (big blind) folded before Flop



PokerStars Home Game Hand #226757103530: {Club #4781089}  Hold'em No Limit (50/100) - 2021/05/14 23:40:05 EET [2021/05/14 16:40:05 ET]
Table 'VTTP NLHE' 2-max (Play Money) Seat #2 is the button
Seat 1: s70n3fac3 (10456 in chips) 
Seat 2: FDIBA2009 (9500 in chips) 
FDIBA2009: posts small blind 50
s70n3fac3: posts big blind 100
*** HOLE CARDS ***
FDIBA2009: raises 100 to 200
s70n3fac3: folds 
Uncalled bet (100) returned to FDIBA2009
FDIBA2009 collected 200 from pot
*** SUMMARY ***
Total pot 200 | Rake 0 
Seat 1: s70n3fac3 (big blind) folded before Flop
Seat 2: FDIBA2009 (button) (small blind) collected (200)



PokerStars Home Game Hand #226757112218: {Club #4781089}  Hold'em No Limit (50/100) - 2021/05/14 23:40:20 EET [2021/05/14 16:40:20 ET]
Table 'VTTP NLHE' 2-max (Play Money) Seat #1 is the button
Seat 1: s70n3fac3 (10356 in chips) 
Seat 2: FDIBA2009 (9600 in chips) 
s70n3fac3: posts small blind 50
FDIBA2009: posts big blind 100
*** HOLE CARDS ***
s70n3fac3: raises 100 to 200
FDIBA2009: calls 100
*** FLOP *** [Ts 7d Jh]
FDIBA2009: checks 
s70n3fac3: checks 
*** TURN *** [Ts 7d Jh] [7s]
FDIBA2009: checks 
s70n3fac3: bets 225
FDIBA2009: folds 
Uncalled bet (225) returned to s70n3fac3
s70n3fac3 collected 378 from pot
s70n3fac3: doesn't show hand 
*** SUMMARY ***
Total pot 400 | Rake 22 
Board [Ts 7d Jh 7s]
Seat 1: s70n3fac3 (button) (small blind) collected (378)
Seat 2: FDIBA2009 (big blind) folded on the Turn



PokerStars Home Game Hand #226757127679: {Club #4781089}  Hold'em No Limit (50/100) - 2021/05/14 23:40:46 EET [2021/05/14 16:40:46 ET]
Table 'VTTP NLHE' 2-max (Play Money) Seat #2 is the button
Seat 1: s70n3fac3 (10534 in chips) 
Seat 2: FDIBA2009 (9400 in chips) 
FDIBA2009: posts small blind 50
s70n3fac3: posts big blind 100
*** HOLE CARDS ***
FDIBA2009: raises 100 to 200
s70n3fac3: calls 100
*** FLOP *** [Td 6s Jd]
s70n3fac3: checks 
FDIBA2009: bets 300
s70n3fac3: folds 
Uncalled bet (300) returned to FDIBA2009
FDIBA2009 collected 378 from pot
*** SUMMARY ***
Total pot 400 | Rake 22 
Board [Td 6s Jd]
Seat 1: s70n3fac3 (big blind) folded on the Flop
Seat 2: FDIBA2009 (button) (small blind) collected (378)



PokerStars Home Game Hand #226757140322: {Club #4781089}  Hold'em No Limit (50/100) - 2021/05/14 23:41:07 EET [2021/05/14 16:41:07 ET]
Table 'VTTP NLHE' 2-max (Play Money) Seat #1 is the button
Seat 1: s70n3fac3 (10334 in chips) 
Seat 2: FDIBA2009 (9578 in chips) 
s70n3fac3: posts small blind 50
FDIBA2009: posts big blind 100
*** HOLE CARDS ***
s70n3fac3: raises 150 to 250
FDIBA2009: folds 
Uncalled bet (150) returned to s70n3fac3
s70n3fac3 collected 200 from pot
s70n3fac3: doesn't show hand 
*** SUMMARY ***
Total pot 200 | Rake 0 
Seat 1: s70n3fac3 (button) (small blind) collected (200)
Seat 2: FDIBA2009 (big blind) folded before Flop



PokerStars Home Game Hand #226757144397: {Club #4781089}  Hold'em No Limit (50/100) - 2021/05/14 23:41:14 EET [2021/05/14 16:41:14 ET]
Table 'VTTP NLHE' 2-max (Play Money) Seat #2 is the button
Seat 1: s70n3fac3 (10434 in chips) 
Seat 2: FDIBA2009 (9478 in chips) 
FDIBA2009: posts small blind 50
s70n3fac3: posts big blind 100
*** HOLE CARDS ***
FDIBA2009: raises 150 to 250
s70n3fac3: folds 
Uncalled bet (150) returned to FDIBA2009
FDIBA2009 collected 200 from pot
*** SUMMARY ***
Total pot 200 | Rake 0 
Seat 1: s70n3fac3 (big blind) folded before Flop
Seat 2: FDIBA2009 (button) (small blind) collected (200)



PokerStars Home Game Hand #226757151275: {Club #4781089}  Hold'em No Limit (50/100) - 2021/05/14 23:41:25 EET [2021/05/14 16:41:25 ET]
Table 'VTTP NLHE' 2-max (Play Money) Seat #1 is the button
Seat 1: s70n3fac3 (10334 in chips) 
Seat 2: FDIBA2009 (9578 in chips) 
s70n3fac3: posts small blind 50
FDIBA2009: posts big blind 100
*** HOLE CARDS ***
s70n3fac3: raises 150 to 250
FDIBA2009: raises 550 to 800
s70n3fac3: folds 
Uncalled bet (550) returned to FDIBA2009
FDIBA2009 collected 500 from pot
*** SUMMARY ***
Total pot 500 | Rake 0 
Seat 1: s70n3fac3 (button) (small blind) folded before Flop
Seat 2: FDIBA2009 (big blind) collected (500)



PokerStars Home Game Hand #226757165850: {Club #4781089}  Hold'em No Limit (50/100) - 2021/05/14 23:41:50 EET [2021/05/14 16:41:50 ET]
Table 'VTTP NLHE' 2-max (Play Money) Seat #2 is the button
Seat 1: s70n3fac3 (10084 in chips) 
Seat 2: FDIBA2009 (9828 in chips) 
FDIBA2009: posts small blind 50
s70n3fac3: posts big blind 100
*** HOLE CARDS ***
FDIBA2009: raises 150 to 250
s70n3fac3: raises 450 to 700
FDIBA2009: calls 450
*** FLOP *** [8h 9d 3s]
s70n3fac3: bets 750
FDIBA2009: folds 
Uncalled bet (750) returned to s70n3fac3
s70n3fac3 collected 1323 from pot
s70n3fac3: doesn't show hand 
*** SUMMARY ***
Total pot 1400 | Rake 77 
Board [8h 9d 3s]
Seat 1: s70n3fac3 (big blind) collected (1323)
Seat 2: FDIBA2009 (button) (small blind) folded on the Flop



PokerStars Home Game Hand #226757188646: {Club #4781089}  Hold'em No Limit (50/100) - 2021/05/14 23:42:28 EET [2021/05/14 16:42:28 ET]
Table 'VTTP NLHE' 2-max (Play Money) Seat #1 is the button
Seat 1: s70n3fac3 (10707 in chips) 
Seat 2: FDIBA2009 (9128 in chips) 
s70n3fac3: posts small blind 50
FDIBA2009: posts big blind 100
*** HOLE CARDS ***
s70n3fac3: raises 150 to 250
FDIBA2009: folds 
Uncalled bet (150) returned to s70n3fac3
s70n3fac3 collected 200 from pot
s70n3fac3: doesn't show hand 
*** SUMMARY ***
Total pot 200 | Rake 0 
Seat 1: s70n3fac3 (button) (small blind) collected (200)
Seat 2: FDIBA2009 (big blind) folded before Flop



PokerStars Home Game Hand #226757193868: {Club #4781089}  Hold'em No Limit (50/100) - 2021/05/14 23:42:37 EET [2021/05/14 16:42:37 ET]
Table 'VTTP NLHE' 2-max (Play Money) Seat #2 is the button
Seat 1: s70n3fac3 (10807 in chips) 
Seat 2: FDIBA2009 (9028 in chips) 
FDIBA2009: posts small blind 50
s70n3fac3: posts big blind 100
*** HOLE CARDS ***
FDIBA2009: raises 150 to 250
s70n3fac3: calls 150
*** FLOP *** [4s 6s 3s]
s70n3fac3: checks 
FDIBA2009: checks 
*** TURN *** [4s 6s 3s] [8h]
s70n3fac3: bets 250
FDIBA2009: calls 250
*** RIVER *** [4s 6s 3s 8h] [6c]
s70n3fac3: bets 450
FDIBA2009: calls 450
*** SHOW DOWN ***
s70n3fac3: shows [8d Js] (two pair, Eights and Sixes)
FDIBA2009: shows [8c Jh] (two pair, Eights and Sixes)
s70n3fac3 collected 898 from pot
FDIBA2009 collected 897 from pot
*** SUMMARY ***
Total pot 1900 | Rake 105 
Board [4s 6s 3s 8h 6c]
Seat 1: s70n3fac3 (big blind) showed [8d Js] and won (898) with two pair, Eights and Sixes
Seat 2: FDIBA2009 (button) (small blind) showed [8c Jh] and won (897) with two pair, Eights and Sixes



PokerStars Home Game Hand #226757223050: {Club #4781089}  Hold'em No Limit (50/100) - 2021/05/14 23:43:27 EET [2021/05/14 16:43:27 ET]
Table 'VTTP NLHE' 2-max (Play Money) Seat #1 is the button
Seat 1: s70n3fac3 (10755 in chips) 
Seat 2: FDIBA2009 (8975 in chips) 
s70n3fac3: posts small blind 50
FDIBA2009: posts big blind 100
*** HOLE CARDS ***
s70n3fac3: raises 100 to 200
FDIBA2009: calls 100
*** FLOP *** [2c 8c 6h]
FDIBA2009: checks 
s70n3fac3: bets 250
FDIBA2009: calls 250
*** TURN *** [2c 8c 6h] [7h]
FDIBA2009: checks 
s70n3fac3: bets 450
FDIBA2009: calls 450
*** RIVER *** [2c 8c 6h 7h] [As]
FDIBA2009: checks 
s70n3fac3: checks 
*** SHOW DOWN ***
FDIBA2009: shows [9h Tc] (a straight, Six to Ten)
s70n3fac3: mucks hand 
FDIBA2009 collected 1701 from pot
*** SUMMARY ***
Total pot 1800 | Rake 99 
Board [2c 8c 6h 7h As]
Seat 1: s70n3fac3 (button) (small blind) mucked [Kc 6c]
Seat 2: FDIBA2009 (big blind) showed [9h Tc] and won (1701) with a straight, Six to Ten



PokerStars Home Game Hand #226757252235: {Club #4781089}  Hold'em No Limit (50/100) - 2021/05/14 23:44:16 EET [2021/05/14 16:44:16 ET]
Table 'VTTP NLHE' 2-max (Play Money) Seat #2 is the button
Seat 1: s70n3fac3 (9855 in chips) 
Seat 2: FDIBA2009 (9776 in chips) 
FDIBA2009: posts small blind 50
s70n3fac3: posts big blind 100
*** HOLE CARDS ***
FDIBA2009: raises 100 to 200
s70n3fac3: folds 
Uncalled bet (100) returned to FDIBA2009
FDIBA2009 collected 200 from pot
*** SUMMARY ***
Total pot 200 | Rake 0 
Seat 1: s70n3fac3 (big blind) folded before Flop
Seat 2: FDIBA2009 (button) (small blind) collected (200)



PokerStars Home Game Hand #226757264323: {Club #4781089}  Hold'em No Limit (50/100) - 2021/05/14 23:44:37 EET [2021/05/14 16:44:37 ET]
Table 'VTTP NLHE' 2-max (Play Money) Seat #1 is the button
Seat 1: s70n3fac3 (9755 in chips) 
Seat 2: FDIBA2009 (9876 in chips) 
s70n3fac3: posts small blind 50
FDIBA2009: posts big blind 100
*** HOLE CARDS ***
s70n3fac3: raises 100 to 200
FDIBA2009: folds 
Uncalled bet (100) returned to s70n3fac3
s70n3fac3 collected 200 from pot
s70n3fac3: doesn't show hand 
*** SUMMARY ***
Total pot 200 | Rake 0 
Seat 1: s70n3fac3 (button) (small blind) collected (200)
Seat 2: FDIBA2009 (big blind) folded before Flop



PokerStars Home Game Hand #226757268692: {Club #4781089}  Hold'em No Limit (50/100) - 2021/05/14 23:44:44 EET [2021/05/14 16:44:44 ET]
Table 'VTTP NLHE' 2-max (Play Money) Seat #2 is the button
Seat 1: s70n3fac3 (9855 in chips) 
Seat 2: FDIBA2009 (9776 in chips) 
FDIBA2009: posts small blind 50
s70n3fac3: posts big blind 100
*** HOLE CARDS ***
FDIBA2009: raises 100 to 200
s70n3fac3: calls 100
*** FLOP *** [Ad 9d Jd]
s70n3fac3: checks 
FDIBA2009: bets 200
s70n3fac3: folds 
Uncalled bet (200) returned to FDIBA2009
FDIBA2009 collected 378 from pot
*** SUMMARY ***
Total pot 400 | Rake 22 
Board [Ad 9d Jd]
Seat 1: s70n3fac3 (big blind) folded on the Flop
Seat 2: FDIBA2009 (button) (small blind) collected (378)



PokerStars Home Game Hand #226757284772: {Club #4781089}  Hold'em No Limit (50/100) - 2021/05/14 23:45:11 EET [2021/05/14 16:45:11 ET]
Table 'VTTP NLHE' 2-max (Play Money) Seat #1 is the button
Seat 1: s70n3fac3 (9655 in chips) 
Seat 2: FDIBA2009 (9954 in chips) 
s70n3fac3: posts small blind 50
FDIBA2009: posts big blind 100
*** HOLE CARDS ***
s70n3fac3: raises 150 to 250
FDIBA2009: folds 
Uncalled bet (150) returned to s70n3fac3
s70n3fac3 collected 200 from pot
s70n3fac3: doesn't show hand 
*** SUMMARY ***
Total pot 200 | Rake 0 
Seat 1: s70n3fac3 (button) (small blind) collected (200)
Seat 2: FDIBA2009 (big blind) folded before Flop



PokerStars Home Game Hand #226757289209: {Club #4781089}  Hold'em No Limit (50/100) - 2021/05/14 23:45:18 EET [2021/05/14 16:45:18 ET]
Table 'VTTP NLHE' 2-max (Play Money) Seat #2 is the button
Seat 1: s70n3fac3 (9755 in chips) 
Seat 2: FDIBA2009 (9854 in chips) 
FDIBA2009: posts small blind 50
s70n3fac3: posts big blind 100
*** HOLE CARDS ***
FDIBA2009: raises 100 to 200
s70n3fac3: folds 
Uncalled bet (100) returned to FDIBA2009
FDIBA2009 collected 200 from pot
*** SUMMARY ***
Total pot 200 | Rake 0 
Seat 1: s70n3fac3 (big blind) folded before Flop
Seat 2: FDIBA2009 (button) (small blind) collected (200)



PokerStars Home Game Hand #226757293654: {Club #4781089}  Hold'em No Limit (50/100) - 2021/05/14 23:45:26 EET [2021/05/14 16:45:26 ET]
Table 'VTTP NLHE' 2-max (Play Money) Seat #1 is the button
Seat 1: s70n3fac3 (9655 in chips) 
Seat 2: FDIBA2009 (9954 in chips) 
s70n3fac3: posts small blind 50
FDIBA2009: posts big blind 100
*** HOLE CARDS ***
s70n3fac3: raises 100 to 200
FDIBA2009: calls 100
*** FLOP *** [Kd 5d Td]
FDIBA2009: checks 
s70n3fac3: bets 200
FDIBA2009: folds 
Uncalled bet (200) returned to s70n3fac3
s70n3fac3 collected 378 from pot
s70n3fac3: doesn't show hand 
*** SUMMARY ***
Total pot 400 | Rake 22 
Board [Kd 5d Td]
Seat 1: s70n3fac3 (button) (small blind) collected (378)
Seat 2: FDIBA2009 (big blind) folded on the Flop



PokerStars Home Game Hand #226757302783: {Club #4781089}  Hold'em No Limit (50/100) - 2021/05/14 23:45:41 EET [2021/05/14 16:45:41 ET]
Table 'VTTP NLHE' 2-max (Play Money) Seat #2 is the button
Seat 1: s70n3fac3 (9833 in chips) 
Seat 2: FDIBA2009 (9754 in chips) 
FDIBA2009: posts small blind 50
s70n3fac3: posts big blind 100
*** HOLE CARDS ***
FDIBA2009: raises 100 to 200
s70n3fac3: raises 500 to 700
FDIBA2009: calls 500
*** FLOP *** [5s 4d Jc]
s70n3fac3: checks 
FDIBA2009: bets 500
s70n3fac3: calls 500
*** TURN *** [5s 4d Jc] [9h]
s70n3fac3: checks 
FDIBA2009: bets 800
s70n3fac3: folds 
Uncalled bet (800) returned to FDIBA2009
FDIBA2009 collected 2268 from pot
*** SUMMARY ***
Total pot 2400 | Rake 132 
Board [5s 4d Jc 9h]
Seat 1: s70n3fac3 (big blind) folded on the Turn
Seat 2: FDIBA2009 (button) (small blind) collected (2268)



PokerStars Home Game Hand #226757338247: {Club #4781089}  Hold'em No Limit (50/100) - 2021/05/14 23:46:36 EET [2021/05/14 16:46:36 ET]
Table 'VTTP NLHE' 2-max (Play Money) Seat #1 is the button
Seat 1: s70n3fac3 (8633 in chips) 
Seat 2: FDIBA2009 (10822 in chips) 
s70n3fac3: posts small blind 50
FDIBA2009: posts big blind 100
*** HOLE CARDS ***
s70n3fac3: raises 100 to 200
FDIBA2009: calls 100
*** FLOP *** [5s Js 2h]
FDIBA2009: checks 
s70n3fac3: bets 200
FDIBA2009: calls 200
*** TURN *** [5s Js 2h] [4c]
FDIBA2009: checks 
s70n3fac3: checks 
*** RIVER *** [5s Js 2h 4c] [2d]
FDIBA2009: checks 
s70n3fac3: checks 
*** SHOW DOWN ***
FDIBA2009: shows [9s Ks] (a pair of Deuces)
s70n3fac3: mucks hand 
FDIBA2009 collected 756 from pot
*** SUMMARY ***
Total pot 800 | Rake 44 
Board [5s Js 2h 4c 2d]
Seat 1: s70n3fac3 (button) (small blind) mucked [Qh Tc]
Seat 2: FDIBA2009 (big blind) showed [9s Ks] and won (756) with a pair of Deuces



PokerStars Home Game Hand #226757358462: {Club #4781089}  Hold'em No Limit (50/100) - 2021/05/14 23:47:09 EET [2021/05/14 16:47:09 ET]
Table 'VTTP NLHE' 2-max (Play Money) Seat #2 is the button
Seat 1: s70n3fac3 (8233 in chips) 
Seat 2: FDIBA2009 (11178 in chips) 
FDIBA2009: posts small blind 50
s70n3fac3: posts big blind 100
*** HOLE CARDS ***
FDIBA2009: raises 100 to 200
s70n3fac3: folds 
Uncalled bet (100) returned to FDIBA2009
FDIBA2009 collected 200 from pot
*** SUMMARY ***
Total pot 200 | Rake 0 
Seat 1: s70n3fac3 (big blind) folded before Flop
Seat 2: FDIBA2009 (button) (small blind) collected (200)



PokerStars Home Game Hand #226757363009: {Club #4781089}  Hold'em No Limit (50/100) - 2021/05/14 23:47:16 EET [2021/05/14 16:47:16 ET]
Table 'VTTP NLHE' 2-max (Play Money) Seat #1 is the button
Seat 1: s70n3fac3 (8133 in chips) 
Seat 2: FDIBA2009 (11278 in chips) 
s70n3fac3: posts small blind 50
FDIBA2009: posts big blind 100
*** HOLE CARDS ***
s70n3fac3: folds 
Uncalled bet (50) returned to FDIBA2009
FDIBA2009 collected 100 from pot
*** SUMMARY ***
Total pot 100 | Rake 0 
Seat 1: s70n3fac3 (button) (small blind) folded before Flop
Seat 2: FDIBA2009 (big blind) collected (100)



PokerStars Home Game Hand #226757365339: {Club #4781089}  Hold'em No Limit (50/100) - 2021/05/14 23:47:20 EET [2021/05/14 16:47:20 ET]
Table 'VTTP NLHE' 2-max (Play Money) Seat #2 is the button
Seat 1: s70n3fac3 (8083 in chips) 
Seat 2: FDIBA2009 (11328 in chips) 
FDIBA2009: posts small blind 50
s70n3fac3: posts big blind 100
*** HOLE CARDS ***
FDIBA2009: raises 100 to 200
s70n3fac3: folds 
Uncalled bet (100) returned to FDIBA2009
FDIBA2009 collected 200 from pot
*** SUMMARY ***
Total pot 200 | Rake 0 
Seat 1: s70n3fac3 (big blind) folded before Flop
Seat 2: FDIBA2009 (button) (small blind) collected (200)



PokerStars Home Game Hand #226757370124: {Club #4781089}  Hold'em No Limit (50/100) - 2021/05/14 23:47:28 EET [2021/05/14 16:47:28 ET]
Table 'VTTP NLHE' 2-max (Play Money) Seat #1 is the button
Seat 1: s70n3fac3 (7983 in chips) 
Seat 2: FDIBA2009 (11428 in chips) 
s70n3fac3: posts small blind 50
FDIBA2009: posts big blind 100
*** HOLE CARDS ***
s70n3fac3: raises 150 to 250
FDIBA2009: calls 150
*** FLOP *** [9s 5c 2s]
FDIBA2009: checks 
s70n3fac3: bets 300
FDIBA2009: calls 300
*** TURN *** [9s 5c 2s] [Th]
FDIBA2009: checks 
s70n3fac3: bets 600
FDIBA2009: calls 600
*** RIVER *** [9s 5c 2s Th] [Js]
FDIBA2009: checks 
s70n3fac3: checks 
*** SHOW DOWN ***
FDIBA2009: shows [9d 7d] (a pair of Nines)
s70n3fac3: mucks hand 
FDIBA2009 collected 2173 from pot
*** SUMMARY ***
Total pot 2300 | Rake 127 
Board [9s 5c 2s Th Js]
Seat 1: s70n3fac3 (button) (small blind) mucked [9c 4c]
Seat 2: FDIBA2009 (big blind) showed [9d 7d] and won (2173) with a pair of Nines



PokerStars Home Game Hand #226757391730: {Club #4781089}  Hold'em No Limit (50/100) - 2021/05/14 23:48:03 EET [2021/05/14 16:48:03 ET]
Table 'VTTP NLHE' 2-max (Play Money) Seat #2 is the button
Seat 1: s70n3fac3 (6833 in chips) 
Seat 2: FDIBA2009 (12451 in chips) 
FDIBA2009: posts small blind 50
s70n3fac3: posts big blind 100
*** HOLE CARDS ***
FDIBA2009: raises 100 to 200
s70n3fac3: calls 100
*** FLOP *** [Th Qs 5s]
s70n3fac3: checks 
FDIBA2009: bets 200
s70n3fac3: folds 
Uncalled bet (200) returned to FDIBA2009
FDIBA2009 collected 378 from pot
*** SUMMARY ***
Total pot 400 | Rake 22 
Board [Th Qs 5s]
Seat 1: s70n3fac3 (big blind) folded on the Flop
Seat 2: FDIBA2009 (button) (small blind) collected (378)



PokerStars Home Game Hand #226757403274: {Club #4781089}  Hold'em No Limit (50/100) - 2021/05/14 23:48:23 EET [2021/05/14 16:48:23 ET]
Table 'VTTP NLHE' 2-max (Play Money) Seat #1 is the button
Seat 1: s70n3fac3 (6633 in chips) 
Seat 2: FDIBA2009 (12629 in chips) 
s70n3fac3: posts small blind 50
FDIBA2009: posts big blind 100
*** HOLE CARDS ***
s70n3fac3: raises 150 to 250
FDIBA2009: calls 150
*** FLOP *** [8h 8s 3c]
FDIBA2009: checks 
s70n3fac3: bets 250
FDIBA2009: folds 
Uncalled bet (250) returned to s70n3fac3
s70n3fac3 collected 472 from pot
s70n3fac3: doesn't show hand 
*** SUMMARY ***
Total pot 500 | Rake 28 
Board [8h 8s 3c]
Seat 1: s70n3fac3 (button) (small blind) collected (472)
Seat 2: FDIBA2009 (big blind) folded on the Flop



PokerStars Home Game Hand #226757415859: {Club #4781089}  Hold'em No Limit (50/100) - 2021/05/14 23:48:43 EET [2021/05/14 16:48:43 ET]
Table 'VTTP NLHE' 2-max (Play Money) Seat #2 is the button
Seat 1: s70n3fac3 (6855 in chips) 
Seat 2: FDIBA2009 (12379 in chips) 
FDIBA2009: posts small blind 50
s70n3fac3: posts big blind 100
*** HOLE CARDS ***
FDIBA2009: calls 50
s70n3fac3: raises 400 to 500
FDIBA2009: folds 
Uncalled bet (400) returned to s70n3fac3
s70n3fac3 collected 200 from pot
s70n3fac3: doesn't show hand 
*** SUMMARY ***
Total pot 200 | Rake 0 
Seat 1: s70n3fac3 (big blind) collected (200)
Seat 2: FDIBA2009 (button) (small blind) folded before Flop



PokerStars Home Game Hand #226757425050: {Club #4781089}  Hold'em No Limit (50/100) - 2021/05/14 23:48:59 EET [2021/05/14 16:48:59 ET]
Table 'VTTP NLHE' 2-max (Play Money) Seat #1 is the button
Seat 1: s70n3fac3 (6955 in chips) 
Seat 2: FDIBA2009 (12279 in chips) 
s70n3fac3: posts small blind 50
FDIBA2009: posts big blind 100
*** HOLE CARDS ***
s70n3fac3: raises 150 to 250
FDIBA2009: raises 650 to 900
s70n3fac3: calls 650
*** FLOP *** [3h 8c 2c]
FDIBA2009: checks 
s70n3fac3: bets 1450
FDIBA2009: folds 
Uncalled bet (1450) returned to s70n3fac3
s70n3fac3 collected 1701 from pot
s70n3fac3: doesn't show hand 
*** SUMMARY ***
Total pot 1800 | Rake 99 
Board [3h 8c 2c]
Seat 1: s70n3fac3 (button) (small blind) collected (1701)
Seat 2: FDIBA2009 (big blind) folded on the Flop



PokerStars Home Game Hand #226757452824: {Club #4781089}  Hold'em No Limit (50/100) - 2021/05/14 23:49:45 EET [2021/05/14 16:49:45 ET]
Table 'VTTP NLHE' 2-max (Play Money) Seat #2 is the button
Seat 1: s70n3fac3 (7756 in chips) 
Seat 2: FDIBA2009 (11379 in chips) 
FDIBA2009: posts small blind 50
s70n3fac3: posts big blind 100
*** HOLE CARDS ***
FDIBA2009: raises 100 to 200
s70n3fac3: folds 
Uncalled bet (100) returned to FDIBA2009
FDIBA2009 collected 200 from pot
*** SUMMARY ***
Total pot 200 | Rake 0 
Seat 1: s70n3fac3 (big blind) folded before Flop
Seat 2: FDIBA2009 (button) (small blind) collected (200)



PokerStars Home Game Hand #226757460099: {Club #4781089}  Hold'em No Limit (50/100) - 2021/05/14 23:49:53 EET [2021/05/14 16:49:53 ET]
Table 'VTTP NLHE' 2-max (Play Money) Seat #1 is the button
Seat 1: s70n3fac3 (7656 in chips) 
Seat 2: FDIBA2009 (11479 in chips) 
s70n3fac3: posts small blind 50
FDIBA2009: posts big blind 100
*** HOLE CARDS ***
s70n3fac3: raises 100 to 200
FDIBA2009: folds 
Uncalled bet (100) returned to s70n3fac3
s70n3fac3 collected 200 from pot
s70n3fac3: doesn't show hand 
*** SUMMARY ***
Total pot 200 | Rake 0 
Seat 1: s70n3fac3 (button) (small blind) collected (200)
Seat 2: FDIBA2009 (big blind) folded before Flop



PokerStars Home Game Hand #226757464091: {Club #4781089}  Hold'em No Limit (50/100) - 2021/05/14 23:50:00 EET [2021/05/14 16:50:00 ET]
Table 'VTTP NLHE' 2-max (Play Money) Seat #2 is the button
Seat 1: s70n3fac3 (7756 in chips) 
Seat 2: FDIBA2009 (11379 in chips) 
FDIBA2009: posts small blind 50
s70n3fac3: posts big blind 100
*** HOLE CARDS ***
FDIBA2009: raises 100 to 200
s70n3fac3: calls 100
*** FLOP *** [3s 5h 7s]
s70n3fac3: checks 
FDIBA2009: bets 300
s70n3fac3: folds 
Uncalled bet (300) returned to FDIBA2009
FDIBA2009 collected 378 from pot
*** SUMMARY ***
Total pot 400 | Rake 22 
Board [3s 5h 7s]
Seat 1: s70n3fac3 (big blind) folded on the Flop
Seat 2: FDIBA2009 (button) (small blind) collected (378)



PokerStars Home Game Hand #226757477184: {Club #4781089}  Hold'em No Limit (50/100) - 2021/05/14 23:50:22 EET [2021/05/14 16:50:22 ET]
Table 'VTTP NLHE' 2-max (Play Money) Seat #1 is the button
Seat 1: s70n3fac3 (7556 in chips) 
Seat 2: FDIBA2009 (11557 in chips) 
s70n3fac3: posts small blind 50
FDIBA2009: posts big blind 100
*** HOLE CARDS ***
s70n3fac3: calls 50
FDIBA2009: raises 400 to 500
s70n3fac3: folds 
Uncalled bet (400) returned to FDIBA2009
FDIBA2009 collected 200 from pot
*** SUMMARY ***
Total pot 200 | Rake 0 
Seat 1: s70n3fac3 (button) (small blind) folded before Flop
Seat 2: FDIBA2009 (big blind) collected (200)



PokerStars Home Game Hand #226757483752: {Club #4781089}  Hold'em No Limit (50/100) - 2021/05/14 23:50:33 EET [2021/05/14 16:50:33 ET]
Table 'VTTP NLHE' 2-max (Play Money) Seat #2 is the button
Seat 1: s70n3fac3 (7456 in chips) 
Seat 2: FDIBA2009 (11657 in chips) 
FDIBA2009: posts small blind 50
s70n3fac3: posts big blind 100
*** HOLE CARDS ***
FDIBA2009: raises 100 to 200
s70n3fac3: calls 100
*** FLOP *** [Qh 5s Jd]
s70n3fac3: checks 
FDIBA2009: bets 300
s70n3fac3: calls 300
*** TURN *** [Qh 5s Jd] [4c]
s70n3fac3: checks 
FDIBA2009: checks 
*** RIVER *** [Qh 5s Jd 4c] [Th]
s70n3fac3: checks 
FDIBA2009: checks 
*** SHOW DOWN ***
s70n3fac3: shows [6h 6s] (a pair of Sixes)
FDIBA2009: mucks hand 
s70n3fac3 collected 945 from pot
*** SUMMARY ***
Total pot 1000 | Rake 55 
Board [Qh 5s Jd 4c Th]
Seat 1: s70n3fac3 (big blind) showed [6h 6s] and won (945) with a pair of Sixes
Seat 2: FDIBA2009 (button) (small blind) mucked [Ad 7h]



PokerStars Home Game Hand #226757506117: {Club #4781089}  Hold'em No Limit (50/100) - 2021/05/14 23:51:11 EET [2021/05/14 16:51:11 ET]
Table 'VTTP NLHE' 2-max (Play Money) Seat #1 is the button
Seat 1: s70n3fac3 (7901 in chips) 
Seat 2: FDIBA2009 (11157 in chips) 
s70n3fac3: posts small blind 50
FDIBA2009: posts big blind 100
*** HOLE CARDS ***
s70n3fac3: raises 100 to 200
FDIBA2009: calls 100
*** FLOP *** [Ad 5c 6s]
FDIBA2009: checks 
s70n3fac3: bets 250
FDIBA2009: folds 
Uncalled bet (250) returned to s70n3fac3
s70n3fac3 collected 378 from pot
s70n3fac3: doesn't show hand 
*** SUMMARY ***
Total pot 400 | Rake 22 
Board [Ad 5c 6s]
Seat 1: s70n3fac3 (button) (small blind) collected (378)
Seat 2: FDIBA2009 (big blind) folded on the Flop



PokerStars Home Game Hand #226757515164: {Club #4781089}  Hold'em No Limit (50/100) - 2021/05/14 23:51:26 EET [2021/05/14 16:51:26 ET]
Table 'VTTP NLHE' 2-max (Play Money) Seat #2 is the button
Seat 1: s70n3fac3 (8079 in chips) 
Seat 2: FDIBA2009 (10957 in chips) 
FDIBA2009: posts small blind 50
s70n3fac3: posts big blind 100
*** HOLE CARDS ***
FDIBA2009: raises 100 to 200
s70n3fac3: calls 100
*** FLOP *** [2s 9d 3h]
s70n3fac3: checks 
FDIBA2009: bets 300
s70n3fac3: raises 450 to 750
FDIBA2009: folds 
Uncalled bet (450) returned to s70n3fac3
s70n3fac3 collected 945 from pot
s70n3fac3: doesn't show hand 
*** SUMMARY ***
Total pot 1000 | Rake 55 
Board [2s 9d 3h]
Seat 1: s70n3fac3 (big blind) collected (945)
Seat 2: FDIBA2009 (button) (small blind) folded on the Flop



PokerStars Home Game Hand #226757535230: {Club #4781089}  Hold'em No Limit (50/100) - 2021/05/14 23:52:00 EET [2021/05/14 16:52:00 ET]
Table 'VTTP NLHE' 2-max (Play Money) Seat #1 is the button
Seat 1: s70n3fac3 (8524 in chips) 
Seat 2: FDIBA2009 (10457 in chips) 
s70n3fac3: posts small blind 50
FDIBA2009: posts big blind 100
*** HOLE CARDS ***
s70n3fac3: calls 50
FDIBA2009: raises 300 to 400
s70n3fac3: folds 
Uncalled bet (300) returned to FDIBA2009
FDIBA2009 collected 200 from pot
*** SUMMARY ***
Total pot 200 | Rake 0 
Seat 1: s70n3fac3 (button) (small blind) folded before Flop
Seat 2: FDIBA2009 (big blind) collected (200)



PokerStars Home Game Hand #226757543071: {Club #4781089}  Hold'em No Limit (50/100) - 2021/05/14 23:52:13 EET [2021/05/14 16:52:13 ET]
Table 'VTTP NLHE' 2-max (Play Money) Seat #2 is the button
Seat 1: s70n3fac3 (8424 in chips) 
Seat 2: FDIBA2009 (10557 in chips) 
FDIBA2009: posts small blind 50
s70n3fac3: posts big blind 100
*** HOLE CARDS ***
FDIBA2009: raises 100 to 200
s70n3fac3: raises 500 to 700
FDIBA2009: calls 500
*** FLOP *** [2d 3s 4h]
s70n3fac3: bets 800
FDIBA2009: calls 800
*** TURN *** [2d 3s 4h] [3h]
s70n3fac3: bets 1500
FDIBA2009: calls 1500
*** RIVER *** [2d 3s 4h 3h] [2c]
s70n3fac3: bets 2850
FDIBA2009: folds 
Uncalled bet (2850) returned to s70n3fac3
s70n3fac3 collected 5670 from pot
s70n3fac3: doesn't show hand 
*** SUMMARY ***
Total pot 6000 | Rake 330 
Board [2d 3s 4h 3h 2c]
Seat 1: s70n3fac3 (big blind) collected (5670)
Seat 2: FDIBA2009 (button) (small blind) folded on the River



PokerStars Home Game Hand #226757581878: {Club #4781089}  Hold'em No Limit (50/100) - 2021/05/14 23:53:16 EET [2021/05/14 16:53:16 ET]
Table 'VTTP NLHE' 2-max (Play Money) Seat #1 is the button
Seat 1: s70n3fac3 (11094 in chips) 
Seat 2: FDIBA2009 (7557 in chips) 
s70n3fac3: posts small blind 50
FDIBA2009: posts big blind 100
*** HOLE CARDS ***
s70n3fac3: raises 150 to 250
FDIBA2009: folds 
Uncalled bet (150) returned to s70n3fac3
s70n3fac3 collected 200 from pot
s70n3fac3: doesn't show hand 
*** SUMMARY ***
Total pot 200 | Rake 0 
Seat 1: s70n3fac3 (button) (small blind) collected (200)
Seat 2: FDIBA2009 (big blind) folded before Flop



PokerStars Home Game Hand #226757586298: {Club #4781089}  Hold'em No Limit (50/100) - 2021/05/14 23:53:24 EET [2021/05/14 16:53:24 ET]
Table 'VTTP NLHE' 2-max (Play Money) Seat #2 is the button
Seat 1: s70n3fac3 (11194 in chips) 
Seat 2: FDIBA2009 (7457 in chips) 
FDIBA2009: posts small blind 50
s70n3fac3: posts big blind 100
*** HOLE CARDS ***
FDIBA2009: raises 100 to 200
s70n3fac3: folds 
Uncalled bet (100) returned to FDIBA2009
FDIBA2009 collected 200 from pot
*** SUMMARY ***
Total pot 200 | Rake 0 
Seat 1: s70n3fac3 (big blind) folded before Flop
Seat 2: FDIBA2009 (button) (small blind) collected (200)



PokerStars Home Game Hand #226757589962: {Club #4781089}  Hold'em No Limit (50/100) - 2021/05/14 23:53:30 EET [2021/05/14 16:53:30 ET]
Table 'VTTP NLHE' 2-max (Play Money) Seat #1 is the button
Seat 1: s70n3fac3 (11094 in chips) 
Seat 2: FDIBA2009 (7557 in chips) 
s70n3fac3: posts small blind 50
FDIBA2009: posts big blind 100
*** HOLE CARDS ***
s70n3fac3: raises 100 to 200
FDIBA2009: folds 
Uncalled bet (100) returned to s70n3fac3
s70n3fac3 collected 200 from pot
s70n3fac3: doesn't show hand 
*** SUMMARY ***
Total pot 200 | Rake 0 
Seat 1: s70n3fac3 (button) (small blind) collected (200)
Seat 2: FDIBA2009 (big blind) folded before Flop



PokerStars Home Game Hand #226757594145: {Club #4781089}  Hold'em No Limit (50/100) - 2021/05/14 23:53:37 EET [2021/05/14 16:53:37 ET]
Table 'VTTP NLHE' 2-max (Play Money) Seat #2 is the button
Seat 1: s70n3fac3 (11194 in chips) 
Seat 2: FDIBA2009 (7457 in chips) 
FDIBA2009: posts small blind 50
s70n3fac3: posts big blind 100
*** HOLE CARDS ***
FDIBA2009: raises 100 to 200
s70n3fac3: folds 
Uncalled bet (100) returned to FDIBA2009
FDIBA2009 collected 200 from pot
*** SUMMARY ***
Total pot 200 | Rake 0 
Seat 1: s70n3fac3 (big blind) folded before Flop
Seat 2: FDIBA2009 (button) (small blind) collected (200)



PokerStars Home Game Hand #226757600161: {Club #4781089}  Hold'em No Limit (50/100) - 2021/05/14 23:53:47 EET [2021/05/14 16:53:47 ET]
Table 'VTTP NLHE' 2-max (Play Money) Seat #1 is the button
Seat 1: s70n3fac3 (11094 in chips) 
Seat 2: FDIBA2009 (7557 in chips) 
s70n3fac3: posts small blind 50
FDIBA2009: posts big blind 100
*** HOLE CARDS ***
s70n3fac3: folds 
Uncalled bet (50) returned to FDIBA2009
FDIBA2009 collected 100 from pot
*** SUMMARY ***
Total pot 100 | Rake 0 
Seat 1: s70n3fac3 (button) (small blind) folded before Flop
Seat 2: FDIBA2009 (big blind) collected (100)



PokerStars Home Game Hand #226757603070: {Club #4781089}  Hold'em No Limit (50/100) - 2021/05/14 23:53:52 EET [2021/05/14 16:53:52 ET]
Table 'VTTP NLHE' 2-max (Play Money) Seat #2 is the button
Seat 1: s70n3fac3 (11044 in chips) 
Seat 2: FDIBA2009 (7607 in chips) 
FDIBA2009: posts small blind 50
s70n3fac3: posts big blind 100
*** HOLE CARDS ***
FDIBA2009: raises 100 to 200
s70n3fac3: folds 
Uncalled bet (100) returned to FDIBA2009
FDIBA2009 collected 200 from pot
*** SUMMARY ***
Total pot 200 | Rake 0 
Seat 1: s70n3fac3 (big blind) folded before Flop
Seat 2: FDIBA2009 (button) (small blind) collected (200)



PokerStars Home Game Hand #226757606909: {Club #4781089}  Hold'em No Limit (50/100) - 2021/05/14 23:53:59 EET [2021/05/14 16:53:59 ET]
Table 'VTTP NLHE' 2-max (Play Money) Seat #1 is the button
Seat 1: s70n3fac3 (10944 in chips) 
Seat 2: FDIBA2009 (7707 in chips) 
s70n3fac3: posts small blind 50
FDIBA2009: posts big blind 100
*** HOLE CARDS ***
s70n3fac3: raises 100 to 200
FDIBA2009: calls 100
*** FLOP *** [Ac Jc Ts]
FDIBA2009: checks 
s70n3fac3: bets 200
FDIBA2009: folds 
Uncalled bet (200) returned to s70n3fac3
s70n3fac3 collected 378 from pot
s70n3fac3: doesn't show hand 
*** SUMMARY ***
Total pot 400 | Rake 22 
Board [Ac Jc Ts]
Seat 1: s70n3fac3 (button) (small blind) collected (378)
Seat 2: FDIBA2009 (big blind) folded on the Flop



PokerStars Home Game Hand #226757615435: {Club #4781089}  Hold'em No Limit (50/100) - 2021/05/14 23:54:13 EET [2021/05/14 16:54:13 ET]
Table 'VTTP NLHE' 2-max (Play Money) Seat #2 is the button
Seat 1: s70n3fac3 (11122 in chips) 
Seat 2: FDIBA2009 (7507 in chips) 
FDIBA2009: posts small blind 50
s70n3fac3: posts big blind 100
*** HOLE CARDS ***
FDIBA2009: raises 100 to 200
s70n3fac3: calls 100
*** FLOP *** [Kd 5c As]
s70n3fac3: checks 
FDIBA2009: bets 300
s70n3fac3: calls 300
*** TURN *** [Kd 5c As] [3d]
s70n3fac3: checks 
FDIBA2009: bets 945
s70n3fac3: raises 945 to 1890
FDIBA2009: folds 
Uncalled bet (945) returned to s70n3fac3
s70n3fac3 collected 2731 from pot
s70n3fac3: doesn't show hand 
*** SUMMARY ***
Total pot 2890 | Rake 159 
Board [Kd 5c As 3d]
Seat 1: s70n3fac3 (big blind) collected (2731)
Seat 2: FDIBA2009 (button) (small blind) folded on the Turn



PokerStars Home Game Hand #226757640648: {Club #4781089}  Hold'em No Limit (50/100) - 2021/05/14 23:54:56 EET [2021/05/14 16:54:56 ET]
Table 'VTTP NLHE' 2-max (Play Money) Seat #1 is the button
Seat 1: s70n3fac3 (12408 in chips) 
Seat 2: FDIBA2009 (6062 in chips) 
s70n3fac3: posts small blind 50
FDIBA2009: posts big blind 100
*** HOLE CARDS ***
s70n3fac3: raises 150 to 250
FDIBA2009: calls 150
*** FLOP *** [Js 8d 3s]
FDIBA2009: checks 
s70n3fac3: bets 250
FDIBA2009: calls 250
*** TURN *** [Js 8d 3s] [Kd]
FDIBA2009: checks 
s70n3fac3: bets 550
FDIBA2009: calls 550
*** RIVER *** [Js 8d 3s Kd] [Ac]
FDIBA2009: checks 
s70n3fac3: bets 900
FDIBA2009: raises 2400 to 3300
s70n3fac3: folds 
Uncalled bet (2400) returned to FDIBA2009
FDIBA2009 collected 3685 from pot
*** SUMMARY ***
Total pot 3900 | Rake 215 
Board [Js 8d 3s Kd Ac]
Seat 1: s70n3fac3 (button) (small blind) folded on the River
Seat 2: FDIBA2009 (big blind) collected (3685)



PokerStars Home Game Hand #226757674989: {Club #4781089}  Hold'em No Limit (50/100) - 2021/05/14 23:56:04 EET [2021/05/14 16:56:04 ET]
Table 'VTTP NLHE' 2-max (Play Money) Seat #2 is the button
Seat 1: s70n3fac3 (10458 in chips) 
Seat 2: FDIBA2009 (7797 in chips) 
FDIBA2009: posts small blind 50
s70n3fac3: posts big blind 100
*** HOLE CARDS ***
FDIBA2009: raises 100 to 200
s70n3fac3: calls 100
*** FLOP *** [As 9h 6c]
s70n3fac3: checks 
FDIBA2009: bets 200
s70n3fac3: folds 
Uncalled bet (200) returned to FDIBA2009
FDIBA2009 collected 378 from pot
*** SUMMARY ***
Total pot 400 | Rake 22 
Board [As 9h 6c]
Seat 1: s70n3fac3 (big blind) folded on the Flop
Seat 2: FDIBA2009 (button) (small blind) collected (378)



PokerStars Home Game Hand #226757682044: {Club #4781089}  Hold'em No Limit (50/100) - 2021/05/14 23:56:21 EET [2021/05/14 16:56:21 ET]
Table 'VTTP NLHE' 2-max (Play Money) Seat #1 is the button
Seat 1: s70n3fac3 (10258 in chips) 
Seat 2: FDIBA2009 (7975 in chips) 
s70n3fac3: posts small blind 50
FDIBA2009: posts big blind 100
*** HOLE CARDS ***
s70n3fac3: raises 100 to 200
FDIBA2009: calls 100
*** FLOP *** [3d Ad 5h]
FDIBA2009: checks 
s70n3fac3: bets 200
FDIBA2009: folds 
Uncalled bet (200) returned to s70n3fac3
s70n3fac3 collected 378 from pot
s70n3fac3: doesn't show hand 
*** SUMMARY ***
Total pot 400 | Rake 22 
Board [3d Ad 5h]
Seat 1: s70n3fac3 (button) (small blind) collected (378)
Seat 2: FDIBA2009 (big blind) folded on the Flop



PokerStars Home Game Hand #226757693063: {Club #4781089}  Hold'em No Limit (50/100) - 2021/05/14 23:56:47 EET [2021/05/14 16:56:47 ET]
Table 'VTTP NLHE' 2-max (Play Money) Seat #2 is the button
Seat 1: s70n3fac3 (10436 in chips) 
Seat 2: FDIBA2009 (7775 in chips) 
FDIBA2009: posts small blind 50
s70n3fac3: posts big blind 100
*** HOLE CARDS ***
FDIBA2009: raises 100 to 200
s70n3fac3: calls 100
*** FLOP *** [3c Kc Jh]
s70n3fac3: checks 
FDIBA2009: bets 189
s70n3fac3: calls 189
*** TURN *** [3c Kc Jh] [8s]
s70n3fac3: checks 
FDIBA2009: bets 500
s70n3fac3: calls 500
*** RIVER *** [3c Kc Jh 8s] [Ks]
s70n3fac3: checks 
FDIBA2009: bets 1450
s70n3fac3: calls 1450
*** SHOW DOWN ***
FDIBA2009: shows [6d Kh] (three of a kind, Kings)
s70n3fac3: mucks hand 
FDIBA2009 collected 4421 from pot
*** SUMMARY ***
Total pot 4678 | Rake 257 
Board [3c Kc Jh 8s Ks]
Seat 1: s70n3fac3 (big blind) mucked [Jd 8c]
Seat 2: FDIBA2009 (button) (small blind) showed [6d Kh] and won (4421) with three of a kind, Kings



PokerStars Home Game Hand #226757723478: {Club #4781089}  Hold'em No Limit (50/100) - 2021/05/14 23:58:01 EET [2021/05/14 16:58:01 ET]
Table 'VTTP NLHE' 2-max (Play Money) Seat #1 is the button
Seat 1: s70n3fac3 (8097 in chips) 
Seat 2: FDIBA2009 (9857 in chips) 
s70n3fac3: posts small blind 50
FDIBA2009: posts big blind 100
*** HOLE CARDS ***
s70n3fac3: raises 150 to 250
FDIBA2009: folds 
Uncalled bet (150) returned to s70n3fac3
s70n3fac3 collected 200 from pot
s70n3fac3: doesn't show hand 
*** SUMMARY ***
Total pot 200 | Rake 0 
Seat 1: s70n3fac3 (button) (small blind) collected (200)
Seat 2: FDIBA2009 (big blind) folded before Flop



PokerStars Home Game Hand #226757728405: {Club #4781089}  Hold'em No Limit (50/100) - 2021/05/14 23:58:13 EET [2021/05/14 16:58:13 ET]
Table 'VTTP NLHE' 2-max (Play Money) Seat #2 is the button
Seat 1: s70n3fac3 (8197 in chips) 
Seat 2: FDIBA2009 (9757 in chips) 
FDIBA2009: posts small blind 50
s70n3fac3: posts big blind 100
*** HOLE CARDS ***
FDIBA2009: raises 100 to 200
s70n3fac3: folds 
Uncalled bet (100) returned to FDIBA2009
FDIBA2009 collected 200 from pot
*** SUMMARY ***
Total pot 200 | Rake 0 
Seat 1: s70n3fac3 (big blind) folded before Flop
Seat 2: FDIBA2009 (button) (small blind) collected (200)



PokerStars Home Game Hand #226757731219: {Club #4781089}  Hold'em No Limit (50/100) - 2021/05/14 23:58:20 EET [2021/05/14 16:58:20 ET]
Table 'VTTP NLHE' 2-max (Play Money) Seat #1 is the button
Seat 1: s70n3fac3 (8097 in chips) 
Seat 2: FDIBA2009 (9857 in chips) 
s70n3fac3: posts small blind 50
FDIBA2009: posts big blind 100
*** HOLE CARDS ***
s70n3fac3: raises 150 to 250
FDIBA2009: raises 750 to 1000
s70n3fac3: calls 750
*** FLOP *** [Kh 2d 9d]
FDIBA2009: bets 2000
s70n3fac3: folds 
Uncalled bet (2000) returned to FDIBA2009
FDIBA2009 collected 1890 from pot
*** SUMMARY ***
Total pot 2000 | Rake 110 
Board [Kh 2d 9d]
Seat 1: s70n3fac3 (button) (small blind) folded on the Flop
Seat 2: FDIBA2009 (big blind) collected (1890)



PokerStars Home Game Hand #226757746790: {Club #4781089}  Hold'em No Limit (50/100) - 2021/05/14 23:58:59 EET [2021/05/14 16:58:59 ET]
Table 'VTTP NLHE' 2-max (Play Money) Seat #2 is the button
Seat 1: s70n3fac3 (7097 in chips) 
Seat 2: FDIBA2009 (10747 in chips) 
FDIBA2009: posts small blind 50
s70n3fac3: posts big blind 100
*** HOLE CARDS ***
FDIBA2009: raises 100 to 200
s70n3fac3: calls 100
*** FLOP *** [Tc 2s As]
s70n3fac3: checks 
FDIBA2009: bets 250
s70n3fac3: folds 
Uncalled bet (250) returned to FDIBA2009
FDIBA2009 collected 378 from pot
*** SUMMARY ***
Total pot 400 | Rake 22 
Board [Tc 2s As]
Seat 1: s70n3fac3 (big blind) folded on the Flop
Seat 2: FDIBA2009 (button) (small blind) collected (378)



PokerStars Home Game Hand #226757756688: {Club #4781089}  Hold'em No Limit (50/100) - 2021/05/14 23:59:18 EET [2021/05/14 16:59:18 ET]
Table 'VTTP NLHE' 2-max (Play Money) Seat #1 is the button
Seat 1: s70n3fac3 (6897 in chips) 
Seat 2: FDIBA2009 (10925 in chips) 
s70n3fac3: posts small blind 50
FDIBA2009: posts big blind 100
*** HOLE CARDS ***
s70n3fac3: raises 100 to 200
FDIBA2009: calls 100
*** FLOP *** [6d Ts 9c]
FDIBA2009: checks 
s70n3fac3: bets 250
FDIBA2009: calls 250
*** TURN *** [6d Ts 9c] [Ac]
FDIBA2009: checks 
s70n3fac3: bets 450
FDIBA2009: raises 550 to 1000
s70n3fac3: calls 550
*** RIVER *** [6d Ts 9c Ac] [Qd]
FDIBA2009: bets 2500
s70n3fac3: folds 
Uncalled bet (2500) returned to FDIBA2009
FDIBA2009 collected 2740 from pot
*** SUMMARY ***
Total pot 2900 | Rake 160 
Board [6d Ts 9c Ac Qd]
Seat 1: s70n3fac3 (button) (small blind) folded on the River
Seat 2: FDIBA2009 (big blind) collected (2740)



PokerStars Home Game Hand #226757791692: {Club #4781089}  Hold'em No Limit (50/100) - 2021/05/15 0:00:22 EET [2021/05/14 17:00:22 ET]
Table 'VTTP NLHE' 2-max (Play Money) Seat #2 is the button
Seat 1: s70n3fac3 (5447 in chips) 
Seat 2: FDIBA2009 (12215 in chips) 
FDIBA2009: posts small blind 50
s70n3fac3: posts big blind 100
*** HOLE CARDS ***
FDIBA2009: raises 100 to 200
s70n3fac3: folds 
Uncalled bet (100) returned to FDIBA2009
FDIBA2009 collected 200 from pot
*** SUMMARY ***
Total pot 200 | Rake 0 
Seat 1: s70n3fac3 (big blind) folded before Flop
Seat 2: FDIBA2009 (button) (small blind) collected (200)



PokerStars Home Game Hand #226757794849: {Club #4781089}  Hold'em No Limit (50/100) - 2021/05/15 0:00:33 EET [2021/05/14 17:00:33 ET]
Table 'VTTP NLHE' 2-max (Play Money) Seat #1 is the button
Seat 1: s70n3fac3 (5347 in chips) 
Seat 2: FDIBA2009 (12315 in chips) 
s70n3fac3: posts small blind 50
FDIBA2009: posts big blind 100
*** HOLE CARDS ***
s70n3fac3: raises 100 to 200
FDIBA2009: calls 100
*** FLOP *** [Qd 5c 6d]
FDIBA2009: checks 
s70n3fac3: bets 200
FDIBA2009: calls 200
*** TURN *** [Qd 5c 6d] [Jd]
FDIBA2009: checks 
s70n3fac3: checks 
*** RIVER *** [Qd 5c 6d Jd] [6h]
FDIBA2009: checks 
s70n3fac3: checks 
*** SHOW DOWN ***
FDIBA2009: shows [Ad 3c] (a pair of Sixes)
s70n3fac3: mucks hand 
FDIBA2009 collected 756 from pot
*** SUMMARY ***
Total pot 800 | Rake 44 
Board [Qd 5c 6d Jd 6h]
Seat 1: s70n3fac3 (button) (small blind) mucked [Ks 8s]
Seat 2: FDIBA2009 (big blind) showed [Ad 3c] and won (756) with a pair of Sixes



PokerStars Home Game Hand #226757806077: {Club #4781089}  Hold'em No Limit (50/100) - 2021/05/15 0:01:03 EET [2021/05/14 17:01:03 ET]
Table 'VTTP NLHE' 2-max (Play Money) Seat #2 is the button
Seat 1: s70n3fac3 (4947 in chips) 
Seat 2: FDIBA2009 (12671 in chips) 
FDIBA2009: posts small blind 50
s70n3fac3: posts big blind 100
*** HOLE CARDS ***
FDIBA2009: raises 100 to 200
s70n3fac3: calls 100
*** FLOP *** [Th 2h Kd]
s70n3fac3: checks 
FDIBA2009: checks 
*** TURN *** [Th 2h Kd] [Kc]
s70n3fac3: bets 200
FDIBA2009: folds 
Uncalled bet (200) returned to s70n3fac3
s70n3fac3 collected 378 from pot
s70n3fac3: doesn't show hand 
*** SUMMARY ***
Total pot 400 | Rake 22 
Board [Th 2h Kd Kc]
Seat 1: s70n3fac3 (big blind) collected (378)
Seat 2: FDIBA2009 (button) (small blind) folded on the Turn



PokerStars Home Game Hand #226757814763: {Club #4781089}  Hold'em No Limit (50/100) - 2021/05/15 0:01:20 EET [2021/05/14 17:01:20 ET]
Table 'VTTP NLHE' 2-max (Play Money) Seat #1 is the button
Seat 1: s70n3fac3 (5125 in chips) 
Seat 2: FDIBA2009 (12471 in chips) 
s70n3fac3: posts small blind 50
FDIBA2009: posts big blind 100
*** HOLE CARDS ***
s70n3fac3: raises 100 to 200
FDIBA2009: folds 
Uncalled bet (100) returned to s70n3fac3
s70n3fac3 collected 200 from pot
s70n3fac3: doesn't show hand 
*** SUMMARY ***
Total pot 200 | Rake 0 
Seat 1: s70n3fac3 (button) (small blind) collected (200)
Seat 2: FDIBA2009 (big blind) folded before Flop



PokerStars Home Game Hand #226757818985: {Club #4781089}  Hold'em No Limit (50/100) - 2021/05/15 0:01:31 EET [2021/05/14 17:01:31 ET]
Table 'VTTP NLHE' 2-max (Play Money) Seat #2 is the button
Seat 1: s70n3fac3 (5225 in chips) 
Seat 2: FDIBA2009 (12371 in chips) 
FDIBA2009: posts small blind 50
s70n3fac3: posts big blind 100
*** HOLE CARDS ***
FDIBA2009: raises 100 to 200
s70n3fac3: calls 100
*** FLOP *** [7c 2s Kh]
s70n3fac3: checks 
FDIBA2009: checks 
*** TURN *** [7c 2s Kh] [3s]
s70n3fac3: checks 
FDIBA2009: checks 
*** RIVER *** [7c 2s Kh 3s] [Ks]
s70n3fac3: checks 
FDIBA2009: bets 600
s70n3fac3: folds 
Uncalled bet (600) returned to FDIBA2009
FDIBA2009 collected 378 from pot
*** SUMMARY ***
Total pot 400 | Rake 22 
Board [7c 2s Kh 3s Ks]
Seat 1: s70n3fac3 (big blind) folded on the River
Seat 2: FDIBA2009 (button) (small blind) collected (378)



PokerStars Home Game Hand #226757836193: {Club #4781089}  Hold'em No Limit (50/100) - 2021/05/15 0:02:17 EET [2021/05/14 17:02:17 ET]
Table 'VTTP NLHE' 2-max (Play Money) Seat #1 is the button
Seat 1: s70n3fac3 (5025 in chips) 
Seat 2: FDIBA2009 (12549 in chips) 
s70n3fac3: posts small blind 50
FDIBA2009: posts big blind 100
*** HOLE CARDS ***
s70n3fac3: raises 100 to 200
FDIBA2009: calls 100
*** FLOP *** [6h 3d Ah]
FDIBA2009: checks 
s70n3fac3: bets 200
FDIBA2009: calls 200
*** TURN *** [6h 3d Ah] [2s]
FDIBA2009: checks 
s70n3fac3: checks 
*** RIVER *** [6h 3d Ah 2s] [Jh]
FDIBA2009: bets 378
s70n3fac3: folds 
Uncalled bet (378) returned to FDIBA2009
FDIBA2009 collected 756 from pot
*** SUMMARY ***
Total pot 800 | Rake 44 
Board [6h 3d Ah 2s Jh]
Seat 1: s70n3fac3 (button) (small blind) folded on the River
Seat 2: FDIBA2009 (big blind) collected (756)



PokerStars Home Game Hand #226757851080: {Club #4781089}  Hold'em No Limit (50/100) - 2021/05/15 0:02:49 EET [2021/05/14 17:02:49 ET]
Table 'VTTP NLHE' 2-max (Play Money) Seat #2 is the button
Seat 1: s70n3fac3 (4625 in chips) 
Seat 2: FDIBA2009 (12905 in chips) 
FDIBA2009: posts small blind 50
s70n3fac3: posts big blind 100
*** HOLE CARDS ***
FDIBA2009: raises 100 to 200
s70n3fac3: raises 400 to 600
FDIBA2009: calls 400
*** FLOP *** [Ad 3s Ah]
s70n3fac3: checks 
FDIBA2009: checks 
*** TURN *** [Ad 3s Ah] [6c]
s70n3fac3: bets 600
FDIBA2009: folds 
Uncalled bet (600) returned to s70n3fac3
s70n3fac3 collected 1134 from pot
s70n3fac3: doesn't show hand 
*** SUMMARY ***
Total pot 1200 | Rake 66 
Board [Ad 3s Ah 6c]
Seat 1: s70n3fac3 (big blind) collected (1134)
Seat 2: FDIBA2009 (button) (small blind) folded on the Turn



PokerStars Home Game Hand #226757860465: {Club #4781089}  Hold'em No Limit (50/100) - 2021/05/15 0:03:23 EET [2021/05/14 17:03:23 ET]
Table 'VTTP NLHE' 2-max (Play Money) Seat #1 is the button
Seat 1: s70n3fac3 (5159 in chips) 
Seat 2: FDIBA2009 (12305 in chips) 
s70n3fac3: posts small blind 50
FDIBA2009: posts big blind 100
*** HOLE CARDS ***
s70n3fac3 said, "Ð¸Ð¼Ð°Ñ Ð»Ð¸ Ð·Ð°Ð±Ð°Ð²ÑÐ½Ðµ Ð¼ÐµÐ¶Ñ ÑÑÑÐµÑÐµ?"
s70n3fac3: raises 100 to 200
FDIBA2009: folds 
Uncalled bet (100) returned to s70n3fac3
s70n3fac3 collected 200 from pot
s70n3fac3: doesn't show hand 
*** SUMMARY ***
Total pot 200 | Rake 0 
Seat 1: s70n3fac3 (button) (small blind) collected (200)
Seat 2: FDIBA2009 (big blind) folded before Flop



PokerStars Home Game Hand #226757868663: {Club #4781089}  Hold'em No Limit (50/100) - 2021/05/15 0:03:40 EET [2021/05/14 17:03:40 ET]
Table 'VTTP NLHE' 2-max (Play Money) Seat #2 is the button
Seat 1: s70n3fac3 (5259 in chips) 
Seat 2: FDIBA2009 (12205 in chips) 
FDIBA2009: posts small blind 50
s70n3fac3: posts big blind 100
*** HOLE CARDS ***
FDIBA2009: raises 100 to 200
s70n3fac3: folds 
Uncalled bet (100) returned to FDIBA2009
FDIBA2009 collected 200 from pot
*** SUMMARY ***
Total pot 200 | Rake 0 
Seat 1: s70n3fac3 (big blind) folded before Flop
Seat 2: FDIBA2009 (button) (small blind) collected (200)



PokerStars Home Game Hand #226757874388: {Club #4781089}  Hold'em No Limit (50/100) - 2021/05/15 0:03:56 EET [2021/05/14 17:03:56 ET]
Table 'VTTP NLHE' 2-max (Play Money) Seat #1 is the button
Seat 1: s70n3fac3 (5159 in chips) 
Seat 2: FDIBA2009 (12305 in chips) 
s70n3fac3: posts small blind 50
FDIBA2009: posts big blind 100
*** HOLE CARDS ***
s70n3fac3: raises 100 to 200
FDIBA2009 said, "Da"
FDIBA2009: raises 100 to 300
s70n3fac3: calls 100
*** FLOP *** [Td 7d As]
FDIBA2009: checks 
s70n3fac3: bets 300
FDIBA2009 said, "No ne golismo"
FDIBA2009: folds 
Uncalled bet (300) returned to s70n3fac3
s70n3fac3 collected 567 from pot
s70n3fac3: doesn't show hand 
*** SUMMARY ***
Total pot 600 | Rake 33 
Board [Td 7d As]
Seat 1: s70n3fac3 (button) (small blind) collected (567)
Seat 2: FDIBA2009 (big blind) folded on the Flop



PokerStars Home Game Hand #226757887607: {Club #4781089}  Hold'em No Limit (50/100) - 2021/05/15 0:04:26 EET [2021/05/14 17:04:26 ET]
Table 'VTTP NLHE' 2-max (Play Money) Seat #2 is the button
Seat 1: s70n3fac3 (5426 in chips) 
Seat 2: FDIBA2009 (12005 in chips) 
FDIBA2009: posts small blind 50
s70n3fac3: posts big blind 100
*** HOLE CARDS ***
s70n3fac3 said, "da, bavi se pri razdavaneto na novata"
FDIBA2009: calls 50
s70n3fac3 said, "poveche ot obiknoveno"
s70n3fac3: raises 200 to 300
FDIBA2009: calls 200
*** FLOP *** [8d Kd 8c]
s70n3fac3: checks 
FDIBA2009: bets 283
s70n3fac3: calls 283
*** TURN *** [8d Kd 8c] [2d]
s70n3fac3: bets 600
FDIBA2009: folds 
Uncalled bet (600) returned to s70n3fac3
s70n3fac3 collected 1102 from pot
s70n3fac3: doesn't show hand 
*** SUMMARY ***
Total pot 1166 | Rake 64 
Board [8d Kd 8c 2d]
Seat 1: s70n3fac3 (big blind) collected (1102)
Seat 2: FDIBA2009 (button) (small blind) folded on the Turn



PokerStars Home Game Hand #226757905874: {Club #4781089}  Hold'em No Limit (50/100) - 2021/05/15 0:05:06 EET [2021/05/14 17:05:06 ET]
Table 'VTTP NLHE' 2-max (Play Money) Seat #1 is the button
Seat 1: s70n3fac3 (5945 in chips) 
Seat 2: FDIBA2009 (11422 in chips) 
s70n3fac3: posts small blind 50
FDIBA2009: posts big blind 100
*** HOLE CARDS ***
s70n3fac3: calls 50
FDIBA2009: checks 
*** FLOP *** [6s 8h Qc]
FDIBA2009: checks 
s70n3fac3: checks 
*** TURN *** [6s 8h Qc] [5s]
FDIBA2009: bets 189
s70n3fac3: folds 
Uncalled bet (189) returned to FDIBA2009
FDIBA2009 collected 189 from pot
*** SUMMARY ***
Total pot 200 | Rake 11 
Board [6s 8h Qc 5s]
Seat 1: s70n3fac3 (button) (small blind) folded on the Turn
Seat 2: FDIBA2009 (big blind) collected (189)



PokerStars Home Game Hand #226757914350: {Club #4781089}  Hold'em No Limit (50/100) - 2021/05/15 0:05:22 EET [2021/05/14 17:05:22 ET]
Table 'VTTP NLHE' 2-max (Play Money) Seat #2 is the button
Seat 1: s70n3fac3 (5845 in chips) 
Seat 2: FDIBA2009 (11511 in chips) 
FDIBA2009: posts small blind 50
s70n3fac3: posts big blind 100
*** HOLE CARDS ***
FDIBA2009: raises 100 to 200
s70n3fac3: raises 400 to 600
FDIBA2009: folds 
Uncalled bet (400) returned to s70n3fac3
s70n3fac3 collected 400 from pot
s70n3fac3: doesn't show hand 
*** SUMMARY ***
Total pot 400 | Rake 0 
Seat 1: s70n3fac3 (big blind) collected (400)
Seat 2: FDIBA2009 (button) (small blind) folded before Flop



PokerStars Home Game Hand #226757923279: {Club #4781089}  Hold'em No Limit (50/100) - 2021/05/15 0:05:35 EET [2021/05/14 17:05:35 ET]
Table 'VTTP NLHE' 2-max (Play Money) Seat #1 is the button
Seat 1: s70n3fac3 (6045 in chips) 
Seat 2: FDIBA2009 (11311 in chips) 
s70n3fac3: posts small blind 50
FDIBA2009: posts big blind 100
*** HOLE CARDS ***
s70n3fac3: folds 
Uncalled bet (50) returned to FDIBA2009
FDIBA2009 collected 100 from pot
*** SUMMARY ***
Total pot 100 | Rake 0 
Seat 1: s70n3fac3 (button) (small blind) folded before Flop
Seat 2: FDIBA2009 (big blind) collected (100)



PokerStars Home Game Hand #226757925730: {Club #4781089}  Hold'em No Limit (50/100) - 2021/05/15 0:05:39 EET [2021/05/14 17:05:39 ET]
Table 'VTTP NLHE' 2-max (Play Money) Seat #2 is the button
Seat 1: s70n3fac3 (5995 in chips) 
Seat 2: FDIBA2009 (11361 in chips) 
FDIBA2009: posts small blind 50
s70n3fac3: posts big blind 100
*** HOLE CARDS ***
FDIBA2009: raises 100 to 200
s70n3fac3: calls 100
*** FLOP *** [4s 5h Qc]
s70n3fac3: checks 
FDIBA2009: bets 100
s70n3fac3: folds 
Uncalled bet (100) returned to FDIBA2009
FDIBA2009 collected 378 from pot
*** SUMMARY ***
Total pot 400 | Rake 22 
Board [4s 5h Qc]
Seat 1: s70n3fac3 (big blind) folded on the Flop
Seat 2: FDIBA2009 (button) (small blind) collected (378)



PokerStars Home Game Hand #226757935065: {Club #4781089}  Hold'em No Limit (50/100) - 2021/05/15 0:05:53 EET [2021/05/14 17:05:53 ET]
Table 'VTTP NLHE' 2-max (Play Money) Seat #1 is the button
Seat 1: s70n3fac3 (5795 in chips) 
Seat 2: FDIBA2009 (11539 in chips) 
s70n3fac3: posts small blind 50
FDIBA2009: posts big blind 100
*** HOLE CARDS ***
s70n3fac3: raises 100 to 200
FDIBA2009: calls 100
*** FLOP *** [9c Qs Kc]
FDIBA2009: checks 
s70n3fac3: bets 200
FDIBA2009: calls 200
*** TURN *** [9c Qs Kc] [5h]
FDIBA2009: checks 
s70n3fac3: bets 400
FDIBA2009: calls 400
*** RIVER *** [9c Qs Kc 5h] [7s]
FDIBA2009: checks 
s70n3fac3: checks 
*** SHOW DOWN ***
FDIBA2009: shows [6d Qd] (a pair of Queens)
s70n3fac3: mucks hand 
FDIBA2009 collected 1512 from pot
*** SUMMARY ***
Total pot 1600 | Rake 88 
Board [9c Qs Kc 5h 7s]
Seat 1: s70n3fac3 (button) (small blind) mucked [9h Ac]
Seat 2: FDIBA2009 (big blind) showed [6d Qd] and won (1512) with a pair of Queens



PokerStars Home Game Hand #226757958544: {Club #4781089}  Hold'em No Limit (50/100) - 2021/05/15 0:06:25 EET [2021/05/14 17:06:25 ET]
Table 'VTTP NLHE' 2-max (Play Money) Seat #2 is the button
Seat 1: s70n3fac3 (4995 in chips) 
Seat 2: FDIBA2009 (12251 in chips) 
FDIBA2009: posts small blind 50
s70n3fac3: posts big blind 100
*** HOLE CARDS ***
FDIBA2009: raises 100 to 200
s70n3fac3: calls 100
*** FLOP *** [4d Qd 9c]
s70n3fac3: checks 
FDIBA2009: bets 189
s70n3fac3: raises 189 to 378
FDIBA2009: folds 
Uncalled bet (189) returned to s70n3fac3
s70n3fac3 collected 735 from pot
s70n3fac3: doesn't show hand 
*** SUMMARY ***
Total pot 778 | Rake 43 
Board [4d Qd 9c]
Seat 1: s70n3fac3 (big blind) collected (735)
Seat 2: FDIBA2009 (button) (small blind) folded on the Flop



PokerStars Home Game Hand #226757969158: {Club #4781089}  Hold'em No Limit (50/100) - 2021/05/15 0:06:42 EET [2021/05/14 17:06:42 ET]
Table 'VTTP NLHE' 2-max (Play Money) Seat #1 is the button
Seat 1: s70n3fac3 (5341 in chips) 
Seat 2: FDIBA2009 (11862 in chips) 
s70n3fac3: posts small blind 50
FDIBA2009: posts big blind 100
*** HOLE CARDS ***
s70n3fac3: raises 100 to 200
FDIBA2009: calls 100
*** FLOP *** [3c 6h Qs]
FDIBA2009: checks 
s70n3fac3: bets 200
FDIBA2009: folds 
Uncalled bet (200) returned to s70n3fac3
s70n3fac3 collected 378 from pot
s70n3fac3: doesn't show hand 
*** SUMMARY ***
Total pot 400 | Rake 22 
Board [3c 6h Qs]
Seat 1: s70n3fac3 (button) (small blind) collected (378)
Seat 2: FDIBA2009 (big blind) folded on the Flop



PokerStars Home Game Hand #226757981800: {Club #4781089}  Hold'em No Limit (50/100) - 2021/05/15 0:07:01 EET [2021/05/14 17:07:01 ET]
Table 'VTTP NLHE' 2-max (Play Money) Seat #2 is the button
Seat 1: s70n3fac3 (5519 in chips) 
Seat 2: FDIBA2009 (11662 in chips) 
FDIBA2009: posts small blind 50
s70n3fac3: posts big blind 100
*** HOLE CARDS ***
FDIBA2009: raises 100 to 200
s70n3fac3: calls 100
*** FLOP *** [4c Th 7c]
s70n3fac3: checks 
FDIBA2009: checks 
*** TURN *** [4c Th 7c] [Td]
s70n3fac3: bets 200
FDIBA2009: calls 200
*** RIVER *** [4c Th 7c Td] [7s]
s70n3fac3: checks 
FDIBA2009: bets 378
s70n3fac3: folds 
Uncalled bet (378) returned to FDIBA2009
FDIBA2009 collected 756 from pot
*** SUMMARY ***
Total pot 800 | Rake 44 
Board [4c Th 7c Td 7s]
Seat 1: s70n3fac3 (big blind) folded on the River
Seat 2: FDIBA2009 (button) (small blind) collected (756)



PokerStars Home Game Hand #226758002386: {Club #4781089}  Hold'em No Limit (50/100) - 2021/05/15 0:07:34 EET [2021/05/14 17:07:34 ET]
Table 'VTTP NLHE' 2-max (Play Money) Seat #1 is the button
Seat 1: s70n3fac3 (5119 in chips) 
Seat 2: FDIBA2009 (12018 in chips) 
s70n3fac3: posts small blind 50
FDIBA2009: posts big blind 100
*** HOLE CARDS ***
s70n3fac3: folds 
Uncalled bet (50) returned to FDIBA2009
FDIBA2009 collected 100 from pot
*** SUMMARY ***
Total pot 100 | Rake 0 
Seat 1: s70n3fac3 (button) (small blind) folded before Flop
Seat 2: FDIBA2009 (big blind) collected (100)



PokerStars Home Game Hand #226758004869: {Club #4781089}  Hold'em No Limit (50/100) - 2021/05/15 0:07:38 EET [2021/05/14 17:07:38 ET]
Table 'VTTP NLHE' 2-max (Play Money) Seat #2 is the button
Seat 1: s70n3fac3 (5069 in chips) 
Seat 2: FDIBA2009 (12068 in chips) 
FDIBA2009: posts small blind 50
s70n3fac3: posts big blind 100
*** HOLE CARDS ***
FDIBA2009: raises 100 to 200
s70n3fac3: folds 
Uncalled bet (100) returned to FDIBA2009
FDIBA2009 collected 200 from pot
*** SUMMARY ***
Total pot 200 | Rake 0 
Seat 1: s70n3fac3 (big blind) folded before Flop
Seat 2: FDIBA2009 (button) (small blind) collected (200)



PokerStars Home Game Hand #226758008796: {Club #4781089}  Hold'em No Limit (50/100) - 2021/05/15 0:07:45 EET [2021/05/14 17:07:45 ET]
Table 'VTTP NLHE' 2-max (Play Money) Seat #1 is the button
Seat 1: s70n3fac3 (4969 in chips) 
Seat 2: FDIBA2009 (12168 in chips) 
s70n3fac3: posts small blind 50
FDIBA2009: posts big blind 100
*** HOLE CARDS ***
s70n3fac3: raises 100 to 200
FDIBA2009: calls 100
*** FLOP *** [5h Kh 8d]
FDIBA2009: checks 
s70n3fac3: checks 
*** TURN *** [5h Kh 8d] [7h]
FDIBA2009: checks 
s70n3fac3: checks 
*** RIVER *** [5h Kh 8d 7h] [Ad]
FDIBA2009: checks 
s70n3fac3: bets 300
FDIBA2009: calls 300
*** SHOW DOWN ***
s70n3fac3: shows [8h 9h] (a flush, King high)
FDIBA2009: mucks hand 
s70n3fac3 collected 945 from pot
*** SUMMARY ***
Total pot 1000 | Rake 55 
Board [5h Kh 8d 7h Ad]
Seat 1: s70n3fac3 (button) (small blind) showed [8h 9h] and won (945) with a flush, King high
Seat 2: FDIBA2009 (big blind) mucked [9s 7d]



PokerStars Home Game Hand #226758026517: {Club #4781089}  Hold'em No Limit (50/100) - 2021/05/15 0:08:13 EET [2021/05/14 17:08:13 ET]
Table 'VTTP NLHE' 2-max (Play Money) Seat #2 is the button
Seat 1: s70n3fac3 (5414 in chips) 
Seat 2: FDIBA2009 (11668 in chips) 
FDIBA2009: posts small blind 50
s70n3fac3: posts big blind 100
*** HOLE CARDS ***
FDIBA2009: raises 100 to 200
s70n3fac3: folds 
Uncalled bet (100) returned to FDIBA2009
FDIBA2009 collected 200 from pot
*** SUMMARY ***
Total pot 200 | Rake 0 
Seat 1: s70n3fac3 (big blind) folded before Flop
Seat 2: FDIBA2009 (button) (small blind) collected (200)



PokerStars Home Game Hand #226758030483: {Club #4781089}  Hold'em No Limit (50/100) - 2021/05/15 0:08:20 EET [2021/05/14 17:08:20 ET]
Table 'VTTP NLHE' 2-max (Play Money) Seat #1 is the button
Seat 1: s70n3fac3 (5314 in chips) 
Seat 2: FDIBA2009 (11768 in chips) 
s70n3fac3: posts small blind 50
FDIBA2009: posts big blind 100
*** HOLE CARDS ***
s70n3fac3: raises 100 to 200
FDIBA2009: calls 100
*** FLOP *** [6c 5s 7c]
FDIBA2009: bets 100
s70n3fac3: raises 300 to 400
FDIBA2009: calls 300
*** TURN *** [6c 5s 7c] [4c]
FDIBA2009: checks 
s70n3fac3: bets 650
FDIBA2009: calls 650
*** RIVER *** [6c 5s 7c 4c] [Kd]
FDIBA2009: checks 
s70n3fac3: checks 
*** SHOW DOWN ***
FDIBA2009: shows [9c 6s] (a pair of Sixes)
s70n3fac3: shows [Ks 7s] (two pair, Kings and Sevens)
s70n3fac3 collected 2362 from pot
*** SUMMARY ***
Total pot 2500 | Rake 138 
Board [6c 5s 7c 4c Kd]
Seat 1: s70n3fac3 (button) (small blind) showed [Ks 7s] and won (2362) with two pair, Kings and Sevens
Seat 2: FDIBA2009 (big blind) showed [9c 6s] and lost with a pair of Sixes



PokerStars Home Game Hand #226758054175: {Club #4781089}  Hold'em No Limit (50/100) - 2021/05/15 0:08:58 EET [2021/05/14 17:08:58 ET]
Table 'VTTP NLHE' 2-max (Play Money) Seat #2 is the button
Seat 1: s70n3fac3 (6426 in chips) 
Seat 2: FDIBA2009 (10518 in chips) 
FDIBA2009: posts small blind 50
s70n3fac3: posts big blind 100
*** HOLE CARDS ***
FDIBA2009: raises 100 to 200
s70n3fac3: calls 100
*** FLOP *** [Jd 4s 2h]
s70n3fac3: checks 
FDIBA2009: bets 378
s70n3fac3: calls 378
*** TURN *** [Jd 4s 2h] [3c]
s70n3fac3: checks 
FDIBA2009: bets 1092
s70n3fac3: calls 1092
*** RIVER *** [Jd 4s 2h 3c] [Jc]
s70n3fac3: checks 
FDIBA2009: checks 
*** SHOW DOWN ***
s70n3fac3: shows [Ah 4h] (two pair, Jacks and Fours)
FDIBA2009: mucks hand 
s70n3fac3 collected 3156 from pot
*** SUMMARY ***
Total pot 3340 | Rake 184 
Board [Jd 4s 2h 3c Jc]
Seat 1: s70n3fac3 (big blind) showed [Ah 4h] and won (3156) with two pair, Jacks and Fours
Seat 2: FDIBA2009 (button) (small blind) mucked [5s Ts]



PokerStars Home Game Hand #226758074712: {Club #4781089}  Hold'em No Limit (50/100) - 2021/05/15 0:09:31 EET [2021/05/14 17:09:31 ET]
Table 'VTTP NLHE' 2-max (Play Money) Seat #1 is the button
Seat 1: s70n3fac3 (7912 in chips) 
Seat 2: FDIBA2009 (8848 in chips) 
s70n3fac3: posts small blind 50
FDIBA2009: posts big blind 100
*** HOLE CARDS ***
s70n3fac3: folds 
Uncalled bet (50) returned to FDIBA2009
FDIBA2009 collected 100 from pot
*** SUMMARY ***
Total pot 100 | Rake 0 
Seat 1: s70n3fac3 (button) (small blind) folded before Flop
Seat 2: FDIBA2009 (big blind) collected (100)



PokerStars Home Game Hand #226758077134: {Club #4781089}  Hold'em No Limit (50/100) - 2021/05/15 0:09:35 EET [2021/05/14 17:09:35 ET]
Table 'VTTP NLHE' 2-max (Play Money) Seat #2 is the button
Seat 1: s70n3fac3 (7862 in chips) 
Seat 2: FDIBA2009 (8898 in chips) 
FDIBA2009: posts small blind 50
s70n3fac3: posts big blind 100
*** HOLE CARDS ***
FDIBA2009: raises 100 to 200
s70n3fac3: folds 
Uncalled bet (100) returned to FDIBA2009
FDIBA2009 collected 200 from pot
*** SUMMARY ***
Total pot 200 | Rake 0 
Seat 1: s70n3fac3 (big blind) folded before Flop
Seat 2: FDIBA2009 (button) (small blind) collected (200)



PokerStars Home Game Hand #226758083809: {Club #4781089}  Hold'em No Limit (50/100) - 2021/05/15 0:09:46 EET [2021/05/14 17:09:46 ET]
Table 'VTTP NLHE' 2-max (Play Money) Seat #1 is the button
Seat 1: s70n3fac3 (7762 in chips) 
Seat 2: FDIBA2009 (8998 in chips) 
s70n3fac3: posts small blind 50
FDIBA2009: posts big blind 100
*** HOLE CARDS ***
s70n3fac3: raises 100 to 200
FDIBA2009: folds 
Uncalled bet (100) returned to s70n3fac3
s70n3fac3 collected 200 from pot
s70n3fac3: doesn't show hand 
*** SUMMARY ***
Total pot 200 | Rake 0 
Seat 1: s70n3fac3 (button) (small blind) collected (200)
Seat 2: FDIBA2009 (big blind) folded before Flop



PokerStars Home Game Hand #226758091021: {Club #4781089}  Hold'em No Limit (50/100) - 2021/05/15 0:09:57 EET [2021/05/14 17:09:57 ET]
Table 'VTTP NLHE' 2-max (Play Money) Seat #2 is the button
Seat 1: s70n3fac3 (7862 in chips) 
Seat 2: FDIBA2009 (8898 in chips) 
FDIBA2009: posts small blind 50
s70n3fac3: posts big blind 100
*** HOLE CARDS ***
FDIBA2009: folds 
Uncalled bet (50) returned to s70n3fac3
s70n3fac3 collected 100 from pot
s70n3fac3: doesn't show hand 
*** SUMMARY ***
Total pot 100 | Rake 0 
Seat 1: s70n3fac3 (big blind) collected (100)
Seat 2: FDIBA2009 (button) (small blind) folded before Flop



PokerStars Home Game Hand #226758095715: {Club #4781089}  Hold'em No Limit (50/100) - 2021/05/15 0:10:05 EET [2021/05/14 17:10:05 ET]
Table 'VTTP NLHE' 2-max (Play Money) Seat #1 is the button
Seat 1: s70n3fac3 (7912 in chips) 
Seat 2: FDIBA2009 (8848 in chips) 
s70n3fac3: posts small blind 50
FDIBA2009: posts big blind 100
*** HOLE CARDS ***
s70n3fac3: raises 100 to 200
FDIBA2009: raises 400 to 600
s70n3fac3: calls 400
*** FLOP *** [5d Ks 5h]
FDIBA2009: bets 1200
s70n3fac3: folds 
Uncalled bet (1200) returned to FDIBA2009
FDIBA2009 collected 1134 from pot
*** SUMMARY ***
Total pot 1200 | Rake 66 
Board [5d Ks 5h]
Seat 1: s70n3fac3 (button) (small blind) folded on the Flop
Seat 2: FDIBA2009 (big blind) collected (1134)



PokerStars Home Game Hand #226758109386: {Club #4781089}  Hold'em No Limit (50/100) - 2021/05/15 0:10:27 EET [2021/05/14 17:10:27 ET]
Table 'VTTP NLHE' 2-max (Play Money) Seat #2 is the button
Seat 1: s70n3fac3 (7312 in chips) 
Seat 2: FDIBA2009 (9382 in chips) 
FDIBA2009: posts small blind 50
s70n3fac3: posts big blind 100
*** HOLE CARDS ***
FDIBA2009: raises 100 to 200
s70n3fac3: calls 100
*** FLOP *** [As 2c Td]
s70n3fac3: checks 
FDIBA2009: bets 189
s70n3fac3: folds 
Uncalled bet (189) returned to FDIBA2009
FDIBA2009 collected 378 from pot
*** SUMMARY ***
Total pot 400 | Rake 22 
Board [As 2c Td]
Seat 1: s70n3fac3 (big blind) folded on the Flop
Seat 2: FDIBA2009 (button) (small blind) collected (378)



PokerStars Home Game Hand #226758116847: {Club #4781089}  Hold'em No Limit (50/100) - 2021/05/15 0:10:40 EET [2021/05/14 17:10:40 ET]
Table 'VTTP NLHE' 2-max (Play Money) Seat #1 is the button
Seat 1: s70n3fac3 (7112 in chips) 
Seat 2: FDIBA2009 (9560 in chips) 
s70n3fac3: posts small blind 50
FDIBA2009: posts big blind 100
*** HOLE CARDS ***
s70n3fac3: calls 50
FDIBA2009: checks 
*** FLOP *** [2c Jh Ks]
FDIBA2009: checks 
s70n3fac3: checks 
*** TURN *** [2c Jh Ks] [Kh]
FDIBA2009: checks 
s70n3fac3: checks 
*** RIVER *** [2c Jh Ks Kh] [3d]
FDIBA2009: bets 449
s70n3fac3: folds 
Uncalled bet (449) returned to FDIBA2009
FDIBA2009 collected 189 from pot
*** SUMMARY ***
Total pot 200 | Rake 11 
Board [2c Jh Ks Kh 3d]
Seat 1: s70n3fac3 (button) (small blind) folded on the River
Seat 2: FDIBA2009 (big blind) collected (189)



PokerStars Home Game Hand #226758131034: {Club #4781089}  Hold'em No Limit (50/100) - 2021/05/15 0:11:03 EET [2021/05/14 17:11:03 ET]
Table 'VTTP NLHE' 2-max (Play Money) Seat #2 is the button
Seat 1: s70n3fac3 (7012 in chips) 
Seat 2: FDIBA2009 (9649 in chips) 
FDIBA2009: posts small blind 50
s70n3fac3: posts big blind 100
*** HOLE CARDS ***
FDIBA2009: raises 100 to 200
s70n3fac3: calls 100
*** FLOP *** [Tc 5c 7c]
s70n3fac3: checks 
FDIBA2009: checks 
*** TURN *** [Tc 5c 7c] [Kc]
s70n3fac3: checks 
FDIBA2009: bets 189
s70n3fac3: folds 
Uncalled bet (189) returned to FDIBA2009
FDIBA2009 collected 378 from pot
*** SUMMARY ***
Total pot 400 | Rake 22 
Board [Tc 5c 7c Kc]
Seat 1: s70n3fac3 (big blind) folded on the Turn
Seat 2: FDIBA2009 (button) (small blind) collected (378)



PokerStars Home Game Hand #226758146567: {Club #4781089}  Hold'em No Limit (50/100) - 2021/05/15 0:11:19 EET [2021/05/14 17:11:19 ET]
Table 'VTTP NLHE' 2-max (Play Money) Seat #1 is the button
Seat 1: s70n3fac3 (6812 in chips) 
Seat 2: FDIBA2009 (9827 in chips) 
s70n3fac3: posts small blind 50
FDIBA2009: posts big blind 100
*** HOLE CARDS ***
s70n3fac3: raises 100 to 200
FDIBA2009: folds 
Uncalled bet (100) returned to s70n3fac3
s70n3fac3 collected 200 from pot
s70n3fac3: doesn't show hand 
*** SUMMARY ***
Total pot 200 | Rake 0 
Seat 1: s70n3fac3 (button) (small blind) collected (200)
Seat 2: FDIBA2009 (big blind) folded before Flop



PokerStars Home Game Hand #226758149846: {Club #4781089}  Hold'em No Limit (50/100) - 2021/05/15 0:11:24 EET [2021/05/14 17:11:24 ET]
Table 'VTTP NLHE' 2-max (Play Money) Seat #2 is the button
Seat 1: s70n3fac3 (6912 in chips) 
Seat 2: FDIBA2009 (9727 in chips) 
FDIBA2009: posts small blind 50
s70n3fac3: posts big blind 100
*** HOLE CARDS ***
FDIBA2009: raises 100 to 200
s70n3fac3: calls 100
*** FLOP *** [4s Ac 9d]
s70n3fac3: checks 
FDIBA2009: checks 
*** TURN *** [4s Ac 9d] [Jc]
s70n3fac3: bets 200
FDIBA2009: calls 200
*** RIVER *** [4s Ac 9d Jc] [Ad]
s70n3fac3: bets 400
FDIBA2009: folds 
Uncalled bet (400) returned to s70n3fac3
s70n3fac3 collected 756 from pot
s70n3fac3: doesn't show hand 
*** SUMMARY ***
Total pot 800 | Rake 44 
Board [4s Ac 9d Jc Ad]
Seat 1: s70n3fac3 (big blind) collected (756)
Seat 2: FDIBA2009 (button) (small blind) folded on the River



PokerStars Home Game Hand #226758165162: {Club #4781089}  Hold'em No Limit (50/100) - 2021/05/15 0:11:49 EET [2021/05/14 17:11:49 ET]
Table 'VTTP NLHE' 2-max (Play Money) Seat #1 is the button
Seat 1: s70n3fac3 (7268 in chips) 
Seat 2: FDIBA2009 (9327 in chips) 
s70n3fac3: posts small blind 50
FDIBA2009: posts big blind 100
*** HOLE CARDS ***
s70n3fac3: raises 100 to 200
FDIBA2009: calls 100
*** FLOP *** [3c 5d Jc]
FDIBA2009: checks 
s70n3fac3: bets 200
FDIBA2009: calls 200
*** TURN *** [3c 5d Jc] [8d]
FDIBA2009: checks 
s70n3fac3: bets 400
FDIBA2009: calls 400
*** RIVER *** [3c 5d Jc 8d] [7d]
FDIBA2009: checks 
s70n3fac3: checks 
*** SHOW DOWN ***
FDIBA2009: shows [5s 2s] (a pair of Fives)
s70n3fac3: shows [8c Kc] (a pair of Eights)
s70n3fac3 collected 1512 from pot
*** SUMMARY ***
Total pot 1600 | Rake 88 
Board [3c 5d Jc 8d 7d]
Seat 1: s70n3fac3 (button) (small blind) showed [8c Kc] and won (1512) with a pair of Eights
Seat 2: FDIBA2009 (big blind) showed [5s 2s] and lost with a pair of Fives



PokerStars Home Game Hand #226758183519: {Club #4781089}  Hold'em No Limit (50/100) - 2021/05/15 0:12:20 EET [2021/05/14 17:12:20 ET]
Table 'VTTP NLHE' 2-max (Play Money) Seat #2 is the button
Seat 1: s70n3fac3 (7980 in chips) 
Seat 2: FDIBA2009 (8527 in chips) 
FDIBA2009: posts small blind 50
s70n3fac3: posts big blind 100
*** HOLE CARDS ***
FDIBA2009: raises 200 to 300
s70n3fac3: folds 
Uncalled bet (200) returned to FDIBA2009
FDIBA2009 collected 200 from pot
*** SUMMARY ***
Total pot 200 | Rake 0 
Seat 1: s70n3fac3 (big blind) folded before Flop
Seat 2: FDIBA2009 (button) (small blind) collected (200)



PokerStars Home Game Hand #226758189810: {Club #4781089}  Hold'em No Limit (50/100) - 2021/05/15 0:12:30 EET [2021/05/14 17:12:30 ET]
Table 'VTTP NLHE' 2-max (Play Money) Seat #1 is the button
Seat 1: s70n3fac3 (7880 in chips) 
Seat 2: FDIBA2009 (8627 in chips) 
s70n3fac3: posts small blind 50
FDIBA2009: posts big blind 100
*** HOLE CARDS ***
s70n3fac3: raises 100 to 200
FDIBA2009: raises 400 to 600
s70n3fac3: folds 
Uncalled bet (400) returned to FDIBA2009
FDIBA2009 collected 400 from pot
*** SUMMARY ***
Total pot 400 | Rake 0 
Seat 1: s70n3fac3 (button) (small blind) folded before Flop
Seat 2: FDIBA2009 (big blind) collected (400)



PokerStars Home Game Hand #226758194649: {Club #4781089}  Hold'em No Limit (50/100) - 2021/05/15 0:12:38 EET [2021/05/14 17:12:38 ET]
Table 'VTTP NLHE' 2-max (Play Money) Seat #2 is the button
Seat 1: s70n3fac3 (7680 in chips) 
Seat 2: FDIBA2009 (8827 in chips) 
FDIBA2009: posts small blind 50
s70n3fac3: posts big blind 100
*** HOLE CARDS ***
FDIBA2009: raises 100 to 200
s70n3fac3: calls 100
*** FLOP *** [6c 7h Th]
s70n3fac3: checks 
FDIBA2009: bets 378
s70n3fac3: folds 
Uncalled bet (378) returned to FDIBA2009
FDIBA2009 collected 378 from pot
*** SUMMARY ***
Total pot 400 | Rake 22 
Board [6c 7h Th]
Seat 1: s70n3fac3 (big blind) folded on the Flop
Seat 2: FDIBA2009 (button) (small blind) collected (378)



PokerStars Home Game Hand #226758201078: {Club #4781089}  Hold'em No Limit (50/100) - 2021/05/15 0:12:49 EET [2021/05/14 17:12:49 ET]
Table 'VTTP NLHE' 2-max (Play Money) Seat #1 is the button
Seat 1: s70n3fac3 (7480 in chips) 
Seat 2: FDIBA2009 (9005 in chips) 
s70n3fac3: posts small blind 50
FDIBA2009: posts big blind 100
*** HOLE CARDS ***
s70n3fac3: folds 
Uncalled bet (50) returned to FDIBA2009
FDIBA2009 collected 100 from pot
*** SUMMARY ***
Total pot 100 | Rake 0 
Seat 1: s70n3fac3 (button) (small blind) folded before Flop
Seat 2: FDIBA2009 (big blind) collected (100)



PokerStars Home Game Hand #226758203499: {Club #4781089}  Hold'em No Limit (50/100) - 2021/05/15 0:12:53 EET [2021/05/14 17:12:53 ET]
Table 'VTTP NLHE' 2-max (Play Money) Seat #2 is the button
Seat 1: s70n3fac3 (7430 in chips) 
Seat 2: FDIBA2009 (9055 in chips) 
FDIBA2009: posts small blind 50
s70n3fac3: posts big blind 100
*** HOLE CARDS ***
FDIBA2009: raises 100 to 200
s70n3fac3: calls 100
*** FLOP *** [9c 8s 9h]
s70n3fac3: checks 
FDIBA2009: checks 
*** TURN *** [9c 8s 9h] [Kd]
s70n3fac3: checks 
FDIBA2009: bets 378
s70n3fac3: folds 
Uncalled bet (378) returned to FDIBA2009
FDIBA2009 collected 378 from pot
*** SUMMARY ***
Total pot 400 | Rake 22 
Board [9c 8s 9h Kd]
Seat 1: s70n3fac3 (big blind) folded on the Turn
Seat 2: FDIBA2009 (button) (small blind) collected (378)



PokerStars Home Game Hand #226758213555: {Club #4781089}  Hold'em No Limit (50/100) - 2021/05/15 0:13:09 EET [2021/05/14 17:13:09 ET]
Table 'VTTP NLHE' 2-max (Play Money) Seat #1 is the button
Seat 1: s70n3fac3 (7230 in chips) 
Seat 2: FDIBA2009 (9233 in chips) 
s70n3fac3: posts small blind 50
FDIBA2009: posts big blind 100
*** HOLE CARDS ***
s70n3fac3: raises 100 to 200
FDIBA2009: folds 
Uncalled bet (100) returned to s70n3fac3
s70n3fac3 collected 200 from pot
s70n3fac3: doesn't show hand 
*** SUMMARY ***
Total pot 200 | Rake 0 
Seat 1: s70n3fac3 (button) (small blind) collected (200)
Seat 2: FDIBA2009 (big blind) folded before Flop



PokerStars Home Game Hand #226758217227: {Club #4781089}  Hold'em No Limit (50/100) - 2021/05/15 0:13:15 EET [2021/05/14 17:13:15 ET]
Table 'VTTP NLHE' 2-max (Play Money) Seat #2 is the button
Seat 1: s70n3fac3 (7330 in chips) 
Seat 2: FDIBA2009 (9133 in chips) 
FDIBA2009: posts small blind 50
s70n3fac3: posts big blind 100
*** HOLE CARDS ***
FDIBA2009: raises 100 to 200
s70n3fac3: folds 
Uncalled bet (100) returned to FDIBA2009
FDIBA2009 collected 200 from pot
*** SUMMARY ***
Total pot 200 | Rake 0 
Seat 1: s70n3fac3 (big blind) folded before Flop
Seat 2: FDIBA2009 (button) (small blind) collected (200)



PokerStars Home Game Hand #226758221477: {Club #4781089}  Hold'em No Limit (50/100) - 2021/05/15 0:13:22 EET [2021/05/14 17:13:22 ET]
Table 'VTTP NLHE' 2-max (Play Money) Seat #1 is the button
Seat 1: s70n3fac3 (7230 in chips) 
Seat 2: FDIBA2009 (9233 in chips) 
s70n3fac3: posts small blind 50
FDIBA2009: posts big blind 100
*** HOLE CARDS ***
s70n3fac3: raises 150 to 250
FDIBA2009: calls 150
*** FLOP *** [Ah As 2d]
FDIBA2009: checks 
s70n3fac3: checks 
*** TURN *** [Ah As 2d] [4d]
FDIBA2009: checks 
s70n3fac3: checks 
*** RIVER *** [Ah As 2d 4d] [2c]
FDIBA2009: bets 472
s70n3fac3: folds 
Uncalled bet (472) returned to FDIBA2009
FDIBA2009 collected 472 from pot
*** SUMMARY ***
Total pot 500 | Rake 28 
Board [Ah As 2d 4d 2c]
Seat 1: s70n3fac3 (button) (small blind) folded on the River
Seat 2: FDIBA2009 (big blind) collected (472)



PokerStars Home Game Hand #226758241104: {Club #4781089}  Hold'em No Limit (50/100) - 2021/05/15 0:13:55 EET [2021/05/14 17:13:55 ET]
Table 'VTTP NLHE' 2-max (Play Money) Seat #2 is the button
Seat 1: s70n3fac3 (6980 in chips) 
Seat 2: FDIBA2009 (9455 in chips) 
FDIBA2009: posts small blind 50
s70n3fac3: posts big blind 100
*** HOLE CARDS ***
FDIBA2009: raises 100 to 200
s70n3fac3: calls 100
*** FLOP *** [Jh Ac 2s]
s70n3fac3: checks 
FDIBA2009: checks 
*** TURN *** [Jh Ac 2s] [Qh]
s70n3fac3: checks 
FDIBA2009: checks 
*** RIVER *** [Jh Ac 2s Qh] [8d]
s70n3fac3: checks 
FDIBA2009: checks 
*** SHOW DOWN ***
s70n3fac3: shows [4s Ks] (high card Ace)
FDIBA2009: mucks hand 
s70n3fac3 collected 378 from pot
*** SUMMARY ***
Total pot 400 | Rake 22 
Board [Jh Ac 2s Qh 8d]
Seat 1: s70n3fac3 (big blind) showed [4s Ks] and won (378) with high card Ace
Seat 2: FDIBA2009 (button) (small blind) mucked [7d 6c]



PokerStars Home Game Hand #226758258748: {Club #4781089}  Hold'em No Limit (50/100) - 2021/05/15 0:14:24 EET [2021/05/14 17:14:24 ET]
Table 'VTTP NLHE' 2-max (Play Money) Seat #1 is the button
Seat 1: s70n3fac3 (7158 in chips) 
Seat 2: FDIBA2009 (9255 in chips) 
s70n3fac3: posts small blind 50
FDIBA2009: posts big blind 100
*** HOLE CARDS ***
s70n3fac3: raises 100 to 200
FDIBA2009: raises 400 to 600
s70n3fac3: folds 
Uncalled bet (400) returned to FDIBA2009
FDIBA2009 collected 400 from pot
*** SUMMARY ***
Total pot 400 | Rake 0 
Seat 1: s70n3fac3 (button) (small blind) folded before Flop
Seat 2: FDIBA2009 (big blind) collected (400)



PokerStars Home Game Hand #226758266124: {Club #4781089}  Hold'em No Limit (50/100) - 2021/05/15 0:14:36 EET [2021/05/14 17:14:36 ET]
Table 'VTTP NLHE' 2-max (Play Money) Seat #2 is the button
Seat 1: s70n3fac3 (6958 in chips) 
Seat 2: FDIBA2009 (9455 in chips) 
FDIBA2009: posts small blind 50
s70n3fac3: posts big blind 100
*** HOLE CARDS ***
FDIBA2009: raises 100 to 200
s70n3fac3: calls 100
*** FLOP *** [7h Qc 5c]
s70n3fac3: checks 
FDIBA2009: bets 378
s70n3fac3: raises 567 to 945
FDIBA2009: calls 567
*** TURN *** [7h Qc 5c] [5d]
s70n3fac3: checks 
FDIBA2009: checks 
*** RIVER *** [7h Qc 5c 5d] [Jd]
s70n3fac3: checks 
FDIBA2009: bets 2164
s70n3fac3: folds 
Uncalled bet (2164) returned to FDIBA2009
FDIBA2009 collected 2164 from pot
*** SUMMARY ***
Total pot 2290 | Rake 126 
Board [7h Qc 5c 5d Jd]
Seat 1: s70n3fac3 (big blind) folded on the River
Seat 2: FDIBA2009 (button) (small blind) collected (2164)



PokerStars Home Game Hand #226758296107: {Club #4781089}  Hold'em No Limit (50/100) - 2021/05/15 0:15:26 EET [2021/05/14 17:15:26 ET]
Table 'VTTP NLHE' 2-max (Play Money) Seat #1 is the button
Seat 1: s70n3fac3 (5813 in chips) 
Seat 2: FDIBA2009 (10474 in chips) 
s70n3fac3: posts small blind 50
FDIBA2009: posts big blind 100
*** HOLE CARDS ***
s70n3fac3: raises 100 to 200
FDIBA2009: calls 100
*** FLOP *** [2s 9c 4s]
FDIBA2009: checks 
s70n3fac3: bets 250
FDIBA2009: folds 
Uncalled bet (250) returned to s70n3fac3
s70n3fac3 collected 378 from pot
s70n3fac3: doesn't show hand 
*** SUMMARY ***
Total pot 400 | Rake 22 
Board [2s 9c 4s]
Seat 1: s70n3fac3 (button) (small blind) collected (378)
Seat 2: FDIBA2009 (big blind) folded on the Flop



PokerStars Home Game Hand #226758306380: {Club #4781089}  Hold'em No Limit (50/100) - 2021/05/15 0:15:43 EET [2021/05/14 17:15:43 ET]
Table 'VTTP NLHE' 2-max (Play Money) Seat #2 is the button
Seat 1: s70n3fac3 (5991 in chips) 
Seat 2: FDIBA2009 (10274 in chips) 
FDIBA2009: posts small blind 50
s70n3fac3: posts big blind 100
*** HOLE CARDS ***
FDIBA2009: folds 
Uncalled bet (50) returned to s70n3fac3
s70n3fac3 collected 100 from pot
s70n3fac3: doesn't show hand 
*** SUMMARY ***
Total pot 100 | Rake 0 
Seat 1: s70n3fac3 (big blind) collected (100)
Seat 2: FDIBA2009 (button) (small blind) folded before Flop



PokerStars Home Game Hand #226758310141: {Club #4781089}  Hold'em No Limit (50/100) - 2021/05/15 0:15:49 EET [2021/05/14 17:15:49 ET]
Table 'VTTP NLHE' 2-max (Play Money) Seat #1 is the button
Seat 1: s70n3fac3 (6041 in chips) 
Seat 2: FDIBA2009 (10224 in chips) 
s70n3fac3: posts small blind 50
FDIBA2009: posts big blind 100
*** HOLE CARDS ***
s70n3fac3: raises 100 to 200
FDIBA2009: folds 
Uncalled bet (100) returned to s70n3fac3
s70n3fac3 collected 200 from pot
s70n3fac3: doesn't show hand 
*** SUMMARY ***
Total pot 200 | Rake 0 
Seat 1: s70n3fac3 (button) (small blind) collected (200)
Seat 2: FDIBA2009 (big blind) folded before Flop



PokerStars Home Game Hand #226758313502: {Club #4781089}  Hold'em No Limit (50/100) - 2021/05/15 0:15:55 EET [2021/05/14 17:15:55 ET]
Table 'VTTP NLHE' 2-max (Play Money) Seat #2 is the button
Seat 1: s70n3fac3 (6141 in chips) 
Seat 2: FDIBA2009 (10124 in chips) 
FDIBA2009: posts small blind 50
s70n3fac3: posts big blind 100
*** HOLE CARDS ***
FDIBA2009: raises 100 to 200
s70n3fac3: calls 100
*** FLOP *** [Th 4c Kc]
s70n3fac3: checks 
FDIBA2009: checks 
*** TURN *** [Th 4c Kc] [9h]
s70n3fac3: checks 
FDIBA2009: bets 189
s70n3fac3: calls 189
*** RIVER *** [Th 4c Kc 9h] [6d]
s70n3fac3: checks 
FDIBA2009: checks 
*** SHOW DOWN ***
s70n3fac3: shows [8d Jh] (high card King)
FDIBA2009: shows [Js 6h] (a pair of Sixes)
FDIBA2009 collected 735 from pot
*** SUMMARY ***
Total pot 778 | Rake 43 
Board [Th 4c Kc 9h 6d]
Seat 1: s70n3fac3 (big blind) showed [8d Jh] and lost with high card King
Seat 2: FDIBA2009 (button) (small blind) showed [Js 6h] and won (735) with a pair of Sixes



PokerStars Home Game Hand #226758327117: {Club #4781089}  Hold'em No Limit (50/100) - 2021/05/15 0:16:17 EET [2021/05/14 17:16:17 ET]
Table 'VTTP NLHE' 2-max (Play Money) Seat #1 is the button
Seat 1: s70n3fac3 (5752 in chips) 
Seat 2: FDIBA2009 (10470 in chips) 
s70n3fac3: posts small blind 50
FDIBA2009: posts big blind 100
*** HOLE CARDS ***
s70n3fac3: folds 
Uncalled bet (50) returned to FDIBA2009
FDIBA2009 collected 100 from pot
*** SUMMARY ***
Total pot 100 | Rake 0 
Seat 1: s70n3fac3 (button) (small blind) folded before Flop
Seat 2: FDIBA2009 (big blind) collected (100)



PokerStars Home Game Hand #226758329438: {Club #4781089}  Hold'em No Limit (50/100) - 2021/05/15 0:16:21 EET [2021/05/14 17:16:21 ET]
Table 'VTTP NLHE' 2-max (Play Money) Seat #2 is the button
Seat 1: s70n3fac3 (5702 in chips) 
Seat 2: FDIBA2009 (10520 in chips) 
FDIBA2009: posts small blind 50
s70n3fac3: posts big blind 100
*** HOLE CARDS ***
FDIBA2009: raises 100 to 200
s70n3fac3: folds 
Uncalled bet (100) returned to FDIBA2009
FDIBA2009 collected 200 from pot
*** SUMMARY ***
Total pot 200 | Rake 0 
Seat 1: s70n3fac3 (big blind) folded before Flop
Seat 2: FDIBA2009 (button) (small blind) collected (200)



PokerStars Home Game Hand #226758333128: {Club #4781089}  Hold'em No Limit (50/100) - 2021/05/15 0:16:28 EET [2021/05/14 17:16:28 ET]
Table 'VTTP NLHE' 2-max (Play Money) Seat #1 is the button
Seat 1: s70n3fac3 (5602 in chips) 
Seat 2: FDIBA2009 (10620 in chips) 
s70n3fac3: posts small blind 50
FDIBA2009: posts big blind 100
*** HOLE CARDS ***
s70n3fac3: folds 
Uncalled bet (50) returned to FDIBA2009
FDIBA2009 collected 100 from pot
*** SUMMARY ***
Total pot 100 | Rake 0 
Seat 1: s70n3fac3 (button) (small blind) folded before Flop
Seat 2: FDIBA2009 (big blind) collected (100)



PokerStars Home Game Hand #226758335338: {Club #4781089}  Hold'em No Limit (50/100) - 2021/05/15 0:16:31 EET [2021/05/14 17:16:31 ET]
Table 'VTTP NLHE' 2-max (Play Money) Seat #2 is the button
Seat 1: s70n3fac3 (5552 in chips) 
Seat 2: FDIBA2009 (10670 in chips) 
FDIBA2009: posts small blind 50
s70n3fac3: posts big blind 100
*** HOLE CARDS ***
FDIBA2009: raises 100 to 200
s70n3fac3: calls 100
*** FLOP *** [2d Kh 9d]
s70n3fac3: checks 
FDIBA2009: bets 189
s70n3fac3: calls 189
*** TURN *** [2d Kh 9d] [Jh]
s70n3fac3: checks 
FDIBA2009: bets 367
s70n3fac3: folds 
Uncalled bet (367) returned to FDIBA2009
FDIBA2009 collected 735 from pot
*** SUMMARY ***
Total pot 778 | Rake 43 
Board [2d Kh 9d Jh]
Seat 1: s70n3fac3 (big blind) folded on the Turn
Seat 2: FDIBA2009 (button) (small blind) collected (735)



PokerStars Home Game Hand #226758351094: {Club #4781089}  Hold'em No Limit (50/100) - 2021/05/15 0:16:50 EET [2021/05/14 17:16:50 ET]
Table 'VTTP NLHE' 2-max (Play Money) Seat #1 is the button
Seat 1: s70n3fac3 (5163 in chips) 
Seat 2: FDIBA2009 (11016 in chips) 
s70n3fac3: posts small blind 50
FDIBA2009: posts big blind 100
*** HOLE CARDS ***
s70n3fac3: folds 
Uncalled bet (50) returned to FDIBA2009
FDIBA2009 collected 100 from pot
*** SUMMARY ***
Total pot 100 | Rake 0 
Seat 1: s70n3fac3 (button) (small blind) folded before Flop
Seat 2: FDIBA2009 (big blind) collected (100)



PokerStars Home Game Hand #226758386323: {Club #4781089}  Hold'em No Limit (50/100) - 2021/05/15 0:17:48 EET [2021/05/14 17:17:48 ET]
Table 'VTTP NLHE' 2-max (Play Money) Seat #2 is the button
Seat 1: s70n3fac3 (5113 in chips) 
Seat 2: FDIBA2009 (11066 in chips) 
FDIBA2009: posts small blind 50
s70n3fac3: posts big blind 100
*** HOLE CARDS ***
FDIBA2009 said, "Tuk sam"
FDIBA2009: raises 100 to 200
s70n3fac3: calls 100
*** FLOP *** [4s Kh 8h]
s70n3fac3: checks 
FDIBA2009: bets 378
s70n3fac3: folds 
Uncalled bet (378) returned to FDIBA2009
FDIBA2009 collected 378 from pot
*** SUMMARY ***
Total pot 400 | Rake 22 
Board [4s Kh 8h]
Seat 1: s70n3fac3 (big blind) folded on the Flop
Seat 2: FDIBA2009 (button) (small blind) collected (378)



PokerStars Home Game Hand #226758398261: {Club #4781089}  Hold'em No Limit (50/100) - 2021/05/15 0:18:08 EET [2021/05/14 17:18:08 ET]
Table 'VTTP NLHE' 2-max (Play Money) Seat #1 is the button
Seat 1: s70n3fac3 (4913 in chips) 
Seat 2: FDIBA2009 (11244 in chips) 
s70n3fac3: posts small blind 50
FDIBA2009: posts big blind 100
*** HOLE CARDS ***
s70n3fac3: raises 100 to 200
FDIBA2009: calls 100
*** FLOP *** [2c Qc Ac]
FDIBA2009: checks 
s70n3fac3: bets 200
FDIBA2009: calls 200
*** TURN *** [2c Qc Ac] [Qs]
FDIBA2009: checks 
s70n3fac3: bets 400
FDIBA2009: folds 
Uncalled bet (400) returned to s70n3fac3
s70n3fac3 collected 756 from pot
s70n3fac3: doesn't show hand 
*** SUMMARY ***
Total pot 800 | Rake 44 
Board [2c Qc Ac Qs]
Seat 1: s70n3fac3 (button) (small blind) collected (756)
Seat 2: FDIBA2009 (big blind) folded on the Turn



PokerStars Home Game Hand #226758410775: {Club #4781089}  Hold'em No Limit (50/100) - 2021/05/15 0:18:29 EET [2021/05/14 17:18:29 ET]
Table 'VTTP NLHE' 2-max (Play Money) Seat #2 is the button
Seat 1: s70n3fac3 (5269 in chips) 
Seat 2: FDIBA2009 (10844 in chips) 
FDIBA2009: posts small blind 50
s70n3fac3: posts big blind 100
*** HOLE CARDS ***
FDIBA2009: raises 100 to 200
s70n3fac3: folds 
Uncalled bet (100) returned to FDIBA2009
FDIBA2009 collected 200 from pot
*** SUMMARY ***
Total pot 200 | Rake 0 
Seat 1: s70n3fac3 (big blind) folded before Flop
Seat 2: FDIBA2009 (button) (small blind) collected (200)



PokerStars Home Game Hand #226758415745: {Club #4781089}  Hold'em No Limit (50/100) - 2021/05/15 0:18:37 EET [2021/05/14 17:18:37 ET]
Table 'VTTP NLHE' 2-max (Play Money) Seat #1 is the button
Seat 1: s70n3fac3 (5169 in chips) 
Seat 2: FDIBA2009 (10944 in chips) 
s70n3fac3: posts small blind 50
FDIBA2009: posts big blind 100
*** HOLE CARDS ***
s70n3fac3: raises 100 to 200
FDIBA2009: calls 100
*** FLOP *** [7h Jh 5s]
FDIBA2009: checks 
s70n3fac3: bets 200
FDIBA2009: folds 
Uncalled bet (200) returned to s70n3fac3
s70n3fac3 collected 378 from pot
s70n3fac3: doesn't show hand 
*** SUMMARY ***
Total pot 400 | Rake 22 
Board [7h Jh 5s]
Seat 1: s70n3fac3 (button) (small blind) collected (378)
Seat 2: FDIBA2009 (big blind) folded on the Flop



PokerStars Home Game Hand #226758427504: {Club #4781089}  Hold'em No Limit (50/100) - 2021/05/15 0:18:57 EET [2021/05/14 17:18:57 ET]
Table 'VTTP NLHE' 2-max (Play Money) Seat #2 is the button
Seat 1: s70n3fac3 (5347 in chips) 
Seat 2: FDIBA2009 (10744 in chips) 
FDIBA2009: posts small blind 50
s70n3fac3: posts big blind 100
*** HOLE CARDS ***
FDIBA2009: raises 100 to 200
s70n3fac3: calls 100
*** FLOP *** [5h Ks 8h]
s70n3fac3: checks 
FDIBA2009: checks 
*** TURN *** [5h Ks 8h] [8c]
s70n3fac3: checks 
FDIBA2009: checks 
*** RIVER *** [5h Ks 8h 8c] [7h]
s70n3fac3: bets 300
FDIBA2009: calls 300
*** SHOW DOWN ***
s70n3fac3: shows [6s Kh] (two pair, Kings and Eights)
FDIBA2009: mucks hand 
s70n3fac3 collected 945 from pot
*** SUMMARY ***
Total pot 1000 | Rake 55 
Board [5h Ks 8h 8c 7h]
Seat 1: s70n3fac3 (big blind) showed [6s Kh] and won (945) with two pair, Kings and Eights
Seat 2: FDIBA2009 (button) (small blind) mucked [3d 7s]



PokerStars Home Game Hand #226758441152: {Club #4781089}  Hold'em No Limit (50/100) - 2021/05/15 0:19:20 EET [2021/05/14 17:19:20 ET]
Table 'VTTP NLHE' 2-max (Play Money) Seat #1 is the button
Seat 1: s70n3fac3 (5792 in chips) 
Seat 2: FDIBA2009 (10244 in chips) 
s70n3fac3: posts small blind 50
FDIBA2009: posts big blind 100
*** HOLE CARDS ***
s70n3fac3: raises 100 to 200
FDIBA2009: raises 100 to 300
s70n3fac3: calls 100
*** FLOP *** [9d 4c 2h]
FDIBA2009: bets 567
s70n3fac3: calls 567
*** TURN *** [9d 4c 2h] [8d]
FDIBA2009: checks 
s70n3fac3: bets 800
FDIBA2009: folds 
Uncalled bet (800) returned to s70n3fac3
s70n3fac3 collected 1639 from pot
s70n3fac3: doesn't show hand 
*** SUMMARY ***
Total pot 1734 | Rake 95 
Board [9d 4c 2h 8d]
Seat 1: s70n3fac3 (button) (small blind) collected (1639)
Seat 2: FDIBA2009 (big blind) folded on the Turn



PokerStars Home Game Hand #226758464902: {Club #4781089}  Hold'em No Limit (50/100) - 2021/05/15 0:20:00 EET [2021/05/14 17:20:00 ET]
Table 'VTTP NLHE' 2-max (Play Money) Seat #2 is the button
Seat 1: s70n3fac3 (6564 in chips) 
Seat 2: FDIBA2009 (9377 in chips) 
FDIBA2009: posts small blind 50
s70n3fac3: posts big blind 100
*** HOLE CARDS ***
FDIBA2009: raises 100 to 200
s70n3fac3: raises 400 to 600
FDIBA2009: calls 400
*** FLOP *** [2h 9h 5h]
s70n3fac3: checks 
FDIBA2009: checks 
*** TURN *** [2h 9h 5h] [Kh]
s70n3fac3: bets 400
FDIBA2009: calls 400
*** RIVER *** [2h 9h 5h Kh] [Ac]
s70n3fac3: bets 850
FDIBA2009: calls 850
*** SHOW DOWN ***
s70n3fac3: shows [Ah 8h] (a flush, Ace high)
FDIBA2009: mucks hand 
s70n3fac3 collected 3496 from pot
*** SUMMARY ***
Total pot 3700 | Rake 204 
Board [2h 9h 5h Kh Ac]
Seat 1: s70n3fac3 (big blind) showed [Ah 8h] and won (3496) with a flush, Ace high
Seat 2: FDIBA2009 (button) (small blind) mucked [6h Th]



PokerStars Home Game Hand #226758489557: {Club #4781089}  Hold'em No Limit (50/100) - 2021/05/15 0:20:42 EET [2021/05/14 17:20:42 ET]
Table 'VTTP NLHE' 2-max (Play Money) Seat #1 is the button
Seat 1: s70n3fac3 (8210 in chips) 
Seat 2: FDIBA2009 (7527 in chips) 
s70n3fac3: posts small blind 50
FDIBA2009: posts big blind 100
*** HOLE CARDS ***
s70n3fac3: folds 
Uncalled bet (50) returned to FDIBA2009
FDIBA2009 collected 100 from pot
*** SUMMARY ***
Total pot 100 | Rake 0 
Seat 1: s70n3fac3 (button) (small blind) folded before Flop
Seat 2: FDIBA2009 (big blind) collected (100)



PokerStars Home Game Hand #226758493488: {Club #4781089}  Hold'em No Limit (50/100) - 2021/05/15 0:20:48 EET [2021/05/14 17:20:48 ET]
Table 'VTTP NLHE' 2-max (Play Money) Seat #2 is the button
Seat 1: s70n3fac3 (8160 in chips) 
Seat 2: FDIBA2009 (7577 in chips) 
FDIBA2009: posts small blind 50
s70n3fac3: posts big blind 100
*** HOLE CARDS ***
FDIBA2009: raises 100 to 200
s70n3fac3: calls 100
*** FLOP *** [8h 4s 7h]
s70n3fac3: bets 200
FDIBA2009: calls 200
*** TURN *** [8h 4s 7h] [2d]
s70n3fac3: checks 
FDIBA2009: checks 
*** RIVER *** [8h 4s 7h 2d] [As]
s70n3fac3: bets 300
FDIBA2009: calls 300
*** SHOW DOWN ***
s70n3fac3: shows [Qs 7c] (a pair of Sevens)
FDIBA2009: shows [Kc 8s] (a pair of Eights)
FDIBA2009 collected 1323 from pot
*** SUMMARY ***
Total pot 1400 | Rake 77 
Board [8h 4s 7h 2d As]
Seat 1: s70n3fac3 (big blind) showed [Qs 7c] and lost with a pair of Sevens
Seat 2: FDIBA2009 (button) (small blind) showed [Kc 8s] and won (1323) with a pair of Eights



PokerStars Home Game Hand #226758508133: {Club #4781089}  Hold'em No Limit (50/100) - 2021/05/15 0:21:13 EET [2021/05/14 17:21:13 ET]
Table 'VTTP NLHE' 2-max (Play Money) Seat #1 is the button
Seat 1: s70n3fac3 (7460 in chips) 
Seat 2: FDIBA2009 (8200 in chips) 
s70n3fac3: posts small blind 50
FDIBA2009: posts big blind 100
*** HOLE CARDS ***
s70n3fac3: raises 100 to 200
FDIBA2009: calls 100
*** FLOP *** [Jd Ac Js]
FDIBA2009: checks 
s70n3fac3: checks 
*** TURN *** [Jd Ac Js] [8s]
FDIBA2009: checks 
s70n3fac3: bets 200
FDIBA2009: folds 
Uncalled bet (200) returned to s70n3fac3
s70n3fac3 collected 378 from pot
s70n3fac3: doesn't show hand 
*** SUMMARY ***
Total pot 400 | Rake 22 
Board [Jd Ac Js 8s]
Seat 1: s70n3fac3 (button) (small blind) collected (378)
Seat 2: FDIBA2009 (big blind) folded on the Turn



PokerStars Home Game Hand #226758522140: {Club #4781089}  Hold'em No Limit (50/100) - 2021/05/15 0:21:37 EET [2021/05/14 17:21:37 ET]
Table 'VTTP NLHE' 2-max (Play Money) Seat #2 is the button
Seat 1: s70n3fac3 (7638 in chips) 
Seat 2: FDIBA2009 (8000 in chips) 
FDIBA2009: posts small blind 50
s70n3fac3: posts big blind 100
*** HOLE CARDS ***
FDIBA2009: raises 100 to 200
s70n3fac3: calls 100
*** FLOP *** [7d 8s 7h]
s70n3fac3: checks 
FDIBA2009: checks 
*** TURN *** [7d 8s 7h] [5c]
s70n3fac3: bets 200
FDIBA2009: folds 
Uncalled bet (200) returned to s70n3fac3
s70n3fac3 collected 378 from pot
s70n3fac3: doesn't show hand 
*** SUMMARY ***
Total pot 400 | Rake 22 
Board [7d 8s 7h 5c]
Seat 1: s70n3fac3 (big blind) collected (378)
Seat 2: FDIBA2009 (button) (small blind) folded on the Turn



PokerStars Home Game Hand #226758530084: {Club #4781089}  Hold'em No Limit (50/100) - 2021/05/15 0:21:50 EET [2021/05/14 17:21:50 ET]
Table 'VTTP NLHE' 2-max (Play Money) Seat #1 is the button
Seat 1: s70n3fac3 (7816 in chips) 
Seat 2: FDIBA2009 (7800 in chips) 
s70n3fac3: posts small blind 50
FDIBA2009: posts big blind 100
*** HOLE CARDS ***
s70n3fac3: raises 100 to 200
FDIBA2009: raises 100 to 300
s70n3fac3: calls 100
*** FLOP *** [6s 7h 9d]
FDIBA2009: bets 567
s70n3fac3: calls 567
*** TURN *** [6s 7h 9d] [Ks]
FDIBA2009: bets 1639
s70n3fac3: folds 
Uncalled bet (1639) returned to FDIBA2009
FDIBA2009 collected 1639 from pot
*** SUMMARY ***
Total pot 1734 | Rake 95 
Board [6s 7h 9d Ks]
Seat 1: s70n3fac3 (button) (small blind) folded on the Turn
Seat 2: FDIBA2009 (big blind) collected (1639)



PokerStars Home Game Hand #226758545195: {Club #4781089}  Hold'em No Limit (50/100) - 2021/05/15 0:22:15 EET [2021/05/14 17:22:15 ET]
Table 'VTTP NLHE' 2-max (Play Money) Seat #2 is the button
Seat 1: s70n3fac3 (6949 in chips) 
Seat 2: FDIBA2009 (8572 in chips) 
FDIBA2009: posts small blind 50
s70n3fac3: posts big blind 100
*** HOLE CARDS ***
FDIBA2009: raises 100 to 200
s70n3fac3: folds 
Uncalled bet (100) returned to FDIBA2009
FDIBA2009 collected 200 from pot
*** SUMMARY ***
Total pot 200 | Rake 0 
Seat 1: s70n3fac3 (big blind) folded before Flop
Seat 2: FDIBA2009 (button) (small blind) collected (200)



PokerStars Home Game Hand #226758550519: {Club #4781089}  Hold'em No Limit (50/100) - 2021/05/15 0:22:24 EET [2021/05/14 17:22:24 ET]
Table 'VTTP NLHE' 2-max (Play Money) Seat #1 is the button
Seat 1: s70n3fac3 (6849 in chips) 
Seat 2: FDIBA2009 (8672 in chips) 
s70n3fac3: posts small blind 50
FDIBA2009: posts big blind 100
*** HOLE CARDS ***
s70n3fac3: raises 100 to 200
FDIBA2009: folds 
Uncalled bet (100) returned to s70n3fac3
s70n3fac3 collected 200 from pot
s70n3fac3: doesn't show hand 
*** SUMMARY ***
Total pot 200 | Rake 0 
Seat 1: s70n3fac3 (button) (small blind) collected (200)
Seat 2: FDIBA2009 (big blind) folded before Flop



PokerStars Home Game Hand #226758555591: {Club #4781089}  Hold'em No Limit (50/100) - 2021/05/15 0:22:33 EET [2021/05/14 17:22:33 ET]
Table 'VTTP NLHE' 2-max (Play Money) Seat #2 is the button
Seat 1: s70n3fac3 (6949 in chips) 
Seat 2: FDIBA2009 (8572 in chips) 
FDIBA2009: posts small blind 50
s70n3fac3: posts big blind 100
*** HOLE CARDS ***
FDIBA2009: raises 100 to 200
s70n3fac3: folds 
Uncalled bet (100) returned to FDIBA2009
FDIBA2009 collected 200 from pot
*** SUMMARY ***
Total pot 200 | Rake 0 
Seat 1: s70n3fac3 (big blind) folded before Flop
Seat 2: FDIBA2009 (button) (small blind) collected (200)



PokerStars Home Game Hand #226758560882: {Club #4781089}  Hold'em No Limit (50/100) - 2021/05/15 0:22:42 EET [2021/05/14 17:22:42 ET]
Table 'VTTP NLHE' 2-max (Play Money) Seat #1 is the button
Seat 1: s70n3fac3 (6849 in chips) 
Seat 2: FDIBA2009 (8672 in chips) 
s70n3fac3: posts small blind 50
FDIBA2009: posts big blind 100
*** HOLE CARDS ***
s70n3fac3: folds 
Uncalled bet (50) returned to FDIBA2009
FDIBA2009 collected 100 from pot
*** SUMMARY ***
Total pot 100 | Rake 0 
Seat 1: s70n3fac3 (button) (small blind) folded before Flop
Seat 2: FDIBA2009 (big blind) collected (100)



PokerStars Home Game Hand #226758563323: {Club #4781089}  Hold'em No Limit (50/100) - 2021/05/15 0:22:46 EET [2021/05/14 17:22:46 ET]
Table 'VTTP NLHE' 2-max (Play Money) Seat #2 is the button
Seat 1: s70n3fac3 (6799 in chips) 
Seat 2: FDIBA2009 (8722 in chips) 
FDIBA2009: posts small blind 50
s70n3fac3: posts big blind 100
*** HOLE CARDS ***
FDIBA2009: raises 100 to 200
s70n3fac3: folds 
Uncalled bet (100) returned to FDIBA2009
FDIBA2009 collected 200 from pot
*** SUMMARY ***
Total pot 200 | Rake 0 
Seat 1: s70n3fac3 (big blind) folded before Flop
Seat 2: FDIBA2009 (button) (small blind) collected (200)



PokerStars Home Game Hand #226758567787: {Club #4781089}  Hold'em No Limit (50/100) - 2021/05/15 0:22:53 EET [2021/05/14 17:22:53 ET]
Table 'VTTP NLHE' 2-max (Play Money) Seat #1 is the button
Seat 1: s70n3fac3 (6699 in chips) 
Seat 2: FDIBA2009 (8822 in chips) 
s70n3fac3: posts small blind 50
FDIBA2009: posts big blind 100
*** HOLE CARDS ***
s70n3fac3: raises 100 to 200
FDIBA2009: calls 100
*** FLOP *** [3h As 2h]
FDIBA2009: checks 
s70n3fac3: checks 
*** TURN *** [3h As 2h] [8s]
FDIBA2009: checks 
s70n3fac3: bets 200
FDIBA2009: calls 200
*** RIVER *** [3h As 2h 8s] [Qh]
FDIBA2009: checks 
s70n3fac3: bets 400
FDIBA2009: calls 400
*** SHOW DOWN ***
s70n3fac3: shows [7s 5c] (high card Ace)
FDIBA2009: shows [7h Ac] (a pair of Aces)
FDIBA2009 collected 1512 from pot
*** SUMMARY ***
Total pot 1600 | Rake 88 
Board [3h As 2h 8s Qh]
Seat 1: s70n3fac3 (button) (small blind) showed [7s 5c] and lost with high card Ace
Seat 2: FDIBA2009 (big blind) showed [7h Ac] and won (1512) with a pair of Aces



PokerStars Home Game Hand #226758588334: {Club #4781089}  Hold'em No Limit (50/100) - 2021/05/15 0:23:28 EET [2021/05/14 17:23:28 ET]
Table 'VTTP NLHE' 2-max (Play Money) Seat #2 is the button
Seat 1: s70n3fac3 (5899 in chips) 
Seat 2: FDIBA2009 (9534 in chips) 
FDIBA2009: posts small blind 50
s70n3fac3: posts big blind 100
*** HOLE CARDS ***
FDIBA2009: raises 100 to 200
s70n3fac3: calls 100
*** FLOP *** [4h 4d Js]
s70n3fac3: checks 
FDIBA2009: bets 378
s70n3fac3: folds 
Uncalled bet (378) returned to FDIBA2009
FDIBA2009 collected 378 from pot
*** SUMMARY ***
Total pot 400 | Rake 22 
Board [4h 4d Js]
Seat 1: s70n3fac3 (big blind) folded on the Flop
Seat 2: FDIBA2009 (button) (small blind) collected (378)



PokerStars Home Game Hand #226758596143: {Club #4781089}  Hold'em No Limit (50/100) - 2021/05/15 0:23:41 EET [2021/05/14 17:23:41 ET]
Table 'VTTP NLHE' 2-max (Play Money) Seat #1 is the button
Seat 1: s70n3fac3 (5699 in chips) 
Seat 2: FDIBA2009 (9712 in chips) 
s70n3fac3: posts small blind 50
FDIBA2009: posts big blind 100
*** HOLE CARDS ***
s70n3fac3: folds 
Uncalled bet (50) returned to FDIBA2009
FDIBA2009 collected 100 from pot
*** SUMMARY ***
Total pot 100 | Rake 0 
Seat 1: s70n3fac3 (button) (small blind) folded before Flop
Seat 2: FDIBA2009 (big blind) collected (100)



PokerStars Home Game Hand #226758598448: {Club #4781089}  Hold'em No Limit (50/100) - 2021/05/15 0:23:45 EET [2021/05/14 17:23:45 ET]
Table 'VTTP NLHE' 2-max (Play Money) Seat #2 is the button
Seat 1: s70n3fac3 (5649 in chips) 
Seat 2: FDIBA2009 (9762 in chips) 
FDIBA2009: posts small blind 50
s70n3fac3: posts big blind 100
*** HOLE CARDS ***
FDIBA2009: raises 100 to 200
s70n3fac3: calls 100
*** FLOP *** [7s Qs 7c]
s70n3fac3: checks 
FDIBA2009: checks 
*** TURN *** [7s Qs 7c] [9d]
s70n3fac3: checks 
FDIBA2009: bets 378
s70n3fac3: calls 378
*** RIVER *** [7s Qs 7c 9d] [Tc]
s70n3fac3: checks 
FDIBA2009: checks 
*** SHOW DOWN ***
s70n3fac3: shows [5c Ac] (a pair of Sevens)
FDIBA2009: shows [Td 2h] (two pair, Tens and Sevens)
FDIBA2009 collected 1092 from pot
*** SUMMARY ***
Total pot 1156 | Rake 64 
Board [7s Qs 7c 9d Tc]
Seat 1: s70n3fac3 (big blind) showed [5c Ac] and lost with a pair of Sevens
Seat 2: FDIBA2009 (button) (small blind) showed [Td 2h] and won (1092) with two pair, Tens and Sevens



PokerStars Home Game Hand #226758616318: {Club #4781089}  Hold'em No Limit (50/100) - 2021/05/15 0:24:15 EET [2021/05/14 17:24:15 ET]
Table 'VTTP NLHE' 2-max (Play Money) Seat #1 is the button
Seat 1: s70n3fac3 (5071 in chips) 
Seat 2: FDIBA2009 (10276 in chips) 
s70n3fac3: posts small blind 50
FDIBA2009: posts big blind 100
*** HOLE CARDS ***
s70n3fac3: folds 
Uncalled bet (50) returned to FDIBA2009
FDIBA2009 collected 100 from pot
*** SUMMARY ***
Total pot 100 | Rake 0 
Seat 1: s70n3fac3 (button) (small blind) folded before Flop
Seat 2: FDIBA2009 (big blind) collected (100)



PokerStars Home Game Hand #226758619146: {Club #4781089}  Hold'em No Limit (50/100) - 2021/05/15 0:24:20 EET [2021/05/14 17:24:20 ET]
Table 'VTTP NLHE' 2-max (Play Money) Seat #2 is the button
Seat 1: s70n3fac3 (5021 in chips) 
Seat 2: FDIBA2009 (10326 in chips) 
FDIBA2009: posts small blind 50
s70n3fac3: posts big blind 100
*** HOLE CARDS ***
FDIBA2009: raises 100 to 200
s70n3fac3: calls 100
*** FLOP *** [4d 2h 8s]
s70n3fac3: checks 
FDIBA2009: bets 378
s70n3fac3: calls 378
*** TURN *** [4d 2h 8s] [5c]
s70n3fac3: checks 
FDIBA2009: bets 546
s70n3fac3: folds 
Uncalled bet (546) returned to FDIBA2009
FDIBA2009 collected 1092 from pot
*** SUMMARY ***
Total pot 1156 | Rake 64 
Board [4d 2h 8s 5c]
Seat 1: s70n3fac3 (big blind) folded on the Turn
Seat 2: FDIBA2009 (button) (small blind) collected (1092)



PokerStars Home Game Hand #226758633018: {Club #4781089}  Hold'em No Limit (50/100) - 2021/05/15 0:24:43 EET [2021/05/14 17:24:43 ET]
Table 'VTTP NLHE' 2-max (Play Money) Seat #1 is the button
Seat 1: s70n3fac3 (4443 in chips) 
Seat 2: FDIBA2009 (10840 in chips) 
s70n3fac3: posts small blind 50
FDIBA2009: posts big blind 100
*** HOLE CARDS ***
s70n3fac3: raises 100 to 200
FDIBA2009: calls 100
*** FLOP *** [Qd Jh 7s]
FDIBA2009: checks 
s70n3fac3: checks 
*** TURN *** [Qd Jh 7s] [Jc]
FDIBA2009: checks 
s70n3fac3: checks 
*** RIVER *** [Qd Jh 7s Jc] [5c]
FDIBA2009: bets 378
s70n3fac3: folds 
Uncalled bet (378) returned to FDIBA2009
FDIBA2009 collected 378 from pot
*** SUMMARY ***
Total pot 400 | Rake 22 
Board [Qd Jh 7s Jc 5c]
Seat 1: s70n3fac3 (button) (small blind) folded on the River
Seat 2: FDIBA2009 (big blind) collected (378)



PokerStars Home Game Hand #226758646523: {Club #4781089}  Hold'em No Limit (50/100) - 2021/05/15 0:25:06 EET [2021/05/14 17:25:06 ET]
Table 'VTTP NLHE' 2-max (Play Money) Seat #2 is the button
Seat 1: s70n3fac3 (4243 in chips) 
Seat 2: FDIBA2009 (11018 in chips) 
FDIBA2009: posts small blind 50
s70n3fac3: posts big blind 100
*** HOLE CARDS ***
FDIBA2009: raises 100 to 200
s70n3fac3: raises 500 to 700
FDIBA2009: calls 500
*** FLOP *** [5s Ad Kc]
s70n3fac3: bets 700
FDIBA2009: folds 
Uncalled bet (700) returned to s70n3fac3
s70n3fac3 collected 1323 from pot
s70n3fac3: doesn't show hand 
*** SUMMARY ***
Total pot 1400 | Rake 77 
Board [5s Ad Kc]
Seat 1: s70n3fac3 (big blind) collected (1323)
Seat 2: FDIBA2009 (button) (small blind) folded on the Flop



PokerStars Home Game Hand #226758656795: {Club #4781089}  Hold'em No Limit (50/100) - 2021/05/15 0:25:23 EET [2021/05/14 17:25:23 ET]
Table 'VTTP NLHE' 2-max (Play Money) Seat #1 is the button
Seat 1: s70n3fac3 (4866 in chips) 
Seat 2: FDIBA2009 (10318 in chips) 
s70n3fac3: posts small blind 50
FDIBA2009: posts big blind 100
*** HOLE CARDS ***
s70n3fac3: folds 
Uncalled bet (50) returned to FDIBA2009
FDIBA2009 collected 100 from pot
*** SUMMARY ***
Total pot 100 | Rake 0 
Seat 1: s70n3fac3 (button) (small blind) folded before Flop
Seat 2: FDIBA2009 (big blind) collected (100)



PokerStars Home Game Hand #226758659171: {Club #4781089}  Hold'em No Limit (50/100) - 2021/05/15 0:25:27 EET [2021/05/14 17:25:27 ET]
Table 'VTTP NLHE' 2-max (Play Money) Seat #2 is the button
Seat 1: s70n3fac3 (4816 in chips) 
Seat 2: FDIBA2009 (10368 in chips) 
FDIBA2009: posts small blind 50
s70n3fac3: posts big blind 100
*** HOLE CARDS ***
FDIBA2009: raises 100 to 200
s70n3fac3: raises 500 to 700
FDIBA2009: folds 
Uncalled bet (500) returned to s70n3fac3
s70n3fac3 collected 400 from pot
s70n3fac3: doesn't show hand 
*** SUMMARY ***
Total pot 400 | Rake 0 
Seat 1: s70n3fac3 (big blind) collected (400)
Seat 2: FDIBA2009 (button) (small blind) folded before Flop



PokerStars Home Game Hand #226758664300: {Club #4781089}  Hold'em No Limit (50/100) - 2021/05/15 0:25:36 EET [2021/05/14 17:25:36 ET]
Table 'VTTP NLHE' 2-max (Play Money) Seat #1 is the button
Seat 1: s70n3fac3 (5016 in chips) 
Seat 2: FDIBA2009 (10168 in chips) 
s70n3fac3: posts small blind 50
FDIBA2009: posts big blind 100
*** HOLE CARDS ***
s70n3fac3: raises 100 to 200
FDIBA2009: calls 100
*** FLOP *** [Js 6c 3d]
FDIBA2009: checks 
s70n3fac3: checks 
*** TURN *** [Js 6c 3d] [2h]
FDIBA2009: checks 
s70n3fac3: checks 
*** RIVER *** [Js 6c 3d 2h] [As]
FDIBA2009: checks 
s70n3fac3: checks 
*** SHOW DOWN ***
FDIBA2009: shows [Kc 2s] (a pair of Deuces)
s70n3fac3: mucks hand 
FDIBA2009 collected 378 from pot
*** SUMMARY ***
Total pot 400 | Rake 22 
Board [Js 6c 3d 2h As]
Seat 1: s70n3fac3 (button) (small blind) mucked [Kh 9h]
Seat 2: FDIBA2009 (big blind) showed [Kc 2s] and won (378) with a pair of Deuces



PokerStars Home Game Hand #226758679642: {Club #4781089}  Hold'em No Limit (50/100) - 2021/05/15 0:26:02 EET [2021/05/14 17:26:02 ET]
Table 'VTTP NLHE' 2-max (Play Money) Seat #2 is the button
Seat 1: s70n3fac3 (4816 in chips) 
Seat 2: FDIBA2009 (10346 in chips) 
FDIBA2009: posts small blind 50
s70n3fac3: posts big blind 100
*** HOLE CARDS ***
FDIBA2009: raises 100 to 200
s70n3fac3: calls 100
*** FLOP *** [5s 8c 8s]
s70n3fac3: checks 
FDIBA2009: bets 378
s70n3fac3: folds 
Uncalled bet (378) returned to FDIBA2009
FDIBA2009 collected 378 from pot
*** SUMMARY ***
Total pot 400 | Rake 22 
Board [5s 8c 8s]
Seat 1: s70n3fac3 (big blind) folded on the Flop
Seat 2: FDIBA2009 (button) (small blind) collected (378)



PokerStars Home Game Hand #226758687891: {Club #4781089}  Hold'em No Limit (50/100) - 2021/05/15 0:26:16 EET [2021/05/14 17:26:16 ET]
Table 'VTTP NLHE' 2-max (Play Money) Seat #1 is the button
Seat 1: s70n3fac3 (4616 in chips) 
Seat 2: FDIBA2009 (10524 in chips) 
s70n3fac3: posts small blind 50
FDIBA2009: posts big blind 100
*** HOLE CARDS ***
s70n3fac3: raises 100 to 200
FDIBA2009: calls 100
*** FLOP *** [6s 3h 8d]
FDIBA2009: checks 
s70n3fac3: bets 200
FDIBA2009: calls 200
*** TURN *** [6s 3h 8d] [9d]
FDIBA2009: checks 
s70n3fac3: checks 
*** RIVER *** [6s 3h 8d 9d] [4d]
FDIBA2009: checks 
s70n3fac3: checks 
*** SHOW DOWN ***
FDIBA2009: shows [4c 7c] (a pair of Fours)
s70n3fac3: mucks hand 
FDIBA2009 collected 756 from pot
*** SUMMARY ***
Total pot 800 | Rake 44 
Board [6s 3h 8d 9d 4d]
Seat 1: s70n3fac3 (button) (small blind) mucked [3s Kh]
Seat 2: FDIBA2009 (big blind) showed [4c 7c] and won (756) with a pair of Fours



PokerStars Home Game Hand #226758705194: {Club #4781089}  Hold'em No Limit (50/100) - 2021/05/15 0:26:46 EET [2021/05/14 17:26:46 ET]
Table 'VTTP NLHE' 2-max (Play Money) Seat #2 is the button
Seat 1: s70n3fac3 (4216 in chips) 
Seat 2: FDIBA2009 (10880 in chips) 
FDIBA2009: posts small blind 50
s70n3fac3: posts big blind 100
*** HOLE CARDS ***
FDIBA2009: raises 100 to 200
s70n3fac3: folds 
Uncalled bet (100) returned to FDIBA2009
FDIBA2009 collected 200 from pot
*** SUMMARY ***
Total pot 200 | Rake 0 
Seat 1: s70n3fac3 (big blind) folded before Flop
Seat 2: FDIBA2009 (button) (small blind) collected (200)



PokerStars Home Game Hand #226758710602: {Club #4781089}  Hold'em No Limit (50/100) - 2021/05/15 0:26:55 EET [2021/05/14 17:26:55 ET]
Table 'VTTP NLHE' 2-max (Play Money) Seat #1 is the button
Seat 1: s70n3fac3 (4116 in chips) 
Seat 2: FDIBA2009 (10980 in chips) 
s70n3fac3: posts small blind 50
FDIBA2009: posts big blind 100
*** HOLE CARDS ***
s70n3fac3: raises 150 to 250
FDIBA2009: raises 10730 to 10980 and is all-in
s70n3fac3: folds 
Uncalled bet (10730) returned to FDIBA2009
FDIBA2009 collected 500 from pot
*** SUMMARY ***
Total pot 500 | Rake 0 
Seat 1: s70n3fac3 (button) (small blind) folded before Flop
Seat 2: FDIBA2009 (big blind) collected (500)



PokerStars Home Game Hand #226758717297: {Club #4781089}  Hold'em No Limit (50/100) - 2021/05/15 0:27:06 EET [2021/05/14 17:27:06 ET]
Table 'VTTP NLHE' 2-max (Play Money) Seat #2 is the button
Seat 1: s70n3fac3 (3866 in chips) 
Seat 2: FDIBA2009 (11230 in chips) 
FDIBA2009: posts small blind 50
s70n3fac3: posts big blind 100
*** HOLE CARDS ***
FDIBA2009: raises 200 to 300
s70n3fac3: calls 200
*** FLOP *** [Ah 4d 8h]
s70n3fac3: checks 
FDIBA2009: checks 
*** TURN *** [Ah 4d 8h] [Kh]
s70n3fac3: checks 
FDIBA2009: bets 567
s70n3fac3: folds 
Uncalled bet (567) returned to FDIBA2009
FDIBA2009 collected 567 from pot
*** SUMMARY ***
Total pot 600 | Rake 33 
Board [Ah 4d 8h Kh]
Seat 1: s70n3fac3 (big blind) folded on the Turn
Seat 2: FDIBA2009 (button) (small blind) collected (567)



PokerStars Home Game Hand #226758733633: {Club #4781089}  Hold'em No Limit (50/100) - 2021/05/15 0:27:34 EET [2021/05/14 17:27:34 ET]
Table 'VTTP NLHE' 2-max (Play Money) Seat #1 is the button
Seat 1: s70n3fac3 (3566 in chips) 
Seat 2: FDIBA2009 (11497 in chips) 
s70n3fac3: posts small blind 50
FDIBA2009: posts big blind 100
*** HOLE CARDS ***
s70n3fac3: folds 
Uncalled bet (50) returned to FDIBA2009
FDIBA2009 collected 100 from pot
*** SUMMARY ***
Total pot 100 | Rake 0 
Seat 1: s70n3fac3 (button) (small blind) folded before Flop
Seat 2: FDIBA2009 (big blind) collected (100)



PokerStars Home Game Hand #226758735793: {Club #4781089}  Hold'em No Limit (50/100) - 2021/05/15 0:27:38 EET [2021/05/14 17:27:38 ET]
Table 'VTTP NLHE' 2-max (Play Money) Seat #2 is the button
Seat 1: s70n3fac3 (3516 in chips) 
Seat 2: FDIBA2009 (11547 in chips) 
FDIBA2009: posts small blind 50
s70n3fac3: posts big blind 100
*** HOLE CARDS ***
FDIBA2009: calls 50
s70n3fac3: raises 200 to 300
FDIBA2009: folds 
Uncalled bet (200) returned to s70n3fac3
s70n3fac3 collected 200 from pot
s70n3fac3: doesn't show hand 
*** SUMMARY ***
Total pot 200 | Rake 0 
Seat 1: s70n3fac3 (big blind) collected (200)
Seat 2: FDIBA2009 (button) (small blind) folded before Flop



PokerStars Home Game Hand #226758743046: {Club #4781089}  Hold'em No Limit (50/100) - 2021/05/15 0:27:50 EET [2021/05/14 17:27:50 ET]
Table 'VTTP NLHE' 2-max (Play Money) Seat #1 is the button
Seat 1: s70n3fac3 (3616 in chips) 
Seat 2: FDIBA2009 (11447 in chips) 
s70n3fac3: posts small blind 50
FDIBA2009: posts big blind 100
*** HOLE CARDS ***
s70n3fac3: raises 100 to 200
FDIBA2009: calls 100
*** FLOP *** [4d 3d 9s]
FDIBA2009: checks 
s70n3fac3: bets 250
FDIBA2009: folds 
Uncalled bet (250) returned to s70n3fac3
s70n3fac3 collected 378 from pot
s70n3fac3: doesn't show hand 
*** SUMMARY ***
Total pot 400 | Rake 22 
Board [4d 3d 9s]
Seat 1: s70n3fac3 (button) (small blind) collected (378)
Seat 2: FDIBA2009 (big blind) folded on the Flop



PokerStars Home Game Hand #226758759184: {Club #4781089}  Hold'em No Limit (50/100) - 2021/05/15 0:28:17 EET [2021/05/14 17:28:17 ET]
Table 'VTTP NLHE' 2-max (Play Money) Seat #2 is the button
Seat 1: s70n3fac3 (3794 in chips) 
Seat 2: FDIBA2009 (11247 in chips) 
FDIBA2009: posts small blind 50
s70n3fac3: posts big blind 100
*** HOLE CARDS ***
FDIBA2009: raises 100 to 200
s70n3fac3: folds 
Uncalled bet (100) returned to FDIBA2009
FDIBA2009 collected 200 from pot
*** SUMMARY ***
Total pot 200 | Rake 0 
Seat 1: s70n3fac3 (big blind) folded before Flop
Seat 2: FDIBA2009 (button) (small blind) collected (200)



PokerStars Home Game Hand #226758765027: {Club #4781089}  Hold'em No Limit (50/100) - 2021/05/15 0:28:28 EET [2021/05/14 17:28:28 ET]
Table 'VTTP NLHE' 2-max (Play Money) Seat #1 is the button
Seat 1: s70n3fac3 (3694 in chips) 
Seat 2: FDIBA2009 (11347 in chips) 
s70n3fac3: posts small blind 50
FDIBA2009: posts big blind 100
*** HOLE CARDS ***
s70n3fac3: folds 
Uncalled bet (50) returned to FDIBA2009
FDIBA2009 collected 100 from pot
*** SUMMARY ***
Total pot 100 | Rake 0 
Seat 1: s70n3fac3 (button) (small blind) folded before Flop
Seat 2: FDIBA2009 (big blind) collected (100)



PokerStars Home Game Hand #226758767233: {Club #4781089}  Hold'em No Limit (50/100) - 2021/05/15 0:28:31 EET [2021/05/14 17:28:31 ET]
Table 'VTTP NLHE' 2-max (Play Money) Seat #2 is the button
Seat 1: s70n3fac3 (3644 in chips) 
Seat 2: FDIBA2009 (11397 in chips) 
FDIBA2009: posts small blind 50
s70n3fac3: posts big blind 100
*** HOLE CARDS ***
FDIBA2009: raises 100 to 200
s70n3fac3: calls 100
*** FLOP *** [8h Th As]
s70n3fac3: checks 
FDIBA2009: checks 
*** TURN *** [8h Th As] [Ts]
s70n3fac3: checks 
FDIBA2009: checks 
*** RIVER *** [8h Th As Ts] [7s]
s70n3fac3: checks 
FDIBA2009: checks 
*** SHOW DOWN ***
s70n3fac3: shows [Qc 3c] (a pair of Tens)
FDIBA2009: mucks hand 
s70n3fac3 collected 378 from pot
*** SUMMARY ***
Total pot 400 | Rake 22 
Board [8h Th As Ts 7s]
Seat 1: s70n3fac3 (big blind) showed [Qc 3c] and won (378) with a pair of Tens
Seat 2: FDIBA2009 (button) (small blind) mucked [2c 3h]



PokerStars Home Game Hand #226758794626: {Club #4781089}  Hold'em No Limit (50/100) - 2021/05/15 0:29:04 EET [2021/05/14 17:29:04 ET]
Table 'VTTP NLHE' 2-max (Play Money) Seat #1 is the button
Seat 1: s70n3fac3 (3822 in chips) 
Seat 2: FDIBA2009 (11197 in chips) 
s70n3fac3: posts small blind 50
FDIBA2009: posts big blind 100
*** HOLE CARDS ***
s70n3fac3: raises 100 to 200
FDIBA2009: calls 100
*** FLOP *** [5s 7c 9h]
FDIBA2009: bets 189
s70n3fac3: calls 189
*** TURN *** [5s 7c 9h] [As]
FDIBA2009: bets 1235
s70n3fac3: folds 
Uncalled bet (1235) returned to FDIBA2009
FDIBA2009 collected 735 from pot
*** SUMMARY ***
Total pot 778 | Rake 43 
Board [5s 7c 9h As]
Seat 1: s70n3fac3 (button) (small blind) folded on the Turn
Seat 2: FDIBA2009 (big blind) collected (735)



PokerStars Home Game Hand #226758818485: {Club #4781089}  Hold'em No Limit (50/100) - 2021/05/15 0:29:45 EET [2021/05/14 17:29:45 ET]
Table 'VTTP NLHE' 2-max (Play Money) Seat #2 is the button
Seat 1: s70n3fac3 (3433 in chips) 
Seat 2: FDIBA2009 (11543 in chips) 
FDIBA2009: posts small blind 50
s70n3fac3: posts big blind 100
*** HOLE CARDS ***
FDIBA2009: folds 
Uncalled bet (50) returned to s70n3fac3
s70n3fac3 collected 100 from pot
s70n3fac3: doesn't show hand 
*** SUMMARY ***
Total pot 100 | Rake 0 
Seat 1: s70n3fac3 (big blind) collected (100)
Seat 2: FDIBA2009 (button) (small blind) folded before Flop



PokerStars Home Game Hand #226758821219: {Club #4781089}  Hold'em No Limit (50/100) - 2021/05/15 0:29:50 EET [2021/05/14 17:29:50 ET]
Table 'VTTP NLHE' 2-max (Play Money) Seat #1 is the button
Seat 1: s70n3fac3 (3483 in chips) 
Seat 2: FDIBA2009 (11493 in chips) 
s70n3fac3: posts small blind 50
FDIBA2009: posts big blind 100
*** HOLE CARDS ***
s70n3fac3: folds 
Uncalled bet (50) returned to FDIBA2009
FDIBA2009 collected 100 from pot
*** SUMMARY ***
Total pot 100 | Rake 0 
Seat 1: s70n3fac3 (button) (small blind) folded before Flop
Seat 2: FDIBA2009 (big blind) collected (100)



PokerStars Home Game Hand #226758823538: {Club #4781089}  Hold'em No Limit (50/100) - 2021/05/15 0:29:54 EET [2021/05/14 17:29:54 ET]
Table 'VTTP NLHE' 2-max (Play Money) Seat #2 is the button
Seat 1: s70n3fac3 (3433 in chips) 
Seat 2: FDIBA2009 (11543 in chips) 
FDIBA2009: posts small blind 50
s70n3fac3: posts big blind 100
*** HOLE CARDS ***
FDIBA2009: folds 
Uncalled bet (50) returned to s70n3fac3
s70n3fac3 collected 100 from pot
s70n3fac3: doesn't show hand 
*** SUMMARY ***
Total pot 100 | Rake 0 
Seat 1: s70n3fac3 (big blind) collected (100)
Seat 2: FDIBA2009 (button) (small blind) folded before Flop



PokerStars Home Game Hand #226758829484: {Club #4781089}  Hold'em No Limit (50/100) - 2021/05/15 0:30:04 EET [2021/05/14 17:30:04 ET]
Table 'VTTP NLHE' 2-max (Play Money) Seat #1 is the button
Seat 1: s70n3fac3 (3483 in chips) 
Seat 2: FDIBA2009 (11493 in chips) 
s70n3fac3: posts small blind 50
FDIBA2009: posts big blind 100
*** HOLE CARDS ***
s70n3fac3: raises 100 to 200
FDIBA2009: calls 100
*** FLOP *** [Ac 5s 6s]
FDIBA2009: checks 
s70n3fac3: bets 200
FDIBA2009: folds 
Uncalled bet (200) returned to s70n3fac3
s70n3fac3 collected 378 from pot
s70n3fac3: doesn't show hand 
*** SUMMARY ***
Total pot 400 | Rake 22 
Board [Ac 5s 6s]
Seat 1: s70n3fac3 (button) (small blind) collected (378)
Seat 2: FDIBA2009 (big blind) folded on the Flop



PokerStars Home Game Hand #226758845387: {Club #4781089}  Hold'em No Limit (50/100) - 2021/05/15 0:30:32 EET [2021/05/14 17:30:32 ET]
Table 'VTTP NLHE' 2-max (Play Money) Seat #2 is the button
Seat 1: s70n3fac3 (3661 in chips) 
Seat 2: FDIBA2009 (11293 in chips) 
FDIBA2009: posts small blind 50
s70n3fac3: posts big blind 100
*** HOLE CARDS ***
FDIBA2009: folds 
Uncalled bet (50) returned to s70n3fac3
s70n3fac3 collected 100 from pot
s70n3fac3: doesn't show hand 
*** SUMMARY ***
Total pot 100 | Rake 0 
Seat 1: s70n3fac3 (big blind) collected (100)
Seat 2: FDIBA2009 (button) (small blind) folded before Flop



PokerStars Home Game Hand #226758853171: {Club #4781089}  Hold'em No Limit (50/100) - 2021/05/15 0:30:45 EET [2021/05/14 17:30:45 ET]
Table 'VTTP NLHE' 2-max (Play Money) Seat #1 is the button
Seat 1: s70n3fac3 (3711 in chips) 
Seat 2: FDIBA2009 (11243 in chips) 
s70n3fac3: posts small blind 50
FDIBA2009: posts big blind 100
*** HOLE CARDS ***
s70n3fac3: raises 100 to 200
FDIBA2009: calls 100
*** FLOP *** [6s 2d 3d]
FDIBA2009: checks 
s70n3fac3: checks 
*** TURN *** [6s 2d 3d] [Js]
FDIBA2009: bets 378
s70n3fac3: folds 
Uncalled bet (378) returned to FDIBA2009
FDIBA2009 collected 378 from pot
*** SUMMARY ***
Total pot 400 | Rake 22 
Board [6s 2d 3d Js]
Seat 1: s70n3fac3 (button) (small blind) folded on the Turn
Seat 2: FDIBA2009 (big blind) collected (378)



PokerStars Home Game Hand #226758863762: {Club #4781089}  Hold'em No Limit (50/100) - 2021/05/15 0:31:03 EET [2021/05/14 17:31:03 ET]
Table 'VTTP NLHE' 2-max (Play Money) Seat #2 is the button
Seat 1: s70n3fac3 (3511 in chips) 
Seat 2: FDIBA2009 (11421 in chips) 
FDIBA2009: posts small blind 50
s70n3fac3: posts big blind 100
*** HOLE CARDS ***
FDIBA2009: raises 100 to 200
s70n3fac3: calls 100
*** FLOP *** [5d As 7s]
s70n3fac3: checks 
FDIBA2009: bets 189
s70n3fac3: folds 
Uncalled bet (189) returned to FDIBA2009
FDIBA2009 collected 378 from pot
*** SUMMARY ***
Total pot 400 | Rake 22 
Board [5d As 7s]
Seat 1: s70n3fac3 (big blind) folded on the Flop
Seat 2: FDIBA2009 (button) (small blind) collected (378)



PokerStars Home Game Hand #226758871435: {Club #4781089}  Hold'em No Limit (50/100) - 2021/05/15 0:31:17 EET [2021/05/14 17:31:17 ET]
Table 'VTTP NLHE' 2-max (Play Money) Seat #1 is the button
Seat 1: s70n3fac3 (3311 in chips) 
Seat 2: FDIBA2009 (11599 in chips) 
s70n3fac3: posts small blind 50
FDIBA2009: posts big blind 100
*** HOLE CARDS ***
s70n3fac3: raises 100 to 200
FDIBA2009: raises 400 to 600
s70n3fac3: calls 400
*** FLOP *** [3s Tc 9d]
FDIBA2009: checks 
s70n3fac3: bets 500
FDIBA2009: raises 10499 to 10999 and is all-in
s70n3fac3: folds 
Uncalled bet (10499) returned to FDIBA2009
FDIBA2009 collected 2079 from pot
*** SUMMARY ***
Total pot 2200 | Rake 121 
Board [3s Tc 9d]
Seat 1: s70n3fac3 (button) (small blind) folded on the Flop
Seat 2: FDIBA2009 (big blind) collected (2079)



PokerStars Home Game Hand #226758893074: {Club #4781089}  Hold'em No Limit (50/100) - 2021/05/15 0:31:54 EET [2021/05/14 17:31:54 ET]
Table 'VTTP NLHE' 2-max (Play Money) Seat #2 is the button
Seat 1: s70n3fac3 (2211 in chips) 
Seat 2: FDIBA2009 (12578 in chips) 
FDIBA2009: posts small blind 50
s70n3fac3: posts big blind 100
*** HOLE CARDS ***
FDIBA2009: folds 
Uncalled bet (50) returned to s70n3fac3
s70n3fac3 collected 100 from pot
s70n3fac3: doesn't show hand 
*** SUMMARY ***
Total pot 100 | Rake 0 
Seat 1: s70n3fac3 (big blind) collected (100)
Seat 2: FDIBA2009 (button) (small blind) folded before Flop



PokerStars Home Game Hand #226758895621: {Club #4781089}  Hold'em No Limit (50/100) - 2021/05/15 0:31:59 EET [2021/05/14 17:31:59 ET]
Table 'VTTP NLHE' 2-max (Play Money) Seat #1 is the button
Seat 1: s70n3fac3 (2261 in chips) 
Seat 2: FDIBA2009 (12528 in chips) 
s70n3fac3: posts small blind 50
FDIBA2009: posts big blind 100
*** HOLE CARDS ***
s70n3fac3: raises 100 to 200
FDIBA2009: raises 12328 to 12528 and is all-in
s70n3fac3: folds 
Uncalled bet (12328) returned to FDIBA2009
FDIBA2009 collected 400 from pot
*** SUMMARY ***
Total pot 400 | Rake 0 
Seat 1: s70n3fac3 (button) (small blind) folded before Flop
Seat 2: FDIBA2009 (big blind) collected (400)



PokerStars Home Game Hand #226758899707: {Club #4781089}  Hold'em No Limit (50/100) - 2021/05/15 0:32:06 EET [2021/05/14 17:32:06 ET]
Table 'VTTP NLHE' 2-max (Play Money) Seat #2 is the button
Seat 1: s70n3fac3 (2061 in chips) 
Seat 2: FDIBA2009 (12728 in chips) 
FDIBA2009: posts small blind 50
s70n3fac3: posts big blind 100
*** HOLE CARDS ***
FDIBA2009: calls 50
s70n3fac3: checks 
*** FLOP *** [Kc 6s Js]
s70n3fac3: checks 
FDIBA2009: bets 100
s70n3fac3: folds 
Uncalled bet (100) returned to FDIBA2009
FDIBA2009 collected 189 from pot
*** SUMMARY ***
Total pot 200 | Rake 11 
Board [Kc 6s Js]
Seat 1: s70n3fac3 (big blind) folded on the Flop
Seat 2: FDIBA2009 (button) (small blind) collected (189)



PokerStars Home Game Hand #226758905705: {Club #4781089}  Hold'em No Limit (50/100) - 2021/05/15 0:32:16 EET [2021/05/14 17:32:16 ET]
Table 'VTTP NLHE' 2-max (Play Money) Seat #1 is the button
Seat 1: s70n3fac3 (1961 in chips) 
Seat 2: FDIBA2009 (12817 in chips) 
s70n3fac3: posts small blind 50
FDIBA2009: posts big blind 100
*** HOLE CARDS ***
s70n3fac3: calls 50
FDIBA2009: checks 
*** FLOP *** [Qh Kd 7c]
FDIBA2009: checks 
s70n3fac3: checks 
*** TURN *** [Qh Kd 7c] [Tc]
FDIBA2009: bets 100
s70n3fac3: folds 
Uncalled bet (100) returned to FDIBA2009
FDIBA2009 collected 189 from pot
*** SUMMARY ***
Total pot 200 | Rake 11 
Board [Qh Kd 7c Tc]
Seat 1: s70n3fac3 (button) (small blind) folded on the Turn
Seat 2: FDIBA2009 (big blind) collected (189)



PokerStars Home Game Hand #226758915754: {Club #4781089}  Hold'em No Limit (50/100) - 2021/05/15 0:32:34 EET [2021/05/14 17:32:34 ET]
Table 'VTTP NLHE' 2-max (Play Money) Seat #2 is the button
Seat 1: s70n3fac3 (1861 in chips) 
Seat 2: FDIBA2009 (12906 in chips) 
FDIBA2009: posts small blind 50
s70n3fac3: posts big blind 100
*** HOLE CARDS ***
FDIBA2009: calls 50
s70n3fac3: checks 
*** FLOP *** [7d 5d Qh]
s70n3fac3: checks 
FDIBA2009: checks 
*** TURN *** [7d 5d Qh] [7h]
s70n3fac3: bets 100
FDIBA2009: folds 
Uncalled bet (100) returned to s70n3fac3
s70n3fac3 collected 189 from pot
s70n3fac3: doesn't show hand 
*** SUMMARY ***
Total pot 200 | Rake 11 
Board [7d 5d Qh 7h]
Seat 1: s70n3fac3 (big blind) collected (189)
Seat 2: FDIBA2009 (button) (small blind) folded on the Turn



PokerStars Home Game Hand #226758926370: {Club #4781089}  Hold'em No Limit (50/100) - 2021/05/15 0:32:52 EET [2021/05/14 17:32:52 ET]
Table 'VTTP NLHE' 2-max (Play Money) Seat #1 is the button
Seat 1: s70n3fac3 (1950 in chips) 
Seat 2: FDIBA2009 (12806 in chips) 
s70n3fac3: posts small blind 50
FDIBA2009: posts big blind 100
*** HOLE CARDS ***
s70n3fac3: folds 
Uncalled bet (50) returned to FDIBA2009
FDIBA2009 collected 100 from pot
*** SUMMARY ***
Total pot 100 | Rake 0 
Seat 1: s70n3fac3 (button) (small blind) folded before Flop
Seat 2: FDIBA2009 (big blind) collected (100)



PokerStars Home Game Hand #226758928715: {Club #4781089}  Hold'em No Limit (50/100) - 2021/05/15 0:32:56 EET [2021/05/14 17:32:56 ET]
Table 'VTTP NLHE' 2-max (Play Money) Seat #2 is the button
Seat 1: s70n3fac3 (1900 in chips) 
Seat 2: FDIBA2009 (12856 in chips) 
FDIBA2009: posts small blind 50
s70n3fac3: posts big blind 100
*** HOLE CARDS ***
FDIBA2009: raises 100 to 200
s70n3fac3: raises 1700 to 1900 and is all-in
FDIBA2009: folds 
Uncalled bet (1700) returned to s70n3fac3
s70n3fac3 collected 400 from pot
s70n3fac3: doesn't show hand 
*** SUMMARY ***
Total pot 400 | Rake 0 
Seat 1: s70n3fac3 (big blind) collected (400)
Seat 2: FDIBA2009 (button) (small blind) folded before Flop



PokerStars Home Game Hand #226758933552: {Club #4781089}  Hold'em No Limit (50/100) - 2021/05/15 0:33:04 EET [2021/05/14 17:33:04 ET]
Table 'VTTP NLHE' 2-max (Play Money) Seat #1 is the button
Seat 1: s70n3fac3 (2100 in chips) 
Seat 2: FDIBA2009 (12656 in chips) 
s70n3fac3: posts small blind 50
FDIBA2009: posts big blind 100
*** HOLE CARDS ***
s70n3fac3: folds 
Uncalled bet (50) returned to FDIBA2009
FDIBA2009 collected 100 from pot
*** SUMMARY ***
Total pot 100 | Rake 0 
Seat 1: s70n3fac3 (button) (small blind) folded before Flop
Seat 2: FDIBA2009 (big blind) collected (100)



PokerStars Home Game Hand #226758935894: {Club #4781089}  Hold'em No Limit (50/100) - 2021/05/15 0:33:08 EET [2021/05/14 17:33:08 ET]
Table 'VTTP NLHE' 2-max (Play Money) Seat #2 is the button
Seat 1: s70n3fac3 (2050 in chips) 
Seat 2: FDIBA2009 (12706 in chips) 
FDIBA2009: posts small blind 50
s70n3fac3: posts big blind 100
*** HOLE CARDS ***
FDIBA2009: folds 
Uncalled bet (50) returned to s70n3fac3
s70n3fac3 collected 100 from pot
s70n3fac3: doesn't show hand 
*** SUMMARY ***
Total pot 100 | Rake 0 
Seat 1: s70n3fac3 (big blind) collected (100)
Seat 2: FDIBA2009 (button) (small blind) folded before Flop



PokerStars Home Game Hand #226758939019: {Club #4781089}  Hold'em No Limit (50/100) - 2021/05/15 0:33:14 EET [2021/05/14 17:33:14 ET]
Table 'VTTP NLHE' 2-max (Play Money) Seat #1 is the button
Seat 1: s70n3fac3 (2100 in chips) 
Seat 2: FDIBA2009 (12656 in chips) 
s70n3fac3: posts small blind 50
FDIBA2009: posts big blind 100
*** HOLE CARDS ***
s70n3fac3: folds 
Uncalled bet (50) returned to FDIBA2009
FDIBA2009 collected 100 from pot
*** SUMMARY ***
Total pot 100 | Rake 0 
Seat 1: s70n3fac3 (button) (small blind) folded before Flop
Seat 2: FDIBA2009 (big blind) collected (100)



PokerStars Home Game Hand #226758941204: {Club #4781089}  Hold'em No Limit (50/100) - 2021/05/15 0:33:18 EET [2021/05/14 17:33:18 ET]
Table 'VTTP NLHE' 2-max (Play Money) Seat #2 is the button
Seat 1: s70n3fac3 (2050 in chips) 
Seat 2: FDIBA2009 (12706 in chips) 
FDIBA2009: posts small blind 50
s70n3fac3: posts big blind 100
*** HOLE CARDS ***
FDIBA2009: raises 100 to 200
s70n3fac3: calls 100
*** FLOP *** [4s 8c Js]
s70n3fac3: checks 
FDIBA2009: checks 
*** TURN *** [4s 8c Js] [9s]
s70n3fac3: checks 
FDIBA2009: bets 189
s70n3fac3: calls 189
*** RIVER *** [4s 8c Js 9s] [2c]
s70n3fac3: checks 
FDIBA2009: bets 735
s70n3fac3: folds 
Uncalled bet (735) returned to FDIBA2009
FDIBA2009 collected 735 from pot
*** SUMMARY ***
Total pot 778 | Rake 43 
Board [4s 8c Js 9s 2c]
Seat 1: s70n3fac3 (big blind) folded on the River
Seat 2: FDIBA2009 (button) (small blind) collected (735)



PokerStars Home Game Hand #226758955898: {Club #4781089}  Hold'em No Limit (50/100) - 2021/05/15 0:33:43 EET [2021/05/14 17:33:43 ET]
Table 'VTTP NLHE' 2-max (Play Money) Seat #1 is the button
Seat 1: s70n3fac3 (1661 in chips) 
Seat 2: FDIBA2009 (13052 in chips) 
s70n3fac3: posts small blind 50
FDIBA2009: posts big blind 100
*** HOLE CARDS ***
s70n3fac3: calls 50
FDIBA2009: raises 100 to 200
s70n3fac3: raises 1461 to 1661 and is all-in
FDIBA2009: calls 1461
*** FLOP *** [Ah 8c Th]
*** TURN *** [Ah 8c Th] [Td]
*** RIVER *** [Ah 8c Th Td] [Qs]
*** SHOW DOWN ***
FDIBA2009: shows [Ad Kd] (two pair, Aces and Tens)
s70n3fac3: shows [As Tc] (a full house, Tens full of Aces)
s70n3fac3 collected 3139 from pot
*** SUMMARY ***
Total pot 3322 | Rake 183 
Board [Ah 8c Th Td Qs]
Seat 1: s70n3fac3 (button) (small blind) showed [As Tc] and won (3139) with a full house, Tens full of Aces
Seat 2: FDIBA2009 (big blind) showed [Ad Kd] and lost with two pair, Aces and Tens



PokerStars Home Game Hand #226758970361: {Club #4781089}  Hold'em No Limit (50/100) - 2021/05/15 0:34:08 EET [2021/05/14 17:34:08 ET]
Table 'VTTP NLHE' 2-max (Play Money) Seat #2 is the button
Seat 1: s70n3fac3 (3139 in chips) 
Seat 2: FDIBA2009 (11391 in chips) 
FDIBA2009: posts small blind 50
s70n3fac3: posts big blind 100
*** HOLE CARDS ***
FDIBA2009: raises 100 to 200
s70n3fac3: folds 
Uncalled bet (100) returned to FDIBA2009
FDIBA2009 collected 200 from pot
*** SUMMARY ***
Total pot 200 | Rake 0 
Seat 1: s70n3fac3 (big blind) folded before Flop
Seat 2: FDIBA2009 (button) (small blind) collected (200)



PokerStars Home Game Hand #226758974156: {Club #4781089}  Hold'em No Limit (50/100) - 2021/05/15 0:34:15 EET [2021/05/14 17:34:15 ET]
Table 'VTTP NLHE' 2-max (Play Money) Seat #1 is the button
Seat 1: s70n3fac3 (3039 in chips) 
Seat 2: FDIBA2009 (11491 in chips) 
s70n3fac3: posts small blind 50
FDIBA2009: posts big blind 100
*** HOLE CARDS ***
s70n3fac3: calls 50
FDIBA2009: checks 
*** FLOP *** [7h 3h Qd]
FDIBA2009: checks 
s70n3fac3: bets 100
FDIBA2009: folds 
Uncalled bet (100) returned to s70n3fac3
s70n3fac3 collected 189 from pot
s70n3fac3: doesn't show hand 
*** SUMMARY ***
Total pot 200 | Rake 11 
Board [7h 3h Qd]
Seat 1: s70n3fac3 (button) (small blind) collected (189)
Seat 2: FDIBA2009 (big blind) folded on the Flop



PokerStars Home Game Hand #226758980060: {Club #4781089}  Hold'em No Limit (50/100) - 2021/05/15 0:34:25 EET [2021/05/14 17:34:25 ET]
Table 'VTTP NLHE' 2-max (Play Money) Seat #2 is the button
Seat 1: s70n3fac3 (3128 in chips) 
Seat 2: FDIBA2009 (11391 in chips) 
FDIBA2009: posts small blind 50
s70n3fac3: posts big blind 100
*** HOLE CARDS ***
FDIBA2009: raises 100 to 200
s70n3fac3: folds 
Uncalled bet (100) returned to FDIBA2009
FDIBA2009 collected 200 from pot
*** SUMMARY ***
Total pot 200 | Rake 0 
Seat 1: s70n3fac3 (big blind) folded before Flop
Seat 2: FDIBA2009 (button) (small blind) collected (200)



PokerStars Home Game Hand #226758983712: {Club #4781089}  Hold'em No Limit (50/100) - 2021/05/15 0:34:32 EET [2021/05/14 17:34:32 ET]
Table 'VTTP NLHE' 2-max (Play Money) Seat #1 is the button
Seat 1: s70n3fac3 (3028 in chips) 
Seat 2: FDIBA2009 (11491 in chips) 
s70n3fac3: posts small blind 50
FDIBA2009: posts big blind 100
*** HOLE CARDS ***
s70n3fac3: folds 
Uncalled bet (50) returned to FDIBA2009
FDIBA2009 collected 100 from pot
*** SUMMARY ***
Total pot 100 | Rake 0 
Seat 1: s70n3fac3 (button) (small blind) folded before Flop
Seat 2: FDIBA2009 (big blind) collected (100)



PokerStars Home Game Hand #226758986002: {Club #4781089}  Hold'em No Limit (50/100) - 2021/05/15 0:34:36 EET [2021/05/14 17:34:36 ET]
Table 'VTTP NLHE' 2-max (Play Money) Seat #2 is the button
Seat 1: s70n3fac3 (2978 in chips) 
Seat 2: FDIBA2009 (11541 in chips) 
FDIBA2009: posts small blind 50
s70n3fac3: posts big blind 100
*** HOLE CARDS ***
FDIBA2009: raises 100 to 200
s70n3fac3: calls 100
*** FLOP *** [4d 2c 6c]
s70n3fac3: checks 
FDIBA2009: bets 378
s70n3fac3: calls 378
*** TURN *** [4d 2c 6c] [5s]
s70n3fac3: checks 
FDIBA2009: checks 
*** RIVER *** [4d 2c 6c 5s] [2h]
s70n3fac3: checks 
FDIBA2009: checks 
*** SHOW DOWN ***
s70n3fac3: shows [7s 8d] (a straight, Four to Eight)
FDIBA2009: mucks hand 
s70n3fac3 collected 1092 from pot
*** SUMMARY ***
Total pot 1156 | Rake 64 
Board [4d 2c 6c 5s 2h]
Seat 1: s70n3fac3 (big blind) showed [7s 8d] and won (1092) with a straight, Four to Eight
Seat 2: FDIBA2009 (button) (small blind) mucked [4c 8s]



PokerStars Home Game Hand #226759011747: {Club #4781089}  Hold'em No Limit (50/100) - 2021/05/15 0:35:09 EET [2021/05/14 17:35:09 ET]
Table 'VTTP NLHE' 2-max (Play Money) Seat #1 is the button
Seat 1: s70n3fac3 (3492 in chips) 
Seat 2: FDIBA2009 (10963 in chips) 
s70n3fac3: posts small blind 50
FDIBA2009: posts big blind 100
*** HOLE CARDS ***
s70n3fac3: folds 
Uncalled bet (50) returned to FDIBA2009
FDIBA2009 collected 100 from pot
*** SUMMARY ***
Total pot 100 | Rake 0 
Seat 1: s70n3fac3 (button) (small blind) folded before Flop
Seat 2: FDIBA2009 (big blind) collected (100)



PokerStars Home Game Hand #226759014508: {Club #4781089}  Hold'em No Limit (50/100) - 2021/05/15 0:35:14 EET [2021/05/14 17:35:14 ET]
Table 'VTTP NLHE' 2-max (Play Money) Seat #2 is the button
Seat 1: s70n3fac3 (3442 in chips) 
Seat 2: FDIBA2009 (11013 in chips) 
FDIBA2009: posts small blind 50
s70n3fac3: posts big blind 100
*** HOLE CARDS ***
FDIBA2009: raises 200 to 300
s70n3fac3: calls 200
*** FLOP *** [2d 8c 3c]
s70n3fac3: checks 
FDIBA2009: bets 567
s70n3fac3: folds 
Uncalled bet (567) returned to FDIBA2009
FDIBA2009 collected 567 from pot
*** SUMMARY ***
Total pot 600 | Rake 33 
Board [2d 8c 3c]
Seat 1: s70n3fac3 (big blind) folded on the Flop
Seat 2: FDIBA2009 (button) (small blind) collected (567)



PokerStars Home Game Hand #226759021840: {Club #4781089}  Hold'em No Limit (50/100) - 2021/05/15 0:35:26 EET [2021/05/14 17:35:26 ET]
Table 'VTTP NLHE' 2-max (Play Money) Seat #1 is the button
Seat 1: s70n3fac3 (3142 in chips) 
Seat 2: FDIBA2009 (11280 in chips) 
s70n3fac3: posts small blind 50
FDIBA2009: posts big blind 100
*** HOLE CARDS ***
s70n3fac3: calls 50
FDIBA2009: checks 
*** FLOP *** [4h Kh 8s]
FDIBA2009: checks 
s70n3fac3: bets 100
FDIBA2009: folds 
Uncalled bet (100) returned to s70n3fac3
s70n3fac3 collected 189 from pot
s70n3fac3: doesn't show hand 
*** SUMMARY ***
Total pot 200 | Rake 11 
Board [4h Kh 8s]
Seat 1: s70n3fac3 (button) (small blind) collected (189)
Seat 2: FDIBA2009 (big blind) folded on the Flop



PokerStars Home Game Hand #226759036002: {Club #4781089}  Hold'em No Limit (50/100) - 2021/05/15 0:35:51 EET [2021/05/14 17:35:51 ET]
Table 'VTTP NLHE' 2-max (Play Money) Seat #2 is the button
Seat 1: s70n3fac3 (3231 in chips) 
Seat 2: FDIBA2009 (11180 in chips) 
FDIBA2009: posts small blind 50
s70n3fac3: posts big blind 100
*** HOLE CARDS ***
FDIBA2009: raises 100 to 200
s70n3fac3: folds 
Uncalled bet (100) returned to FDIBA2009
FDIBA2009 collected 200 from pot
*** SUMMARY ***
Total pot 200 | Rake 0 
Seat 1: s70n3fac3 (big blind) folded before Flop
Seat 2: FDIBA2009 (button) (small blind) collected (200)



PokerStars Home Game Hand #226759039270: {Club #4781089}  Hold'em No Limit (50/100) - 2021/05/15 0:35:57 EET [2021/05/14 17:35:57 ET]
Table 'VTTP NLHE' 2-max (Play Money) Seat #1 is the button
Seat 1: s70n3fac3 (3131 in chips) 
Seat 2: FDIBA2009 (11280 in chips) 
s70n3fac3: posts small blind 50
FDIBA2009: posts big blind 100
*** HOLE CARDS ***
s70n3fac3: calls 50
FDIBA2009: raises 200 to 300
s70n3fac3: calls 200
*** FLOP *** [9d As Kh]
FDIBA2009: checks 
s70n3fac3: bets 200
FDIBA2009: calls 200
*** TURN *** [9d As Kh] [Qs]
FDIBA2009: checks 
s70n3fac3: bets 400
FDIBA2009: calls 400
*** RIVER *** [9d As Kh Qs] [Ad]
FDIBA2009: checks 
s70n3fac3: checks 
*** SHOW DOWN ***
FDIBA2009: shows [Tc Kc] (two pair, Aces and Kings)
s70n3fac3: mucks hand 
FDIBA2009 collected 1701 from pot
*** SUMMARY ***
Total pot 1800 | Rake 99 
Board [9d As Kh Qs Ad]
Seat 1: s70n3fac3 (button) (small blind) mucked [7s Th]
Seat 2: FDIBA2009 (big blind) showed [Tc Kc] and won (1701) with two pair, Aces and Kings



PokerStars Home Game Hand #226759060215: {Club #4781089}  Hold'em No Limit (50/100) - 2021/05/15 0:36:34 EET [2021/05/14 17:36:34 ET]
Table 'VTTP NLHE' 2-max (Play Money) Seat #2 is the button
Seat 1: s70n3fac3 (2231 in chips) 
Seat 2: FDIBA2009 (12081 in chips) 
FDIBA2009: posts small blind 50
s70n3fac3: posts big blind 100
*** HOLE CARDS ***
FDIBA2009: raises 100 to 200
s70n3fac3: calls 100
*** FLOP *** [8s Kh Jc]
s70n3fac3: checks 
FDIBA2009: checks 
*** TURN *** [8s Kh Jc] [Qc]
s70n3fac3: checks 
FDIBA2009: checks 
*** RIVER *** [8s Kh Jc Qc] [5d]
s70n3fac3: bets 200
FDIBA2009: calls 200
*** SHOW DOWN ***
s70n3fac3: shows [3h Qh] (a pair of Queens)
FDIBA2009: mucks hand 
s70n3fac3 collected 756 from pot
*** SUMMARY ***
Total pot 800 | Rake 44 
Board [8s Kh Jc Qc 5d]
Seat 1: s70n3fac3 (big blind) showed [3h Qh] and won (756) with a pair of Queens
Seat 2: FDIBA2009 (button) (small blind) mucked [Jd Th]



PokerStars Home Game Hand #226759073167: {Club #4781089}  Hold'em No Limit (50/100) - 2021/05/15 0:36:57 EET [2021/05/14 17:36:57 ET]
Table 'VTTP NLHE' 2-max (Play Money) Seat #1 is the button
Seat 1: s70n3fac3 (2587 in chips) 
Seat 2: FDIBA2009 (11681 in chips) 
s70n3fac3: posts small blind 50
FDIBA2009: posts big blind 100
*** HOLE CARDS ***
s70n3fac3: folds 
Uncalled bet (50) returned to FDIBA2009
FDIBA2009 collected 100 from pot
*** SUMMARY ***
Total pot 100 | Rake 0 
Seat 1: s70n3fac3 (button) (small blind) folded before Flop
Seat 2: FDIBA2009 (big blind) collected (100)



PokerStars Home Game Hand #226759075531: {Club #4781089}  Hold'em No Limit (50/100) - 2021/05/15 0:37:01 EET [2021/05/14 17:37:01 ET]
Table 'VTTP NLHE' 2-max (Play Money) Seat #2 is the button
Seat 1: s70n3fac3 (2537 in chips) 
Seat 2: FDIBA2009 (11731 in chips) 
FDIBA2009: posts small blind 50
s70n3fac3: posts big blind 100
*** HOLE CARDS ***
FDIBA2009: raises 100 to 200
s70n3fac3: calls 100
*** FLOP *** [Td 3h Ad]
s70n3fac3: checks 
FDIBA2009: checks 
*** TURN *** [Td 3h Ad] [Jc]
s70n3fac3: bets 200
FDIBA2009: folds 
Uncalled bet (200) returned to s70n3fac3
s70n3fac3 collected 378 from pot
s70n3fac3: doesn't show hand 
*** SUMMARY ***
Total pot 400 | Rake 22 
Board [Td 3h Ad Jc]
Seat 1: s70n3fac3 (big blind) collected (378)
Seat 2: FDIBA2009 (button) (small blind) folded on the Turn



PokerStars Home Game Hand #226759083587: {Club #4781089}  Hold'em No Limit (50/100) - 2021/05/15 0:37:15 EET [2021/05/14 17:37:15 ET]
Table 'VTTP NLHE' 2-max (Play Money) Seat #1 is the button
Seat 1: s70n3fac3 (2715 in chips) 
Seat 2: FDIBA2009 (11531 in chips) 
s70n3fac3: posts small blind 50
FDIBA2009: posts big blind 100
*** HOLE CARDS ***
s70n3fac3: folds 
Uncalled bet (50) returned to FDIBA2009
FDIBA2009 collected 100 from pot
*** SUMMARY ***
Total pot 100 | Rake 0 
Seat 1: s70n3fac3 (button) (small blind) folded before Flop
Seat 2: FDIBA2009 (big blind) collected (100)



PokerStars Home Game Hand #226759085658: {Club #4781089}  Hold'em No Limit (50/100) - 2021/05/15 0:37:18 EET [2021/05/14 17:37:18 ET]
Table 'VTTP NLHE' 2-max (Play Money) Seat #2 is the button
Seat 1: s70n3fac3 (2665 in chips) 
Seat 2: FDIBA2009 (11581 in chips) 
FDIBA2009: posts small blind 50
s70n3fac3: posts big blind 100
*** HOLE CARDS ***
FDIBA2009: raises 100 to 200
s70n3fac3: calls 100
*** FLOP *** [3c 7c Ac]
s70n3fac3: checks 
FDIBA2009: bets 100
s70n3fac3: calls 100
*** TURN *** [3c 7c Ac] [Kc]
s70n3fac3: checks 
FDIBA2009: checks 
*** RIVER *** [3c 7c Ac Kc] [Ah]
s70n3fac3: checks 
FDIBA2009: bets 100
s70n3fac3: calls 100
*** SHOW DOWN ***
FDIBA2009: shows [4c Qc] (a flush, Ace high)
s70n3fac3: mucks hand 
FDIBA2009 collected 756 from pot
*** SUMMARY ***
Total pot 800 | Rake 44 
Board [3c 7c Ac Kc Ah]
Seat 1: s70n3fac3 (big blind) mucked [7h 4h]
Seat 2: FDIBA2009 (button) (small blind) showed [4c Qc] and won (756) with a flush, Ace high



PokerStars Home Game Hand #226759097245: {Club #4781089}  Hold'em No Limit (50/100) - 2021/05/15 0:37:39 EET [2021/05/14 17:37:39 ET]
Table 'VTTP NLHE' 2-max (Play Money) Seat #1 is the button
Seat 1: s70n3fac3 (2265 in chips) 
Seat 2: FDIBA2009 (11937 in chips) 
s70n3fac3: posts small blind 50
FDIBA2009: posts big blind 100
*** HOLE CARDS ***
s70n3fac3: folds 
Uncalled bet (50) returned to FDIBA2009
FDIBA2009 collected 100 from pot
*** SUMMARY ***
Total pot 100 | Rake 0 
Seat 1: s70n3fac3 (button) (small blind) folded before Flop
Seat 2: FDIBA2009 (big blind) collected (100)



PokerStars Home Game Hand #226759099621: {Club #4781089}  Hold'em No Limit (50/100) - 2021/05/15 0:37:43 EET [2021/05/14 17:37:43 ET]
Table 'VTTP NLHE' 2-max (Play Money) Seat #2 is the button
Seat 1: s70n3fac3 (2215 in chips) 
Seat 2: FDIBA2009 (11987 in chips) 
FDIBA2009: posts small blind 50
s70n3fac3: posts big blind 100
*** HOLE CARDS ***
FDIBA2009: calls 50
s70n3fac3: raises 200 to 300
FDIBA2009: folds 
Uncalled bet (200) returned to s70n3fac3
s70n3fac3 collected 200 from pot
s70n3fac3: doesn't show hand 
*** SUMMARY ***
Total pot 200 | Rake 0 
Seat 1: s70n3fac3 (big blind) collected (200)
Seat 2: FDIBA2009 (button) (small blind) folded before Flop



PokerStars Home Game Hand #226759104127: {Club #4781089}  Hold'em No Limit (50/100) - 2021/05/15 0:37:50 EET [2021/05/14 17:37:50 ET]
Table 'VTTP NLHE' 2-max (Play Money) Seat #1 is the button
Seat 1: s70n3fac3 (2315 in chips) 
Seat 2: FDIBA2009 (11887 in chips) 
s70n3fac3: posts small blind 50
FDIBA2009: posts big blind 100
*** HOLE CARDS ***
s70n3fac3: raises 100 to 200
FDIBA2009: folds 
Uncalled bet (100) returned to s70n3fac3
s70n3fac3 collected 200 from pot
s70n3fac3: doesn't show hand 
*** SUMMARY ***
Total pot 200 | Rake 0 
Seat 1: s70n3fac3 (button) (small blind) collected (200)
Seat 2: FDIBA2009 (big blind) folded before Flop



PokerStars Home Game Hand #226759106977: {Club #4781089}  Hold'em No Limit (50/100) - 2021/05/15 0:37:55 EET [2021/05/14 17:37:55 ET]
Table 'VTTP NLHE' 2-max (Play Money) Seat #2 is the button
Seat 1: s70n3fac3 (2415 in chips) 
Seat 2: FDIBA2009 (11787 in chips) 
FDIBA2009: posts small blind 50
s70n3fac3: posts big blind 100
*** HOLE CARDS ***
FDIBA2009: raises 100 to 200
s70n3fac3: folds 
Uncalled bet (100) returned to FDIBA2009
FDIBA2009 collected 200 from pot
*** SUMMARY ***
Total pot 200 | Rake 0 
Seat 1: s70n3fac3 (big blind) folded before Flop
Seat 2: FDIBA2009 (button) (small blind) collected (200)



PokerStars Home Game Hand #226759109970: {Club #4781089}  Hold'em No Limit (50/100) - 2021/05/15 0:38:01 EET [2021/05/14 17:38:01 ET]
Table 'VTTP NLHE' 2-max (Play Money) Seat #1 is the button
Seat 1: s70n3fac3 (2315 in chips) 
Seat 2: FDIBA2009 (11887 in chips) 
s70n3fac3: posts small blind 50
FDIBA2009: posts big blind 100
*** HOLE CARDS ***
s70n3fac3: calls 50
FDIBA2009: checks 
*** FLOP *** [6s 3c Ad]
FDIBA2009: checks 
s70n3fac3: bets 100
FDIBA2009: calls 100
*** TURN *** [6s 3c Ad] [5s]
FDIBA2009: checks 
s70n3fac3: bets 200
FDIBA2009: folds 
Uncalled bet (200) returned to s70n3fac3
s70n3fac3 collected 378 from pot
s70n3fac3: doesn't show hand 
*** SUMMARY ***
Total pot 400 | Rake 22 
Board [6s 3c Ad 5s]
Seat 1: s70n3fac3 (button) (small blind) collected (378)
Seat 2: FDIBA2009 (big blind) folded on the Turn



PokerStars Home Game Hand #226759119713: {Club #4781089}  Hold'em No Limit (50/100) - 2021/05/15 0:38:17 EET [2021/05/14 17:38:17 ET]
Table 'VTTP NLHE' 2-max (Play Money) Seat #2 is the button
Seat 1: s70n3fac3 (2493 in chips) 
Seat 2: FDIBA2009 (11687 in chips) 
FDIBA2009: posts small blind 50
s70n3fac3: posts big blind 100
*** HOLE CARDS ***
FDIBA2009: raises 100 to 200
s70n3fac3: calls 100
*** FLOP *** [Js 8h As]
s70n3fac3: checks 
FDIBA2009: bets 378
s70n3fac3: folds 
Uncalled bet (378) returned to FDIBA2009
FDIBA2009 collected 378 from pot
*** SUMMARY ***
Total pot 400 | Rake 22 
Board [Js 8h As]
Seat 1: s70n3fac3 (big blind) folded on the Flop
Seat 2: FDIBA2009 (button) (small blind) collected (378)



PokerStars Home Game Hand #226759126214: {Club #4781089}  Hold'em No Limit (50/100) - 2021/05/15 0:38:29 EET [2021/05/14 17:38:29 ET]
Table 'VTTP NLHE' 2-max (Play Money) Seat #1 is the button
Seat 1: s70n3fac3 (2293 in chips) 
Seat 2: FDIBA2009 (11865 in chips) 
s70n3fac3: posts small blind 50
FDIBA2009: posts big blind 100
*** HOLE CARDS ***
s70n3fac3: folds 
Uncalled bet (50) returned to FDIBA2009
FDIBA2009 collected 100 from pot
*** SUMMARY ***
Total pot 100 | Rake 0 
Seat 1: s70n3fac3 (button) (small blind) folded before Flop
Seat 2: FDIBA2009 (big blind) collected (100)



PokerStars Home Game Hand #226759128302: {Club #4781089}  Hold'em No Limit (50/100) - 2021/05/15 0:38:33 EET [2021/05/14 17:38:33 ET]
Table 'VTTP NLHE' 2-max (Play Money) Seat #2 is the button
Seat 1: s70n3fac3 (2243 in chips) 
Seat 2: FDIBA2009 (11915 in chips) 
FDIBA2009: posts small blind 50
s70n3fac3: posts big blind 100
*** HOLE CARDS ***
FDIBA2009: raises 100 to 200
s70n3fac3: folds 
Uncalled bet (100) returned to FDIBA2009
FDIBA2009 collected 200 from pot
*** SUMMARY ***
Total pot 200 | Rake 0 
Seat 1: s70n3fac3 (big blind) folded before Flop
Seat 2: FDIBA2009 (button) (small blind) collected (200)



PokerStars Home Game Hand #226759132067: {Club #4781089}  Hold'em No Limit (50/100) - 2021/05/15 0:38:39 EET [2021/05/14 17:38:39 ET]
Table 'VTTP NLHE' 2-max (Play Money) Seat #1 is the button
Seat 1: s70n3fac3 (2143 in chips) 
Seat 2: FDIBA2009 (12015 in chips) 
s70n3fac3: posts small blind 50
FDIBA2009: posts big blind 100
*** HOLE CARDS ***
s70n3fac3: folds 
Uncalled bet (50) returned to FDIBA2009
FDIBA2009 collected 100 from pot
*** SUMMARY ***
Total pot 100 | Rake 0 
Seat 1: s70n3fac3 (button) (small blind) folded before Flop
Seat 2: FDIBA2009 (big blind) collected (100)



PokerStars Home Game Hand #226759135195: {Club #4781089}  Hold'em No Limit (50/100) - 2021/05/15 0:38:44 EET [2021/05/14 17:38:44 ET]
Table 'VTTP NLHE' 2-max (Play Money) Seat #2 is the button
Seat 1: s70n3fac3 (2093 in chips) 
Seat 2: FDIBA2009 (12065 in chips) 
FDIBA2009: posts small blind 50
s70n3fac3: posts big blind 100
*** HOLE CARDS ***
FDIBA2009: raises 200 to 300
s70n3fac3: calls 200
*** FLOP *** [8s 3c 3h]
s70n3fac3: checks 
FDIBA2009: bets 567
s70n3fac3: folds 
Uncalled bet (567) returned to FDIBA2009
FDIBA2009 collected 567 from pot
*** SUMMARY ***
Total pot 600 | Rake 33 
Board [8s 3c 3h]
Seat 1: s70n3fac3 (big blind) folded on the Flop
Seat 2: FDIBA2009 (button) (small blind) collected (567)



PokerStars Home Game Hand #226759143329: {Club #4781089}  Hold'em No Limit (50/100) - 2021/05/15 0:38:59 EET [2021/05/14 17:38:59 ET]
Table 'VTTP NLHE' 2-max (Play Money) Seat #1 is the button
Seat 1: s70n3fac3 (1793 in chips) 
Seat 2: FDIBA2009 (12332 in chips) 
s70n3fac3: posts small blind 50
FDIBA2009: posts big blind 100
*** HOLE CARDS ***
s70n3fac3: folds 
Uncalled bet (50) returned to FDIBA2009
FDIBA2009 collected 100 from pot
*** SUMMARY ***
Total pot 100 | Rake 0 
Seat 1: s70n3fac3 (button) (small blind) folded before Flop
Seat 2: FDIBA2009 (big blind) collected (100)



PokerStars Home Game Hand #226759145449: {Club #4781089}  Hold'em No Limit (50/100) - 2021/05/15 0:39:02 EET [2021/05/14 17:39:02 ET]
Table 'VTTP NLHE' 2-max (Play Money) Seat #2 is the button
Seat 1: s70n3fac3 (1743 in chips) 
Seat 2: FDIBA2009 (12382 in chips) 
FDIBA2009: posts small blind 50
s70n3fac3: posts big blind 100
*** HOLE CARDS ***
FDIBA2009: calls 50
s70n3fac3: checks 
*** FLOP *** [Ad Js 3h]
s70n3fac3: checks 
FDIBA2009: checks 
*** TURN *** [Ad Js 3h] [6c]
s70n3fac3: checks 
FDIBA2009: bets 189
s70n3fac3: calls 189
*** RIVER *** [Ad Js 3h 6c] [9d]
s70n3fac3: checks 
FDIBA2009: bets 273
s70n3fac3: raises 546 to 819
FDIBA2009: folds 
Uncalled bet (546) returned to s70n3fac3
s70n3fac3 collected 1062 from pot
s70n3fac3: doesn't show hand 
*** SUMMARY ***
Total pot 1124 | Rake 62 
Board [Ad Js 3h 6c 9d]
Seat 1: s70n3fac3 (big blind) collected (1062)
Seat 2: FDIBA2009 (button) (small blind) folded on the River



PokerStars Home Game Hand #226759166551: {Club #4781089}  Hold'em No Limit (50/100) - 2021/05/15 0:39:40 EET [2021/05/14 17:39:40 ET]
Table 'VTTP NLHE' 2-max (Play Money) Seat #1 is the button
Seat 1: s70n3fac3 (2243 in chips) 
Seat 2: FDIBA2009 (11820 in chips) 
s70n3fac3: posts small blind 50
FDIBA2009: posts big blind 100
*** HOLE CARDS ***
s70n3fac3: folds 
Uncalled bet (50) returned to FDIBA2009
FDIBA2009 collected 100 from pot
*** SUMMARY ***
Total pot 100 | Rake 0 
Seat 1: s70n3fac3 (button) (small blind) folded before Flop
Seat 2: FDIBA2009 (big blind) collected (100)



PokerStars Home Game Hand #226759168868: {Club #4781089}  Hold'em No Limit (50/100) - 2021/05/15 0:39:43 EET [2021/05/14 17:39:43 ET]
Table 'VTTP NLHE' 2-max (Play Money) Seat #2 is the button
Seat 1: s70n3fac3 (2193 in chips) 
Seat 2: FDIBA2009 (11870 in chips) 
FDIBA2009: posts small blind 50
s70n3fac3: posts big blind 100
*** HOLE CARDS ***
FDIBA2009: raises 100 to 200
s70n3fac3: folds 
Uncalled bet (100) returned to FDIBA2009
FDIBA2009 collected 200 from pot
*** SUMMARY ***
Total pot 200 | Rake 0 
Seat 1: s70n3fac3 (big blind) folded before Flop
Seat 2: FDIBA2009 (button) (small blind) collected (200)



PokerStars Home Game Hand #226759172849: {Club #4781089}  Hold'em No Limit (50/100) - 2021/05/15 0:39:50 EET [2021/05/14 17:39:50 ET]
Table 'VTTP NLHE' 2-max (Play Money) Seat #1 is the button
Seat 1: s70n3fac3 (2093 in chips) 
Seat 2: FDIBA2009 (11970 in chips) 
s70n3fac3: posts small blind 50
FDIBA2009: posts big blind 100
*** HOLE CARDS ***
s70n3fac3: raises 100 to 200
FDIBA2009: calls 100
*** FLOP *** [4c Kc Qs]
FDIBA2009: checks 
s70n3fac3: bets 200
FDIBA2009: folds 
Uncalled bet (200) returned to s70n3fac3
s70n3fac3 collected 378 from pot
s70n3fac3: doesn't show hand 
*** SUMMARY ***
Total pot 400 | Rake 22 
Board [4c Kc Qs]
Seat 1: s70n3fac3 (button) (small blind) collected (378)
Seat 2: FDIBA2009 (big blind) folded on the Flop



PokerStars Home Game Hand #226759178662: {Club #4781089}  Hold'em No Limit (50/100) - 2021/05/15 0:40:00 EET [2021/05/14 17:40:00 ET]
Table 'VTTP NLHE' 2-max (Play Money) Seat #2 is the button
Seat 1: s70n3fac3 (2271 in chips) 
Seat 2: FDIBA2009 (11770 in chips) 
FDIBA2009: posts small blind 50
s70n3fac3: posts big blind 100
*** HOLE CARDS ***
FDIBA2009: raises 100 to 200
s70n3fac3: calls 100
*** FLOP *** [6s 3h Th]
s70n3fac3: checks 
FDIBA2009: checks 
*** TURN *** [6s 3h Th] [Ks]
s70n3fac3: bets 200
FDIBA2009: calls 200
*** RIVER *** [6s 3h Th Ks] [9c]
s70n3fac3: bets 400
FDIBA2009: calls 400
*** SHOW DOWN ***
s70n3fac3: shows [4d Kc] (a pair of Kings)
FDIBA2009: mucks hand 
s70n3fac3 collected 1512 from pot
*** SUMMARY ***
Total pot 1600 | Rake 88 
Board [6s 3h Th Ks 9c]
Seat 1: s70n3fac3 (big blind) showed [4d Kc] and won (1512) with a pair of Kings
Seat 2: FDIBA2009 (button) (small blind) mucked [7c 9d]



PokerStars Home Game Hand #226759194539: {Club #4781089}  Hold'em No Limit (50/100) - 2021/05/15 0:40:29 EET [2021/05/14 17:40:29 ET]
Table 'VTTP NLHE' 2-max (Play Money) Seat #1 is the button
Seat 1: s70n3fac3 (2983 in chips) 
Seat 2: FDIBA2009 (10970 in chips) 
s70n3fac3: posts small blind 50
FDIBA2009: posts big blind 100
*** HOLE CARDS ***
s70n3fac3: raises 100 to 200
FDIBA2009: folds 
Uncalled bet (100) returned to s70n3fac3
s70n3fac3 collected 200 from pot
s70n3fac3: doesn't show hand 
*** SUMMARY ***
Total pot 200 | Rake 0 
Seat 1: s70n3fac3 (button) (small blind) collected (200)
Seat 2: FDIBA2009 (big blind) folded before Flop



PokerStars Home Game Hand #226759197534: {Club #4781089}  Hold'em No Limit (50/100) - 2021/05/15 0:40:34 EET [2021/05/14 17:40:34 ET]
Table 'VTTP NLHE' 2-max (Play Money) Seat #2 is the button
Seat 1: s70n3fac3 (3083 in chips) 
Seat 2: FDIBA2009 (10870 in chips) 
FDIBA2009: posts small blind 50
s70n3fac3: posts big blind 100
*** HOLE CARDS ***
FDIBA2009: raises 100 to 200
s70n3fac3: folds 
Uncalled bet (100) returned to FDIBA2009
FDIBA2009 collected 200 from pot
*** SUMMARY ***
Total pot 200 | Rake 0 
Seat 1: s70n3fac3 (big blind) folded before Flop
Seat 2: FDIBA2009 (button) (small blind) collected (200)



PokerStars Home Game Hand #226759200681: {Club #4781089}  Hold'em No Limit (50/100) - 2021/05/15 0:40:39 EET [2021/05/14 17:40:39 ET]
Table 'VTTP NLHE' 2-max (Play Money) Seat #1 is the button
Seat 1: s70n3fac3 (2983 in chips) 
Seat 2: FDIBA2009 (10970 in chips) 
s70n3fac3: posts small blind 50
FDIBA2009: posts big blind 100
*** HOLE CARDS ***
s70n3fac3: raises 100 to 200
FDIBA2009: raises 300 to 500
s70n3fac3: calls 300
*** FLOP *** [Ac 4c Ks]
FDIBA2009: checks 
s70n3fac3: bets 400
FDIBA2009: folds 
Uncalled bet (400) returned to s70n3fac3
s70n3fac3 collected 945 from pot
s70n3fac3: doesn't show hand 
*** SUMMARY ***
Total pot 1000 | Rake 55 
Board [Ac 4c Ks]
Seat 1: s70n3fac3 (button) (small blind) collected (945)
Seat 2: FDIBA2009 (big blind) folded on the Flop



PokerStars Home Game Hand #226759215099: {Club #4781089}  Hold'em No Limit (50/100) - 2021/05/15 0:41:05 EET [2021/05/14 17:41:05 ET]
Table 'VTTP NLHE' 2-max (Play Money) Seat #2 is the button
Seat 1: s70n3fac3 (3428 in chips) 
Seat 2: FDIBA2009 (10470 in chips) 
FDIBA2009: posts small blind 50
s70n3fac3: posts big blind 100
*** HOLE CARDS ***
FDIBA2009: raises 100 to 200
s70n3fac3: calls 100
*** FLOP *** [Qs 5c 9c]
s70n3fac3: checks 
FDIBA2009: checks 
*** TURN *** [Qs 5c 9c] [3h]
s70n3fac3: bets 200
FDIBA2009: folds 
Uncalled bet (200) returned to s70n3fac3
s70n3fac3 collected 378 from pot
s70n3fac3: doesn't show hand 
*** SUMMARY ***
Total pot 400 | Rake 22 
Board [Qs 5c 9c 3h]
Seat 1: s70n3fac3 (big blind) collected (378)
Seat 2: FDIBA2009 (button) (small blind) folded on the Turn



PokerStars Home Game Hand #226759222377: {Club #4781089}  Hold'em No Limit (50/100) - 2021/05/15 0:41:17 EET [2021/05/14 17:41:17 ET]
Table 'VTTP NLHE' 2-max (Play Money) Seat #1 is the button
Seat 1: s70n3fac3 (3606 in chips) 
Seat 2: FDIBA2009 (10270 in chips) 
s70n3fac3: posts small blind 50
FDIBA2009: posts big blind 100
*** HOLE CARDS ***
s70n3fac3: folds 
Uncalled bet (50) returned to FDIBA2009
FDIBA2009 collected 100 from pot
*** SUMMARY ***
Total pot 100 | Rake 0 
Seat 1: s70n3fac3 (button) (small blind) folded before Flop
Seat 2: FDIBA2009 (big blind) collected (100)



PokerStars Home Game Hand #226759224584: {Club #4781089}  Hold'em No Limit (50/100) - 2021/05/15 0:41:21 EET [2021/05/14 17:41:21 ET]
Table 'VTTP NLHE' 2-max (Play Money) Seat #2 is the button
Seat 1: s70n3fac3 (3556 in chips) 
Seat 2: FDIBA2009 (10320 in chips) 
FDIBA2009: posts small blind 50
s70n3fac3: posts big blind 100
*** HOLE CARDS ***
FDIBA2009: raises 100 to 200
s70n3fac3: calls 100
*** FLOP *** [3d 2h 4s]
s70n3fac3: checks 
FDIBA2009: bets 100
s70n3fac3: calls 100
*** TURN *** [3d 2h 4s] [4d]
s70n3fac3: checks 
FDIBA2009: bets 567
s70n3fac3: calls 567
*** RIVER *** [3d 2h 4s 4d] [Qd]
s70n3fac3: checks 
FDIBA2009: checks 
*** SHOW DOWN ***
s70n3fac3: shows [3s Kd] (two pair, Fours and Threes)
FDIBA2009: mucks hand 
s70n3fac3 collected 1639 from pot
*** SUMMARY ***
Total pot 1734 | Rake 95 
Board [3d 2h 4s 4d Qd]
Seat 1: s70n3fac3 (big blind) showed [3s Kd] and won (1639) with two pair, Fours and Threes
Seat 2: FDIBA2009 (button) (small blind) mucked [8s 6c]



PokerStars Home Game Hand #226759238083: {Club #4781089}  Hold'em No Limit (50/100) - 2021/05/15 0:41:45 EET [2021/05/14 17:41:45 ET]
Table 'VTTP NLHE' 2-max (Play Money) Seat #1 is the button
Seat 1: s70n3fac3 (4328 in chips) 
Seat 2: FDIBA2009 (9453 in chips) 
s70n3fac3: posts small blind 50
FDIBA2009: posts big blind 100
*** HOLE CARDS ***
s70n3fac3: raises 100 to 200
FDIBA2009: raises 400 to 600
s70n3fac3: calls 400
*** FLOP *** [8s Jc 5d]
FDIBA2009: bets 1134
s70n3fac3: raises 2594 to 3728 and is all-in
FDIBA2009: folds 
Uncalled bet (2594) returned to s70n3fac3
s70n3fac3 collected 3277 from pot
s70n3fac3: doesn't show hand 
*** SUMMARY ***
Total pot 3468 | Rake 191 
Board [8s Jc 5d]
Seat 1: s70n3fac3 (button) (small blind) collected (3277)
Seat 2: FDIBA2009 (big blind) folded on the Flop



PokerStars Home Game Hand #226759257925: {Club #4781089}  Hold'em No Limit (50/100) - 2021/05/15 0:42:20 EET [2021/05/14 17:42:20 ET]
Table 'VTTP NLHE' 2-max (Play Money) Seat #2 is the button
Seat 1: s70n3fac3 (5871 in chips) 
Seat 2: FDIBA2009 (7719 in chips) 
FDIBA2009: posts small blind 50
s70n3fac3: posts big blind 100
*** HOLE CARDS ***
FDIBA2009: raises 100 to 200
s70n3fac3: calls 100
*** FLOP *** [Kh 3c 3h]
s70n3fac3: checks 
FDIBA2009: bets 100
s70n3fac3: folds 
Uncalled bet (100) returned to FDIBA2009
FDIBA2009 collected 378 from pot
*** SUMMARY ***
Total pot 400 | Rake 22 
Board [Kh 3c 3h]
Seat 1: s70n3fac3 (big blind) folded on the Flop
Seat 2: FDIBA2009 (button) (small blind) collected (378)



PokerStars Home Game Hand #226759263900: {Club #4781089}  Hold'em No Limit (50/100) - 2021/05/15 0:42:31 EET [2021/05/14 17:42:31 ET]
Table 'VTTP NLHE' 2-max (Play Money) Seat #1 is the button
Seat 1: s70n3fac3 (5671 in chips) 
Seat 2: FDIBA2009 (7897 in chips) 
s70n3fac3: posts small blind 50
FDIBA2009: posts big blind 100
*** HOLE CARDS ***
s70n3fac3: raises 100 to 200
FDIBA2009: raises 400 to 600
s70n3fac3: calls 400
*** FLOP *** [As 3s Qs]
FDIBA2009: checks 
s70n3fac3: checks 
*** TURN *** [As 3s Qs] [Th]
FDIBA2009: bets 567
s70n3fac3: folds 
Uncalled bet (567) returned to FDIBA2009
FDIBA2009 collected 1134 from pot
*** SUMMARY ***
Total pot 1200 | Rake 66 
Board [As 3s Qs Th]
Seat 1: s70n3fac3 (button) (small blind) folded on the Turn
Seat 2: FDIBA2009 (big blind) collected (1134)



PokerStars Home Game Hand #226759278802: {Club #4781089}  Hold'em No Limit (50/100) - 2021/05/15 0:42:57 EET [2021/05/14 17:42:57 ET]
Table 'VTTP NLHE' 2-max (Play Money) Seat #2 is the button
Seat 1: s70n3fac3 (5071 in chips) 
Seat 2: FDIBA2009 (8431 in chips) 
FDIBA2009: posts small blind 50
s70n3fac3: posts big blind 100
*** HOLE CARDS ***
FDIBA2009: raises 100 to 200
s70n3fac3: folds 
Uncalled bet (100) returned to FDIBA2009
FDIBA2009 collected 200 from pot
*** SUMMARY ***
Total pot 200 | Rake 0 
Seat 1: s70n3fac3 (big blind) folded before Flop
Seat 2: FDIBA2009 (button) (small blind) collected (200)



PokerStars Home Game Hand #226759282165: {Club #4781089}  Hold'em No Limit (50/100) - 2021/05/15 0:43:03 EET [2021/05/14 17:43:03 ET]
Table 'VTTP NLHE' 2-max (Play Money) Seat #1 is the button
Seat 1: s70n3fac3 (4971 in chips) 
Seat 2: FDIBA2009 (8531 in chips) 
s70n3fac3: posts small blind 50
FDIBA2009: posts big blind 100
*** HOLE CARDS ***
s70n3fac3: folds 
Uncalled bet (50) returned to FDIBA2009
FDIBA2009 collected 100 from pot
*** SUMMARY ***
Total pot 100 | Rake 0 
Seat 1: s70n3fac3 (button) (small blind) folded before Flop
Seat 2: FDIBA2009 (big blind) collected (100)



PokerStars Home Game Hand #226759284382: {Club #4781089}  Hold'em No Limit (50/100) - 2021/05/15 0:43:07 EET [2021/05/14 17:43:07 ET]
Table 'VTTP NLHE' 2-max (Play Money) Seat #2 is the button
Seat 1: s70n3fac3 (4921 in chips) 
Seat 2: FDIBA2009 (8581 in chips) 
FDIBA2009: posts small blind 50
s70n3fac3: posts big blind 100
*** HOLE CARDS ***
FDIBA2009: raises 100 to 200
s70n3fac3: calls 100
*** FLOP *** [3c 8d Qd]
s70n3fac3: checks 
FDIBA2009: checks 
*** TURN *** [3c 8d Qd] [2h]
s70n3fac3: checks 
FDIBA2009: bets 189
s70n3fac3: calls 189
*** RIVER *** [3c 8d Qd 2h] [3h]
s70n3fac3: checks 
FDIBA2009: checks 
*** SHOW DOWN ***
s70n3fac3: shows [Ah 7c] (a pair of Threes)
FDIBA2009: shows [2c 7s] (two pair, Threes and Deuces)
FDIBA2009 collected 735 from pot
*** SUMMARY ***
Total pot 778 | Rake 43 
Board [3c 8d Qd 2h 3h]
Seat 1: s70n3fac3 (big blind) showed [Ah 7c] and lost with a pair of Threes
Seat 2: FDIBA2009 (button) (small blind) showed [2c 7s] and won (735) with two pair, Threes and Deuces



PokerStars Home Game Hand #226759294084: {Club #4781089}  Hold'em No Limit (50/100) - 2021/05/15 0:43:24 EET [2021/05/14 17:43:24 ET]
Table 'VTTP NLHE' 2-max (Play Money) Seat #1 is the button
Seat 1: s70n3fac3 (4532 in chips) 
Seat 2: FDIBA2009 (8927 in chips) 
s70n3fac3: posts small blind 50
FDIBA2009: posts big blind 100
*** HOLE CARDS ***
s70n3fac3: raises 100 to 200
FDIBA2009: raises 400 to 600
s70n3fac3: folds 
Uncalled bet (400) returned to FDIBA2009
FDIBA2009 collected 400 from pot
*** SUMMARY ***
Total pot 400 | Rake 0 
Seat 1: s70n3fac3 (button) (small blind) folded before Flop
Seat 2: FDIBA2009 (big blind) collected (400)



PokerStars Home Game Hand #226759299107: {Club #4781089}  Hold'em No Limit (50/100) - 2021/05/15 0:43:33 EET [2021/05/14 17:43:33 ET]
Table 'VTTP NLHE' 2-max (Play Money) Seat #2 is the button
Seat 1: s70n3fac3 (4332 in chips) 
Seat 2: FDIBA2009 (9127 in chips) 
FDIBA2009: posts small blind 50
s70n3fac3: posts big blind 100
*** HOLE CARDS ***
FDIBA2009: raises 100 to 200
s70n3fac3: calls 100
*** FLOP *** [7s 7d 7c]
s70n3fac3: checks 
FDIBA2009: checks 
*** TURN *** [7s 7d 7c] [9s]
s70n3fac3: checks 
FDIBA2009: checks 
*** RIVER *** [7s 7d 7c 9s] [Ts]
s70n3fac3: bets 600
FDIBA2009: calls 600
*** SHOW DOWN ***
s70n3fac3: shows [Td 3d] (a full house, Sevens full of Tens)
FDIBA2009: mucks hand 
s70n3fac3 collected 1512 from pot
*** SUMMARY ***
Total pot 1600 | Rake 88 
Board [7s 7d 7c 9s Ts]
Seat 1: s70n3fac3 (big blind) showed [Td 3d] and won (1512) with a full house, Sevens full of Tens
Seat 2: FDIBA2009 (button) (small blind) mucked [Qh 9d]



PokerStars Home Game Hand #226759310134: {Club #4781089}  Hold'em No Limit (50/100) - 2021/05/15 0:43:53 EET [2021/05/14 17:43:53 ET]
Table 'VTTP NLHE' 2-max (Play Money) Seat #1 is the button
Seat 1: s70n3fac3 (5044 in chips) 
Seat 2: FDIBA2009 (8327 in chips) 
s70n3fac3: posts small blind 50
FDIBA2009: posts big blind 100
*** HOLE CARDS ***
s70n3fac3: raises 100 to 200
FDIBA2009: raises 400 to 600
s70n3fac3: calls 400
*** FLOP *** [Qh 5h 9c]
FDIBA2009: bets 1134
s70n3fac3: calls 1134
*** TURN *** [Qh 5h 9c] [7d]
FDIBA2009: bets 6593 and is all-in
s70n3fac3: calls 3310 and is all-in
Uncalled bet (3283) returned to FDIBA2009
*** RIVER *** [Qh 5h 9c 7d] [8d]
*** SHOW DOWN ***
FDIBA2009: shows [9s 2h] (a pair of Nines)
s70n3fac3: shows [5c 5d] (three of a kind, Fives)
s70n3fac3 collected 9533 from pot
*** SUMMARY ***
Total pot 10088 | Rake 555 
Board [Qh 5h 9c 7d 8d]
Seat 1: s70n3fac3 (button) (small blind) showed [5c 5d] and won (9533) with three of a kind, Fives
Seat 2: FDIBA2009 (big blind) showed [9s 2h] and lost with a pair of Nines



PokerStars Home Game Hand #226759325314: {Club #4781089}  Hold'em No Limit (50/100) - 2021/05/15 0:44:19 EET [2021/05/14 17:44:19 ET]
Table 'VTTP NLHE' 2-max (Play Money) Seat #2 is the button
Seat 1: s70n3fac3 (9533 in chips) 
Seat 2: FDIBA2009 (3283 in chips) 
FDIBA2009: posts small blind 50
s70n3fac3: posts big blind 100
*** HOLE CARDS ***
FDIBA2009: raises 100 to 200
s70n3fac3: calls 100
*** FLOP *** [Kh 7d Qd]
s70n3fac3: checks 
FDIBA2009: bets 378
s70n3fac3: folds 
Uncalled bet (378) returned to FDIBA2009
FDIBA2009 collected 378 from pot
*** SUMMARY ***
Total pot 400 | Rake 22 
Board [Kh 7d Qd]
Seat 1: s70n3fac3 (big blind) folded on the Flop
Seat 2: FDIBA2009 (button) (small blind) collected (378)



PokerStars Home Game Hand #226759331458: {Club #4781089}  Hold'em No Limit (50/100) - 2021/05/15 0:44:30 EET [2021/05/14 17:44:30 ET]
Table 'VTTP NLHE' 2-max (Play Money) Seat #1 is the button
Seat 1: s70n3fac3 (9333 in chips) 
Seat 2: FDIBA2009 (3461 in chips) 
s70n3fac3: posts small blind 50
FDIBA2009: posts big blind 100
*** HOLE CARDS ***
s70n3fac3: raises 100 to 200
FDIBA2009: calls 100
*** FLOP *** [5c 6c 3s]
FDIBA2009: checks 
s70n3fac3: checks 
*** TURN *** [5c 6c 3s] [7s]
FDIBA2009: checks 
s70n3fac3: bets 200
FDIBA2009: folds 
Uncalled bet (200) returned to s70n3fac3
s70n3fac3 collected 378 from pot
s70n3fac3: doesn't show hand 
*** SUMMARY ***
Total pot 400 | Rake 22 
Board [5c 6c 3s 7s]
Seat 1: s70n3fac3 (button) (small blind) collected (378)
Seat 2: FDIBA2009 (big blind) folded on the Turn



PokerStars Home Game Hand #226759340421: {Club #4781089}  Hold'em No Limit (50/100) - 2021/05/15 0:44:46 EET [2021/05/14 17:44:46 ET]
Table 'VTTP NLHE' 2-max (Play Money) Seat #2 is the button
Seat 1: s70n3fac3 (9511 in chips) 
Seat 2: FDIBA2009 (3261 in chips) 
FDIBA2009: posts small blind 50
s70n3fac3: posts big blind 100
*** HOLE CARDS ***
FDIBA2009: raises 100 to 200
s70n3fac3: calls 100
*** FLOP *** [Jh 8s Ks]
s70n3fac3: checks 
FDIBA2009: bets 378
s70n3fac3: folds 
Uncalled bet (378) returned to FDIBA2009
FDIBA2009 collected 378 from pot
*** SUMMARY ***
Total pot 400 | Rake 22 
Board [Jh 8s Ks]
Seat 1: s70n3fac3 (big blind) folded on the Flop
Seat 2: FDIBA2009 (button) (small blind) collected (378)



PokerStars Home Game Hand #226759346965: {Club #4781089}  Hold'em No Limit (50/100) - 2021/05/15 0:44:58 EET [2021/05/14 17:44:58 ET]
Table 'VTTP NLHE' 2-max (Play Money) Seat #1 is the button
Seat 1: s70n3fac3 (9311 in chips) 
Seat 2: FDIBA2009 (3439 in chips) 
s70n3fac3: posts small blind 50
FDIBA2009: posts big blind 100
*** HOLE CARDS ***
s70n3fac3: folds 
Uncalled bet (50) returned to FDIBA2009
FDIBA2009 collected 100 from pot
*** SUMMARY ***
Total pot 100 | Rake 0 
Seat 1: s70n3fac3 (button) (small blind) folded before Flop
Seat 2: FDIBA2009 (big blind) collected (100)



PokerStars Home Game Hand #226759349189: {Club #4781089}  Hold'em No Limit (50/100) - 2021/05/15 0:45:02 EET [2021/05/14 17:45:02 ET]
Table 'VTTP NLHE' 2-max (Play Money) Seat #2 is the button
Seat 1: s70n3fac3 (9261 in chips) 
Seat 2: FDIBA2009 (3489 in chips) 
FDIBA2009: posts small blind 50
s70n3fac3: posts big blind 100
*** HOLE CARDS ***
FDIBA2009: raises 200 to 300
s70n3fac3: calls 200
*** FLOP *** [4d 6d Qh]
s70n3fac3: checks 
FDIBA2009: checks 
*** TURN *** [4d 6d Qh] [6h]
s70n3fac3: checks 
FDIBA2009: bets 283
s70n3fac3: calls 283
*** RIVER *** [4d 6d Qh 6h] [9c]
s70n3fac3: checks 
FDIBA2009: bets 1402
s70n3fac3: folds 
Uncalled bet (1402) returned to FDIBA2009
FDIBA2009 collected 1102 from pot
*** SUMMARY ***
Total pot 1166 | Rake 64 
Board [4d 6d Qh 6h 9c]
Seat 1: s70n3fac3 (big blind) folded on the River
Seat 2: FDIBA2009 (button) (small blind) collected (1102)



PokerStars Home Game Hand #226759369925: {Club #4781089}  Hold'em No Limit (50/100) - 2021/05/15 0:45:39 EET [2021/05/14 17:45:39 ET]
Table 'VTTP NLHE' 2-max (Play Money) Seat #1 is the button
Seat 1: s70n3fac3 (8678 in chips) 
Seat 2: FDIBA2009 (4008 in chips) 
s70n3fac3: posts small blind 50
FDIBA2009: posts big blind 100
*** HOLE CARDS ***
s70n3fac3: folds 
Uncalled bet (50) returned to FDIBA2009
FDIBA2009 collected 100 from pot
*** SUMMARY ***
Total pot 100 | Rake 0 
Seat 1: s70n3fac3 (button) (small blind) folded before Flop
Seat 2: FDIBA2009 (big blind) collected (100)



PokerStars Home Game Hand #226759371995: {Club #4781089}  Hold'em No Limit (50/100) - 2021/05/15 0:45:42 EET [2021/05/14 17:45:42 ET]
Table 'VTTP NLHE' 2-max (Play Money) Seat #2 is the button
Seat 1: s70n3fac3 (8628 in chips) 
Seat 2: FDIBA2009 (4058 in chips) 
FDIBA2009: posts small blind 50
s70n3fac3: posts big blind 100
*** HOLE CARDS ***
FDIBA2009: raises 100 to 200
s70n3fac3: folds 
Uncalled bet (100) returned to FDIBA2009
FDIBA2009 collected 200 from pot
*** SUMMARY ***
Total pot 200 | Rake 0 
Seat 1: s70n3fac3 (big blind) folded before Flop
Seat 2: FDIBA2009 (button) (small blind) collected (200)



PokerStars Home Game Hand #226759375429: {Club #4781089}  Hold'em No Limit (50/100) - 2021/05/15 0:45:49 EET [2021/05/14 17:45:49 ET]
Table 'VTTP NLHE' 2-max (Play Money) Seat #1 is the button
Seat 1: s70n3fac3 (8528 in chips) 
Seat 2: FDIBA2009 (4158 in chips) 
s70n3fac3: posts small blind 50
FDIBA2009: posts big blind 100
*** HOLE CARDS ***
s70n3fac3: raises 100 to 200
FDIBA2009: raises 3958 to 4158 and is all-in
s70n3fac3: folds 
Uncalled bet (3958) returned to FDIBA2009
FDIBA2009 collected 400 from pot
*** SUMMARY ***
Total pot 400 | Rake 0 
Seat 1: s70n3fac3 (button) (small blind) folded before Flop
Seat 2: FDIBA2009 (big blind) collected (400)



PokerStars Home Game Hand #226759380826: {Club #4781089}  Hold'em No Limit (50/100) - 2021/05/15 0:45:58 EET [2021/05/14 17:45:58 ET]
Table 'VTTP NLHE' 2-max (Play Money) Seat #2 is the button
Seat 1: s70n3fac3 (8328 in chips) 
Seat 2: FDIBA2009 (4358 in chips) 
FDIBA2009: posts small blind 50
s70n3fac3: posts big blind 100
*** HOLE CARDS ***
FDIBA2009: raises 100 to 200
s70n3fac3: folds 
Uncalled bet (100) returned to FDIBA2009
FDIBA2009 collected 200 from pot
*** SUMMARY ***
Total pot 200 | Rake 0 
Seat 1: s70n3fac3 (big blind) folded before Flop
Seat 2: FDIBA2009 (button) (small blind) collected (200)



PokerStars Home Game Hand #226759383795: {Club #4781089}  Hold'em No Limit (50/100) - 2021/05/15 0:46:04 EET [2021/05/14 17:46:04 ET]
Table 'VTTP NLHE' 2-max (Play Money) Seat #1 is the button
Seat 1: s70n3fac3 (8228 in chips) 
Seat 2: FDIBA2009 (4458 in chips) 
s70n3fac3: posts small blind 50
FDIBA2009: posts big blind 100
*** HOLE CARDS ***
s70n3fac3: calls 50
FDIBA2009: checks 
*** FLOP *** [Jh Qs 5h]
FDIBA2009: checks 
s70n3fac3: bets 100
FDIBA2009: folds 
Uncalled bet (100) returned to s70n3fac3
s70n3fac3 collected 189 from pot
s70n3fac3: doesn't show hand 
*** SUMMARY ***
Total pot 200 | Rake 11 
Board [Jh Qs 5h]
Seat 1: s70n3fac3 (button) (small blind) collected (189)
Seat 2: FDIBA2009 (big blind) folded on the Flop



PokerStars Home Game Hand #226759388905: {Club #4781089}  Hold'em No Limit (50/100) - 2021/05/15 0:46:13 EET [2021/05/14 17:46:13 ET]
Table 'VTTP NLHE' 2-max (Play Money) Seat #2 is the button
Seat 1: s70n3fac3 (8317 in chips) 
Seat 2: FDIBA2009 (4358 in chips) 
FDIBA2009: posts small blind 50
s70n3fac3: posts big blind 100
*** HOLE CARDS ***
FDIBA2009: raises 100 to 200
s70n3fac3: calls 100
*** FLOP *** [8h 9h 9s]
s70n3fac3: checks 
FDIBA2009: bets 189
s70n3fac3: calls 189
*** TURN *** [8h 9h 9s] [Ad]
s70n3fac3: checks 
FDIBA2009: checks 
*** RIVER *** [8h 9h 9s Ad] [3c]
s70n3fac3: checks 
FDIBA2009: bets 735
s70n3fac3: folds 
Uncalled bet (735) returned to FDIBA2009
FDIBA2009 collected 735 from pot
*** SUMMARY ***
Total pot 778 | Rake 43 
Board [8h 9h 9s Ad 3c]
Seat 1: s70n3fac3 (big blind) folded on the River
Seat 2: FDIBA2009 (button) (small blind) collected (735)



PokerStars Home Game Hand #226759399896: {Club #4781089}  Hold'em No Limit (50/100) - 2021/05/15 0:46:33 EET [2021/05/14 17:46:33 ET]
Table 'VTTP NLHE' 2-max (Play Money) Seat #1 is the button
Seat 1: s70n3fac3 (7928 in chips) 
Seat 2: FDIBA2009 (4704 in chips) 
s70n3fac3: posts small blind 50
FDIBA2009: posts big blind 100
*** HOLE CARDS ***
s70n3fac3: raises 100 to 200
FDIBA2009: calls 100
*** FLOP *** [7s 8h 4s]
FDIBA2009: checks 
s70n3fac3: checks 
*** TURN *** [7s 8h 4s] [6h]
FDIBA2009: bets 189
s70n3fac3: folds 
Uncalled bet (189) returned to FDIBA2009
FDIBA2009 collected 378 from pot
*** SUMMARY ***
Total pot 400 | Rake 22 
Board [7s 8h 4s 6h]
Seat 1: s70n3fac3 (button) (small blind) folded on the Turn
Seat 2: FDIBA2009 (big blind) collected (378)



PokerStars Home Game Hand #226759408700: {Club #4781089}  Hold'em No Limit (50/100) - 2021/05/15 0:46:48 EET [2021/05/14 17:46:48 ET]
Table 'VTTP NLHE' 2-max (Play Money) Seat #2 is the button
Seat 1: s70n3fac3 (7728 in chips) 
Seat 2: FDIBA2009 (4882 in chips) 
FDIBA2009: posts small blind 50
s70n3fac3: posts big blind 100
*** HOLE CARDS ***
FDIBA2009: raises 100 to 200
s70n3fac3: folds 
Uncalled bet (100) returned to FDIBA2009
FDIBA2009 collected 200 from pot
*** SUMMARY ***
Total pot 200 | Rake 0 
Seat 1: s70n3fac3 (big blind) folded before Flop
Seat 2: FDIBA2009 (button) (small blind) collected (200)



PokerStars Home Game Hand #226759411638: {Club #4781089}  Hold'em No Limit (50/100) - 2021/05/15 0:46:54 EET [2021/05/14 17:46:54 ET]
Table 'VTTP NLHE' 2-max (Play Money) Seat #1 is the button
Seat 1: s70n3fac3 (7628 in chips) 
Seat 2: FDIBA2009 (4982 in chips) 
s70n3fac3: posts small blind 50
FDIBA2009: posts big blind 100
*** HOLE CARDS ***
s70n3fac3: raises 100 to 200
FDIBA2009: calls 100
*** FLOP *** [9d 3s 4s]
FDIBA2009: checks 
s70n3fac3: bets 200
FDIBA2009: folds 
Uncalled bet (200) returned to s70n3fac3
s70n3fac3 collected 378 from pot
s70n3fac3: doesn't show hand 
*** SUMMARY ***
Total pot 400 | Rake 22 
Board [9d 3s 4s]
Seat 1: s70n3fac3 (button) (small blind) collected (378)
Seat 2: FDIBA2009 (big blind) folded on the Flop



PokerStars Home Game Hand #226759417762: {Club #4781089}  Hold'em No Limit (50/100) - 2021/05/15 0:47:05 EET [2021/05/14 17:47:05 ET]
Table 'VTTP NLHE' 2-max (Play Money) Seat #2 is the button
Seat 1: s70n3fac3 (7806 in chips) 
Seat 2: FDIBA2009 (4782 in chips) 
FDIBA2009: posts small blind 50
s70n3fac3: posts big blind 100
*** HOLE CARDS ***
FDIBA2009: raises 100 to 200
s70n3fac3: folds 
Uncalled bet (100) returned to FDIBA2009
FDIBA2009 collected 200 from pot
*** SUMMARY ***
Total pot 200 | Rake 0 
Seat 1: s70n3fac3 (big blind) folded before Flop
Seat 2: FDIBA2009 (button) (small blind) collected (200)



PokerStars Home Game Hand #226759420646: {Club #4781089}  Hold'em No Limit (50/100) - 2021/05/15 0:47:10 EET [2021/05/14 17:47:10 ET]
Table 'VTTP NLHE' 2-max (Play Money) Seat #1 is the button
Seat 1: s70n3fac3 (7706 in chips) 
Seat 2: FDIBA2009 (4882 in chips) 
s70n3fac3: posts small blind 50
FDIBA2009: posts big blind 100
*** HOLE CARDS ***
s70n3fac3: calls 50
FDIBA2009: checks 
*** FLOP *** [2c As Jh]
FDIBA2009: bets 189
s70n3fac3: folds 
Uncalled bet (189) returned to FDIBA2009
FDIBA2009 collected 189 from pot
*** SUMMARY ***
Total pot 200 | Rake 11 
Board [2c As Jh]
Seat 1: s70n3fac3 (button) (small blind) folded on the Flop
Seat 2: FDIBA2009 (big blind) collected (189)



PokerStars Home Game Hand #226759426887: {Club #4781089}  Hold'em No Limit (50/100) - 2021/05/15 0:47:21 EET [2021/05/14 17:47:21 ET]
Table 'VTTP NLHE' 2-max (Play Money) Seat #2 is the button
Seat 1: s70n3fac3 (7606 in chips) 
Seat 2: FDIBA2009 (4971 in chips) 
FDIBA2009: posts small blind 50
s70n3fac3: posts big blind 100
*** HOLE CARDS ***
FDIBA2009: raises 100 to 200
s70n3fac3: calls 100
*** FLOP *** [Ts Ac Js]
s70n3fac3: checks 
FDIBA2009: bets 378
s70n3fac3: calls 378
*** TURN *** [Ts Ac Js] [8h]
s70n3fac3: checks 
FDIBA2009: checks 
*** RIVER *** [Ts Ac Js 8h] [3d]
s70n3fac3: checks 
FDIBA2009: checks 
*** SHOW DOWN ***
s70n3fac3: shows [6s Ks] (high card Ace)
FDIBA2009: shows [Jc 9s] (a pair of Jacks)
FDIBA2009 collected 1092 from pot
*** SUMMARY ***
Total pot 1156 | Rake 64 
Board [Ts Ac Js 8h 3d]
Seat 1: s70n3fac3 (big blind) showed [6s Ks] and lost with high card Ace
Seat 2: FDIBA2009 (button) (small blind) showed [Jc 9s] and won (1092) with a pair of Jacks



PokerStars Home Game Hand #226759438531: {Club #4781089}  Hold'em No Limit (50/100) - 2021/05/15 0:47:42 EET [2021/05/14 17:47:42 ET]
Table 'VTTP NLHE' 2-max (Play Money) Seat #1 is the button
Seat 1: s70n3fac3 (7028 in chips) 
Seat 2: FDIBA2009 (5485 in chips) 
s70n3fac3: posts small blind 50
FDIBA2009: posts big blind 100
*** HOLE CARDS ***
s70n3fac3: calls 50
FDIBA2009: raises 100 to 200
s70n3fac3: calls 100
*** FLOP *** [Ts Ks Kd]
FDIBA2009: checks 
s70n3fac3: bets 200
FDIBA2009: folds 
Uncalled bet (200) returned to s70n3fac3
s70n3fac3 collected 378 from pot
s70n3fac3: doesn't show hand 
*** SUMMARY ***
Total pot 400 | Rake 22 
Board [Ts Ks Kd]
Seat 1: s70n3fac3 (button) (small blind) collected (378)
Seat 2: FDIBA2009 (big blind) folded on the Flop



PokerStars Home Game Hand #226759446686: {Club #4781089}  Hold'em No Limit (50/100) - 2021/05/15 0:47:56 EET [2021/05/14 17:47:56 ET]
Table 'VTTP NLHE' 2-max (Play Money) Seat #2 is the button
Seat 1: s70n3fac3 (7206 in chips) 
Seat 2: FDIBA2009 (5285 in chips) 
FDIBA2009: posts small blind 50
s70n3fac3: posts big blind 100
*** HOLE CARDS ***
FDIBA2009: raises 100 to 200
s70n3fac3: calls 100
*** FLOP *** [Qd Jc Kd]
s70n3fac3: checks 
FDIBA2009: bets 189
s70n3fac3: calls 189
*** TURN *** [Qd Jc Kd] [Qc]
s70n3fac3: checks 
FDIBA2009: bets 367
s70n3fac3: calls 367
*** RIVER *** [Qd Jc Kd Qc] [9d]
s70n3fac3: checks 
FDIBA2009: bets 1429
s70n3fac3: folds 
Uncalled bet (1429) returned to FDIBA2009
FDIBA2009 collected 1429 from pot
*** SUMMARY ***
Total pot 1512 | Rake 83 
Board [Qd Jc Kd Qc 9d]
Seat 1: s70n3fac3 (big blind) folded on the River
Seat 2: FDIBA2009 (button) (small blind) collected (1429)



PokerStars Home Game Hand #226759467972: {Club #4781089}  Hold'em No Limit (50/100) - 2021/05/15 0:48:34 EET [2021/05/14 17:48:34 ET]
Table 'VTTP NLHE' 2-max (Play Money) Seat #1 is the button
Seat 1: s70n3fac3 (6450 in chips) 
Seat 2: FDIBA2009 (5958 in chips) 
s70n3fac3: posts small blind 50
FDIBA2009: posts big blind 100
*** HOLE CARDS ***
s70n3fac3: raises 100 to 200
FDIBA2009: calls 100
*** FLOP *** [9c Js Ac]
FDIBA2009: checks 
s70n3fac3: bets 200
FDIBA2009: folds 
Uncalled bet (200) returned to s70n3fac3
s70n3fac3 collected 378 from pot
s70n3fac3: doesn't show hand 
*** SUMMARY ***
Total pot 400 | Rake 22 
Board [9c Js Ac]
Seat 1: s70n3fac3 (button) (small blind) collected (378)
Seat 2: FDIBA2009 (big blind) folded on the Flop



PokerStars Home Game Hand #226759473450: {Club #4781089}  Hold'em No Limit (50/100) - 2021/05/15 0:48:44 EET [2021/05/14 17:48:44 ET]
Table 'VTTP NLHE' 2-max (Play Money) Seat #2 is the button
Seat 1: s70n3fac3 (6628 in chips) 
Seat 2: FDIBA2009 (5758 in chips) 
FDIBA2009: posts small blind 50
s70n3fac3: posts big blind 100
*** HOLE CARDS ***
FDIBA2009: raises 100 to 200
s70n3fac3: calls 100
*** FLOP *** [6h 4s As]
s70n3fac3: checks 
FDIBA2009: checks 
*** TURN *** [6h 4s As] [3s]
s70n3fac3: checks 
FDIBA2009: bets 378
s70n3fac3: folds 
Uncalled bet (378) returned to FDIBA2009
FDIBA2009 collected 378 from pot
*** SUMMARY ***
Total pot 400 | Rake 22 
Board [6h 4s As 3s]
Seat 1: s70n3fac3 (big blind) folded on the Turn
Seat 2: FDIBA2009 (button) (small blind) collected (378)



PokerStars Home Game Hand #226759481620: {Club #4781089}  Hold'em No Limit (50/100) - 2021/05/15 0:48:59 EET [2021/05/14 17:48:59 ET]
Table 'VTTP NLHE' 2-max (Play Money) Seat #1 is the button
Seat 1: s70n3fac3 (6428 in chips) 
Seat 2: FDIBA2009 (5936 in chips) 
s70n3fac3: posts small blind 50
FDIBA2009: posts big blind 100
*** HOLE CARDS ***
s70n3fac3: raises 100 to 200
FDIBA2009: calls 100
*** FLOP *** [Js 7c Qc]
FDIBA2009: checks 
s70n3fac3: bets 200
FDIBA2009: folds 
Uncalled bet (200) returned to s70n3fac3
s70n3fac3 collected 378 from pot
s70n3fac3: doesn't show hand 
*** SUMMARY ***
Total pot 400 | Rake 22 
Board [Js 7c Qc]
Seat 1: s70n3fac3 (button) (small blind) collected (378)
Seat 2: FDIBA2009 (big blind) folded on the Flop



PokerStars Home Game Hand #226759488151: {Club #4781089}  Hold'em No Limit (50/100) - 2021/05/15 0:49:11 EET [2021/05/14 17:49:11 ET]
Table 'VTTP NLHE' 2-max (Play Money) Seat #2 is the button
Seat 1: s70n3fac3 (6606 in chips) 
Seat 2: FDIBA2009 (5736 in chips) 
FDIBA2009: posts small blind 50
s70n3fac3: posts big blind 100
*** HOLE CARDS ***
FDIBA2009: raises 100 to 200
s70n3fac3: calls 100
*** FLOP *** [9d 6s Qs]
s70n3fac3: checks 
FDIBA2009: checks 
*** TURN *** [9d 6s Qs] [Ts]
s70n3fac3: bets 200
FDIBA2009: raises 200 to 400
s70n3fac3: calls 200
*** RIVER *** [9d 6s Qs Ts] [2s]
s70n3fac3: checks 
FDIBA2009: checks 
*** SHOW DOWN ***
s70n3fac3: shows [9s 6d] (a flush, Queen high)
FDIBA2009: mucks hand 
s70n3fac3 collected 1134 from pot
*** SUMMARY ***
Total pot 1200 | Rake 66 
Board [9d 6s Qs Ts 2s]
Seat 1: s70n3fac3 (big blind) showed [9s 6d] and won (1134) with a flush, Queen high
Seat 2: FDIBA2009 (button) (small blind) mucked [Ah Qh]



PokerStars Home Game Hand #226759501139: {Club #4781089}  Hold'em No Limit (50/100) - 2021/05/15 0:49:34 EET [2021/05/14 17:49:34 ET]
Table 'VTTP NLHE' 2-max (Play Money) Seat #1 is the button
Seat 1: s70n3fac3 (7140 in chips) 
Seat 2: FDIBA2009 (5136 in chips) 
s70n3fac3: posts small blind 50
FDIBA2009: posts big blind 100
*** HOLE CARDS ***
s70n3fac3: raises 100 to 200
FDIBA2009: folds 
Uncalled bet (100) returned to s70n3fac3
s70n3fac3 collected 200 from pot
s70n3fac3: doesn't show hand 
*** SUMMARY ***
Total pot 200 | Rake 0 
Seat 1: s70n3fac3 (button) (small blind) collected (200)
Seat 2: FDIBA2009 (big blind) folded before Flop



PokerStars Home Game Hand #226759504492: {Club #4781089}  Hold'em No Limit (50/100) - 2021/05/15 0:49:41 EET [2021/05/14 17:49:41 ET]
Table 'VTTP NLHE' 2-max (Play Money) Seat #2 is the button
Seat 1: s70n3fac3 (7240 in chips) 
Seat 2: FDIBA2009 (5036 in chips) 
FDIBA2009: posts small blind 50
s70n3fac3: posts big blind 100
*** HOLE CARDS ***
FDIBA2009: raises 100 to 200
s70n3fac3: calls 100
*** FLOP *** [4c 9c Tc]
s70n3fac3: checks 
FDIBA2009: checks 
*** TURN *** [4c 9c Tc] [5s]
s70n3fac3: checks 
FDIBA2009: checks 
*** RIVER *** [4c 9c Tc 5s] [8d]
s70n3fac3: checks 
FDIBA2009: bets 100
s70n3fac3: folds 
Uncalled bet (100) returned to FDIBA2009
FDIBA2009 collected 378 from pot
*** SUMMARY ***
Total pot 400 | Rake 22 
Board [4c 9c Tc 5s 8d]
Seat 1: s70n3fac3 (big blind) folded on the River
Seat 2: FDIBA2009 (button) (small blind) collected (378)



PokerStars Home Game Hand #226759512683: {Club #4781089}  Hold'em No Limit (50/100) - 2021/05/15 0:49:55 EET [2021/05/14 17:49:55 ET]
Table 'VTTP NLHE' 2-max (Play Money) Seat #1 is the button
Seat 1: s70n3fac3 (7040 in chips) 
Seat 2: FDIBA2009 (5214 in chips) 
s70n3fac3: posts small blind 50
FDIBA2009: posts big blind 100
*** HOLE CARDS ***
s70n3fac3: raises 100 to 200
FDIBA2009: calls 100
*** FLOP *** [9h 6h Ad]
FDIBA2009: bets 378
s70n3fac3: raises 378 to 756
FDIBA2009: folds 
Uncalled bet (378) returned to s70n3fac3
s70n3fac3 collected 1092 from pot
s70n3fac3: doesn't show hand 
*** SUMMARY ***
Total pot 1156 | Rake 64 
Board [9h 6h Ad]
Seat 1: s70n3fac3 (button) (small blind) collected (1092)
Seat 2: FDIBA2009 (big blind) folded on the Flop



PokerStars Home Game Hand #226759519402: {Club #4781089}  Hold'em No Limit (50/100) - 2021/05/15 0:50:08 EET [2021/05/14 17:50:08 ET]
Table 'VTTP NLHE' 2-max (Play Money) Seat #2 is the button
Seat 1: s70n3fac3 (7554 in chips) 
Seat 2: FDIBA2009 (4636 in chips) 
FDIBA2009: posts small blind 50
s70n3fac3: posts big blind 100
*** HOLE CARDS ***
FDIBA2009: raises 100 to 200
s70n3fac3: folds 
Uncalled bet (100) returned to FDIBA2009
FDIBA2009 collected 200 from pot
*** SUMMARY ***
Total pot 200 | Rake 0 
Seat 1: s70n3fac3 (big blind) folded before Flop
Seat 2: FDIBA2009 (button) (small blind) collected (200)



PokerStars Home Game Hand #226759522286: {Club #4781089}  Hold'em No Limit (50/100) - 2021/05/15 0:50:13 EET [2021/05/14 17:50:13 ET]
Table 'VTTP NLHE' 2-max (Play Money) Seat #1 is the button
Seat 1: s70n3fac3 (7454 in chips) 
Seat 2: FDIBA2009 (4736 in chips) 
s70n3fac3: posts small blind 50
FDIBA2009: posts big blind 100
*** HOLE CARDS ***
s70n3fac3: folds 
Uncalled bet (50) returned to FDIBA2009
FDIBA2009 collected 100 from pot
*** SUMMARY ***
Total pot 100 | Rake 0 
Seat 1: s70n3fac3 (button) (small blind) folded before Flop
Seat 2: FDIBA2009 (big blind) collected (100)



PokerStars Home Game Hand #226759524347: {Club #4781089}  Hold'em No Limit (50/100) - 2021/05/15 0:50:17 EET [2021/05/14 17:50:17 ET]
Table 'VTTP NLHE' 2-max (Play Money) Seat #2 is the button
Seat 1: s70n3fac3 (7404 in chips) 
Seat 2: FDIBA2009 (4786 in chips) 
FDIBA2009: posts small blind 50
s70n3fac3: posts big blind 100
*** HOLE CARDS ***
FDIBA2009: raises 100 to 200
s70n3fac3: raises 500 to 700
FDIBA2009: calls 500
*** FLOP *** [Kh 7d 9h]
s70n3fac3: checks 
FDIBA2009: checks 
*** TURN *** [Kh 7d 9h] [2c]
s70n3fac3: bets 600
FDIBA2009: calls 600
*** RIVER *** [Kh 7d 9h 2c] [6c]
s70n3fac3: bets 1100
FDIBA2009: folds 
Uncalled bet (1100) returned to s70n3fac3
s70n3fac3 collected 2457 from pot
s70n3fac3: doesn't show hand 
*** SUMMARY ***
Total pot 2600 | Rake 143 
Board [Kh 7d 9h 2c 6c]
Seat 1: s70n3fac3 (big blind) collected (2457)
Seat 2: FDIBA2009 (button) (small blind) folded on the River



PokerStars Home Game Hand #226759538892: {Club #4781089}  Hold'em No Limit (50/100) - 2021/05/15 0:50:43 EET [2021/05/14 17:50:43 ET]
Table 'VTTP NLHE' 2-max (Play Money) Seat #1 is the button
Seat 1: s70n3fac3 (8561 in chips) 
Seat 2: FDIBA2009 (3486 in chips) 
s70n3fac3: posts small blind 50
FDIBA2009: posts big blind 100
*** HOLE CARDS ***
s70n3fac3: folds 
Uncalled bet (50) returned to FDIBA2009
FDIBA2009 collected 100 from pot
*** SUMMARY ***
Total pot 100 | Rake 0 
Seat 1: s70n3fac3 (button) (small blind) folded before Flop
Seat 2: FDIBA2009 (big blind) collected (100)



PokerStars Home Game Hand #226759541050: {Club #4781089}  Hold'em No Limit (50/100) - 2021/05/15 0:50:47 EET [2021/05/14 17:50:47 ET]
Table 'VTTP NLHE' 2-max (Play Money) Seat #2 is the button
Seat 1: s70n3fac3 (8511 in chips) 
Seat 2: FDIBA2009 (3536 in chips) 
FDIBA2009: posts small blind 50
s70n3fac3: posts big blind 100
*** HOLE CARDS ***
FDIBA2009: raises 100 to 200
s70n3fac3: calls 100
*** FLOP *** [9d 6c 8d]
s70n3fac3: checks 
FDIBA2009: bets 378
s70n3fac3: folds 
Uncalled bet (378) returned to FDIBA2009
FDIBA2009 collected 378 from pot
*** SUMMARY ***
Total pot 400 | Rake 22 
Board [9d 6c 8d]
Seat 1: s70n3fac3 (big blind) folded on the Flop
Seat 2: FDIBA2009 (button) (small blind) collected (378)



PokerStars Home Game Hand #226759546994: {Club #4781089}  Hold'em No Limit (50/100) - 2021/05/15 0:50:58 EET [2021/05/14 17:50:58 ET]
Table 'VTTP NLHE' 2-max (Play Money) Seat #1 is the button
Seat 1: s70n3fac3 (8311 in chips) 
Seat 2: FDIBA2009 (3714 in chips) 
s70n3fac3: posts small blind 50
FDIBA2009: posts big blind 100
*** HOLE CARDS ***
s70n3fac3: raises 100 to 200
FDIBA2009: calls 100
*** FLOP *** [2d Tc Jc]
FDIBA2009: checks 
s70n3fac3: checks 
*** TURN *** [2d Tc Jc] [9c]
FDIBA2009: bets 378
s70n3fac3: calls 378
*** RIVER *** [2d Tc Jc 9c] [3s]
FDIBA2009: bets 546
s70n3fac3: calls 546
*** SHOW DOWN ***
FDIBA2009: shows [Jd 4s] (a pair of Jacks)
s70n3fac3: mucks hand 
FDIBA2009 collected 2124 from pot
*** SUMMARY ***
Total pot 2248 | Rake 124 
Board [2d Tc Jc 9c 3s]
Seat 1: s70n3fac3 (button) (small blind) mucked [8s 8d]
Seat 2: FDIBA2009 (big blind) showed [Jd 4s] and won (2124) with a pair of Jacks



PokerStars Home Game Hand #226759565734: {Club #4781089}  Hold'em No Limit (50/100) - 2021/05/15 0:51:32 EET [2021/05/14 17:51:32 ET]
Table 'VTTP NLHE' 2-max (Play Money) Seat #2 is the button
Seat 1: s70n3fac3 (7187 in chips) 
Seat 2: FDIBA2009 (4714 in chips) 
FDIBA2009: posts small blind 50
s70n3fac3: posts big blind 100
*** HOLE CARDS ***
FDIBA2009: raises 100 to 200
s70n3fac3: calls 100
*** FLOP *** [Qs 8c Ah]
s70n3fac3: checks 
FDIBA2009: checks 
*** TURN *** [Qs 8c Ah] [4d]
s70n3fac3: checks 
FDIBA2009: checks 
*** RIVER *** [Qs 8c Ah 4d] [4s]
s70n3fac3: checks 
FDIBA2009: bets 378
s70n3fac3: calls 378
*** SHOW DOWN ***
FDIBA2009: shows [7c 3d] (a pair of Fours)
s70n3fac3: shows [Ks 7d] (a pair of Fours - Ace+King kicker)
s70n3fac3 collected 1092 from pot
*** SUMMARY ***
Total pot 1156 | Rake 64 
Board [Qs 8c Ah 4d 4s]
Seat 1: s70n3fac3 (big blind) showed [Ks 7d] and won (1092) with a pair of Fours
Seat 2: FDIBA2009 (button) (small blind) showed [7c 3d] and lost with a pair of Fours



PokerStars Home Game Hand #226759575213: {Club #4781089}  Hold'em No Limit (50/100) - 2021/05/15 0:51:50 EET [2021/05/14 17:51:50 ET]
Table 'VTTP NLHE' 2-max (Play Money) Seat #1 is the button
Seat 1: s70n3fac3 (7701 in chips) 
Seat 2: FDIBA2009 (4136 in chips) 
s70n3fac3: posts small blind 50
FDIBA2009: posts big blind 100
*** HOLE CARDS ***
s70n3fac3: folds 
Uncalled bet (50) returned to FDIBA2009
FDIBA2009 collected 100 from pot
*** SUMMARY ***
Total pot 100 | Rake 0 
Seat 1: s70n3fac3 (button) (small blind) folded before Flop
Seat 2: FDIBA2009 (big blind) collected (100)



PokerStars Home Game Hand #226759577376: {Club #4781089}  Hold'em No Limit (50/100) - 2021/05/15 0:51:54 EET [2021/05/14 17:51:54 ET]
Table 'VTTP NLHE' 2-max (Play Money) Seat #2 is the button
Seat 1: s70n3fac3 (7651 in chips) 
Seat 2: FDIBA2009 (4186 in chips) 
FDIBA2009: posts small blind 50
s70n3fac3: posts big blind 100
*** HOLE CARDS ***
FDIBA2009: raises 100 to 200
s70n3fac3: calls 100
*** FLOP *** [9s 7c 5d]
s70n3fac3: checks 
FDIBA2009: checks 
*** TURN *** [9s 7c 5d] [Th]
s70n3fac3: checks 
FDIBA2009: bets 378
s70n3fac3: folds 
Uncalled bet (378) returned to FDIBA2009
FDIBA2009 collected 378 from pot
*** SUMMARY ***
Total pot 400 | Rake 22 
Board [9s 7c 5d Th]
Seat 1: s70n3fac3 (big blind) folded on the Turn
Seat 2: FDIBA2009 (button) (small blind) collected (378)



PokerStars Home Game Hand #226759584220: {Club #4781089}  Hold'em No Limit (50/100) - 2021/05/15 0:52:06 EET [2021/05/14 17:52:06 ET]
Table 'VTTP NLHE' 2-max (Play Money) Seat #1 is the button
Seat 1: s70n3fac3 (7451 in chips) 
Seat 2: FDIBA2009 (4364 in chips) 
s70n3fac3: posts small blind 50
FDIBA2009: posts big blind 100
*** HOLE CARDS ***
s70n3fac3: raises 100 to 200
FDIBA2009: calls 100
*** FLOP *** [3d Ts Kh]
FDIBA2009: checks 
s70n3fac3: bets 200
FDIBA2009: calls 200
*** TURN *** [3d Ts Kh] [7s]
FDIBA2009: checks 
s70n3fac3: bets 400
FDIBA2009: calls 400
*** RIVER *** [3d Ts Kh 7s] [8c]
FDIBA2009: checks 
s70n3fac3: bets 900
FDIBA2009: folds 
Uncalled bet (900) returned to s70n3fac3
s70n3fac3 collected 1512 from pot
s70n3fac3: doesn't show hand 
*** SUMMARY ***
Total pot 1600 | Rake 88 
Board [3d Ts Kh 7s 8c]
Seat 1: s70n3fac3 (button) (small blind) collected (1512)
Seat 2: FDIBA2009 (big blind) folded on the River



PokerStars Home Game Hand #226759600472: {Club #4781089}  Hold'em No Limit (50/100) - 2021/05/15 0:52:36 EET [2021/05/14 17:52:36 ET]
Table 'VTTP NLHE' 2-max (Play Money) Seat #2 is the button
Seat 1: s70n3fac3 (8163 in chips) 
Seat 2: FDIBA2009 (3564 in chips) 
FDIBA2009: posts small blind 50
s70n3fac3: posts big blind 100
*** HOLE CARDS ***
FDIBA2009: raises 100 to 200
s70n3fac3: calls 100
*** FLOP *** [7c 4d Qh]
s70n3fac3: checks 
FDIBA2009: bets 378
s70n3fac3: folds 
Uncalled bet (378) returned to FDIBA2009
FDIBA2009 collected 378 from pot
*** SUMMARY ***
Total pot 400 | Rake 22 
Board [7c 4d Qh]
Seat 1: s70n3fac3 (big blind) folded on the Flop
Seat 2: FDIBA2009 (button) (small blind) collected (378)



PokerStars Home Game Hand #226759606219: {Club #4781089}  Hold'em No Limit (50/100) - 2021/05/15 0:52:47 EET [2021/05/14 17:52:47 ET]
Table 'VTTP NLHE' 2-max (Play Money) Seat #1 is the button
Seat 1: s70n3fac3 (7963 in chips) 
Seat 2: FDIBA2009 (3742 in chips) 
s70n3fac3: posts small blind 50
FDIBA2009: posts big blind 100
*** HOLE CARDS ***
s70n3fac3: raises 100 to 200
FDIBA2009: calls 100
*** FLOP *** [Th Ad Kc]
FDIBA2009: checks 
s70n3fac3: bets 200
FDIBA2009: calls 200
*** TURN *** [Th Ad Kc] [Qh]
FDIBA2009: checks 
s70n3fac3: bets 400
FDIBA2009: folds 
Uncalled bet (400) returned to s70n3fac3
s70n3fac3 collected 756 from pot
s70n3fac3: doesn't show hand 
*** SUMMARY ***
Total pot 800 | Rake 44 
Board [Th Ad Kc Qh]
Seat 1: s70n3fac3 (button) (small blind) collected (756)
Seat 2: FDIBA2009 (big blind) folded on the Turn



PokerStars Home Game Hand #226759615910: {Club #4781089}  Hold'em No Limit (50/100) - 2021/05/15 0:53:04 EET [2021/05/14 17:53:04 ET]
Table 'VTTP NLHE' 2-max (Play Money) Seat #2 is the button
Seat 1: s70n3fac3 (8319 in chips) 
Seat 2: FDIBA2009 (3342 in chips) 
FDIBA2009: posts small blind 50
s70n3fac3: posts big blind 100
*** HOLE CARDS ***
FDIBA2009: raises 100 to 200
s70n3fac3: folds 
Uncalled bet (100) returned to FDIBA2009
FDIBA2009 collected 200 from pot
*** SUMMARY ***
Total pot 200 | Rake 0 
Seat 1: s70n3fac3 (big blind) folded before Flop
Seat 2: FDIBA2009 (button) (small blind) collected (200)



PokerStars Home Game Hand #226759618612: {Club #4781089}  Hold'em No Limit (50/100) - 2021/05/15 0:53:09 EET [2021/05/14 17:53:09 ET]
Table 'VTTP NLHE' 2-max (Play Money) Seat #1 is the button
Seat 1: s70n3fac3 (8219 in chips) 
Seat 2: FDIBA2009 (3442 in chips) 
s70n3fac3: posts small blind 50
FDIBA2009: posts big blind 100
*** HOLE CARDS ***
s70n3fac3: folds 
Uncalled bet (50) returned to FDIBA2009
FDIBA2009 collected 100 from pot
*** SUMMARY ***
Total pot 100 | Rake 0 
Seat 1: s70n3fac3 (button) (small blind) folded before Flop
Seat 2: FDIBA2009 (big blind) collected (100)



PokerStars Home Game Hand #226759620849: {Club #4781089}  Hold'em No Limit (50/100) - 2021/05/15 0:53:13 EET [2021/05/14 17:53:13 ET]
Table 'VTTP NLHE' 2-max (Play Money) Seat #2 is the button
Seat 1: s70n3fac3 (8169 in chips) 
Seat 2: FDIBA2009 (3492 in chips) 
FDIBA2009: posts small blind 50
s70n3fac3: posts big blind 100
*** HOLE CARDS ***
FDIBA2009: raises 100 to 200
s70n3fac3: calls 100
*** FLOP *** [As Ah Jd]
s70n3fac3: checks 
FDIBA2009: checks 
*** TURN *** [As Ah Jd] [8c]
s70n3fac3: bets 200
FDIBA2009: raises 778 to 978
s70n3fac3: calls 778
*** RIVER *** [As Ah Jd 8c] [3s]
s70n3fac3: checks 
FDIBA2009: checks 
*** SHOW DOWN ***
s70n3fac3: shows [5c Ad] (three of a kind, Aces)
FDIBA2009: mucks hand 
s70n3fac3 collected 2226 from pot
*** SUMMARY ***
Total pot 2356 | Rake 130 
Board [As Ah Jd 8c 3s]
Seat 1: s70n3fac3 (big blind) showed [5c Ad] and won (2226) with three of a kind, Aces
Seat 2: FDIBA2009 (button) (small blind) mucked [8h 6d]



PokerStars Home Game Hand #226759633671: {Club #4781089}  Hold'em No Limit (50/100) - 2021/05/15 0:53:37 EET [2021/05/14 17:53:37 ET]
Table 'VTTP NLHE' 2-max (Play Money) Seat #1 is the button
Seat 1: s70n3fac3 (9217 in chips) 
Seat 2: FDIBA2009 (2314 in chips) 
s70n3fac3: posts small blind 50
FDIBA2009: posts big blind 100
*** HOLE CARDS ***
s70n3fac3: raises 100 to 200
FDIBA2009: raises 2114 to 2314 and is all-in
s70n3fac3: folds 
Uncalled bet (2114) returned to FDIBA2009
FDIBA2009 collected 400 from pot
*** SUMMARY ***
Total pot 400 | Rake 0 
Seat 1: s70n3fac3 (button) (small blind) folded before Flop
Seat 2: FDIBA2009 (big blind) collected (400)



PokerStars Home Game Hand #226759638462: {Club #4781089}  Hold'em No Limit (50/100) - 2021/05/15 0:53:46 EET [2021/05/14 17:53:46 ET]
Table 'VTTP NLHE' 2-max (Play Money) Seat #2 is the button
Seat 1: s70n3fac3 (9017 in chips) 
Seat 2: FDIBA2009 (2514 in chips) 
FDIBA2009: posts small blind 50
s70n3fac3: posts big blind 100
*** HOLE CARDS ***
FDIBA2009: raises 100 to 200
s70n3fac3: folds 
Uncalled bet (100) returned to FDIBA2009
FDIBA2009 collected 200 from pot
*** SUMMARY ***
Total pot 200 | Rake 0 
Seat 1: s70n3fac3 (big blind) folded before Flop
Seat 2: FDIBA2009 (button) (small blind) collected (200)



PokerStars Home Game Hand #226759641562: {Club #4781089}  Hold'em No Limit (50/100) - 2021/05/15 0:53:52 EET [2021/05/14 17:53:52 ET]
Table 'VTTP NLHE' 2-max (Play Money) Seat #1 is the button
Seat 1: s70n3fac3 (8917 in chips) 
Seat 2: FDIBA2009 (2614 in chips) 
s70n3fac3: posts small blind 50
FDIBA2009: posts big blind 100
*** HOLE CARDS ***
s70n3fac3: folds 
Uncalled bet (50) returned to FDIBA2009
FDIBA2009 collected 100 from pot
*** SUMMARY ***
Total pot 100 | Rake 0 
Seat 1: s70n3fac3 (button) (small blind) folded before Flop
Seat 2: FDIBA2009 (big blind) collected (100)



PokerStars Home Game Hand #226759643717: {Club #4781089}  Hold'em No Limit (50/100) - 2021/05/15 0:53:56 EET [2021/05/14 17:53:56 ET]
Table 'VTTP NLHE' 2-max (Play Money) Seat #2 is the button
Seat 1: s70n3fac3 (8867 in chips) 
Seat 2: FDIBA2009 (2664 in chips) 
FDIBA2009: posts small blind 50
s70n3fac3: posts big blind 100
*** HOLE CARDS ***
FDIBA2009: raises 100 to 200
s70n3fac3: calls 100
*** FLOP *** [Ah Tc Qs]
s70n3fac3: checks 
FDIBA2009: bets 378
s70n3fac3: folds 
Uncalled bet (378) returned to FDIBA2009
FDIBA2009 collected 378 from pot
*** SUMMARY ***
Total pot 400 | Rake 22 
Board [Ah Tc Qs]
Seat 1: s70n3fac3 (big blind) folded on the Flop
Seat 2: FDIBA2009 (button) (small blind) collected (378)



PokerStars Home Game Hand #226759650978: {Club #4781089}  Hold'em No Limit (50/100) - 2021/05/15 0:54:09 EET [2021/05/14 17:54:09 ET]
Table 'VTTP NLHE' 2-max (Play Money) Seat #1 is the button
Seat 1: s70n3fac3 (8667 in chips) 
Seat 2: FDIBA2009 (2842 in chips) 
s70n3fac3: posts small blind 50
FDIBA2009: posts big blind 100
*** HOLE CARDS ***
s70n3fac3: folds 
Uncalled bet (50) returned to FDIBA2009
FDIBA2009 collected 100 from pot
*** SUMMARY ***
Total pot 100 | Rake 0 
Seat 1: s70n3fac3 (button) (small blind) folded before Flop
Seat 2: FDIBA2009 (big blind) collected (100)



PokerStars Home Game Hand #226759661298: {Club #4781089}  Hold'em No Limit (50/100) - 2021/05/15 0:54:13 EET [2021/05/14 17:54:13 ET]
Table 'VTTP NLHE' 2-max (Play Money) Seat #2 is the button
Seat 1: s70n3fac3 (8617 in chips) 
Seat 2: FDIBA2009 (2892 in chips) 
FDIBA2009: posts small blind 50
s70n3fac3: posts big blind 100
*** HOLE CARDS ***
FDIBA2009: raises 100 to 200
s70n3fac3: calls 100
*** FLOP *** [3d Qh 4c]
s70n3fac3: checks 
FDIBA2009: bets 378
s70n3fac3: raises 567 to 945
FDIBA2009: folds 
Uncalled bet (567) returned to s70n3fac3
s70n3fac3 collected 1092 from pot
s70n3fac3: doesn't show hand 
*** SUMMARY ***
Total pot 1156 | Rake 64 
Board [3d Qh 4c]
Seat 1: s70n3fac3 (big blind) collected (1092)
Seat 2: FDIBA2009 (button) (small blind) folded on the Flop



PokerStars Home Game Hand #226759678954: {Club #4781089}  Hold'em No Limit (50/100) - 2021/05/15 0:54:45 EET [2021/05/14 17:54:45 ET]
Table 'VTTP NLHE' 2-max (Play Money) Seat #1 is the button
Seat 1: s70n3fac3 (9131 in chips) 
Seat 2: FDIBA2009 (2314 in chips) 
s70n3fac3: posts small blind 50
FDIBA2009: posts big blind 100
*** HOLE CARDS ***
s70n3fac3: raises 100 to 200
FDIBA2009: raises 100 to 300
s70n3fac3: calls 100
*** FLOP *** [Td 7h 4h]
FDIBA2009: bets 567
s70n3fac3: folds 
Uncalled bet (567) returned to FDIBA2009
FDIBA2009 collected 567 from pot
*** SUMMARY ***
Total pot 600 | Rake 33 
Board [Td 7h 4h]
Seat 1: s70n3fac3 (button) (small blind) folded on the Flop
Seat 2: FDIBA2009 (big blind) collected (567)



PokerStars Home Game Hand #226759687795: {Club #4781089}  Hold'em No Limit (50/100) - 2021/05/15 0:55:02 EET [2021/05/14 17:55:02 ET]
Table 'VTTP NLHE' 2-max (Play Money) Seat #2 is the button
Seat 1: s70n3fac3 (8831 in chips) 
Seat 2: FDIBA2009 (2581 in chips) 
FDIBA2009: posts small blind 50
s70n3fac3: posts big blind 100
*** HOLE CARDS ***
FDIBA2009: raises 100 to 200
s70n3fac3: calls 100
*** FLOP *** [Qd 4s 4h]
s70n3fac3: checks 
FDIBA2009: checks 
*** TURN *** [Qd 4s 4h] [Ac]
s70n3fac3: checks 
FDIBA2009: bets 378
s70n3fac3: folds 
Uncalled bet (378) returned to FDIBA2009
FDIBA2009 collected 378 from pot
*** SUMMARY ***
Total pot 400 | Rake 22 
Board [Qd 4s 4h Ac]
Seat 1: s70n3fac3 (big blind) folded on the Turn
Seat 2: FDIBA2009 (button) (small blind) collected (378)



PokerStars Home Game Hand #226759693514: {Club #4781089}  Hold'em No Limit (50/100) - 2021/05/15 0:55:15 EET [2021/05/14 17:55:15 ET]
Table 'VTTP NLHE' 2-max (Play Money) Seat #1 is the button
Seat 1: s70n3fac3 (8631 in chips) 
Seat 2: FDIBA2009 (2759 in chips) 
s70n3fac3: posts small blind 50
FDIBA2009: posts big blind 100
*** HOLE CARDS ***
s70n3fac3: raises 100 to 200
FDIBA2009: calls 100
*** FLOP *** [2d 8c 3d]
FDIBA2009: bets 378
s70n3fac3: folds 
Uncalled bet (378) returned to FDIBA2009
FDIBA2009 collected 378 from pot
*** SUMMARY ***
Total pot 400 | Rake 22 
Board [2d 8c 3d]
Seat 1: s70n3fac3 (button) (small blind) folded on the Flop
Seat 2: FDIBA2009 (big blind) collected (378)



PokerStars Home Game Hand #226759697169: {Club #4781089}  Hold'em No Limit (50/100) - 2021/05/15 0:55:24 EET [2021/05/14 17:55:24 ET]
Table 'VTTP NLHE' 2-max (Play Money) Seat #2 is the button
Seat 1: s70n3fac3 (8431 in chips) 
Seat 2: FDIBA2009 (2937 in chips) 
FDIBA2009: posts small blind 50
s70n3fac3: posts big blind 100
*** HOLE CARDS ***
FDIBA2009: raises 100 to 200
s70n3fac3: folds 
Uncalled bet (100) returned to FDIBA2009
FDIBA2009 collected 200 from pot
*** SUMMARY ***
Total pot 200 | Rake 0 
Seat 1: s70n3fac3 (big blind) folded before Flop
Seat 2: FDIBA2009 (button) (small blind) collected (200)



PokerStars Home Game Hand #226759699268: {Club #4781089}  Hold'em No Limit (50/100) - 2021/05/15 0:55:29 EET [2021/05/14 17:55:29 ET]
Table 'VTTP NLHE' 2-max (Play Money) Seat #1 is the button
Seat 1: s70n3fac3 (8331 in chips) 
Seat 2: FDIBA2009 (3037 in chips) 
s70n3fac3: posts small blind 50
FDIBA2009: posts big blind 100
*** HOLE CARDS ***
s70n3fac3: raises 100 to 200
FDIBA2009: raises 400 to 600
s70n3fac3: calls 400
*** FLOP *** [8s 2c 3h]
FDIBA2009: checks 
s70n3fac3: checks 
*** TURN *** [8s 2c 3h] [4d]
FDIBA2009: checks 
s70n3fac3: checks 
*** RIVER *** [8s 2c 3h 4d] [4c]
FDIBA2009: bets 1134
s70n3fac3: folds 
Uncalled bet (1134) returned to FDIBA2009
FDIBA2009 collected 1134 from pot
*** SUMMARY ***
Total pot 1200 | Rake 66 
Board [8s 2c 3h 4d 4c]
Seat 1: s70n3fac3 (button) (small blind) folded on the River
Seat 2: FDIBA2009 (big blind) collected (1134)



PokerStars Home Game Hand #226759711498: {Club #4781089}  Hold'em No Limit (50/100) - 2021/05/15 0:56:00 EET [2021/05/14 17:56:00 ET]
Table 'VTTP NLHE' 2-max (Play Money) Seat #2 is the button
Seat 1: s70n3fac3 (7731 in chips) 
Seat 2: FDIBA2009 (3571 in chips) 
FDIBA2009: posts small blind 50
s70n3fac3: posts big blind 100
*** HOLE CARDS ***
FDIBA2009: raises 100 to 200
s70n3fac3: calls 100
*** FLOP *** [Ks 3d 8h]
s70n3fac3: checks 
FDIBA2009: checks 
*** TURN *** [Ks 3d 8h] [2d]
s70n3fac3: checks 
FDIBA2009: checks 
*** RIVER *** [Ks 3d 8h 2d] [Jd]
s70n3fac3: bets 200
FDIBA2009: folds 
Uncalled bet (200) returned to s70n3fac3
s70n3fac3 collected 378 from pot
s70n3fac3: doesn't show hand 
*** SUMMARY ***
Total pot 400 | Rake 22 
Board [Ks 3d 8h 2d Jd]
Seat 1: s70n3fac3 (big blind) collected (378)
Seat 2: FDIBA2009 (button) (small blind) folded on the River



PokerStars Home Game Hand #226759716777: {Club #4781089}  Hold'em No Limit (50/100) - 2021/05/15 0:56:12 EET [2021/05/14 17:56:12 ET]
Table 'VTTP NLHE' 2-max (Play Money) Seat #1 is the button
Seat 1: s70n3fac3 (7909 in chips) 
Seat 2: FDIBA2009 (3371 in chips) 
s70n3fac3: posts small blind 50
FDIBA2009: posts big blind 100
*** HOLE CARDS ***
s70n3fac3: raises 100 to 200
FDIBA2009: raises 100 to 300
s70n3fac3: calls 100
*** FLOP *** [8h 6s 3d]
FDIBA2009: checks 
s70n3fac3: checks 
*** TURN *** [8h 6s 3d] [As]
FDIBA2009: bets 567
s70n3fac3: folds 
Uncalled bet (567) returned to FDIBA2009
FDIBA2009 collected 567 from pot
*** SUMMARY ***
Total pot 600 | Rake 33 
Board [8h 6s 3d As]
Seat 1: s70n3fac3 (button) (small blind) folded on the Turn
Seat 2: FDIBA2009 (big blind) collected (567)



PokerStars Home Game Hand #226759722743: {Club #4781089}  Hold'em No Limit (50/100) - 2021/05/15 0:56:27 EET [2021/05/14 17:56:27 ET]
Table 'VTTP NLHE' 2-max (Play Money) Seat #2 is the button
Seat 1: s70n3fac3 (7609 in chips) 
Seat 2: FDIBA2009 (3638 in chips) 
FDIBA2009: posts small blind 50
s70n3fac3: posts big blind 100
*** HOLE CARDS ***
FDIBA2009: raises 100 to 200
s70n3fac3: folds 
Uncalled bet (100) returned to FDIBA2009
FDIBA2009 collected 200 from pot
*** SUMMARY ***
Total pot 200 | Rake 0 
Seat 1: s70n3fac3 (big blind) folded before Flop
Seat 2: FDIBA2009 (button) (small blind) collected (200)



PokerStars Home Game Hand #226759724898: {Club #4781089}  Hold'em No Limit (50/100) - 2021/05/15 0:56:33 EET [2021/05/14 17:56:33 ET]
Table 'VTTP NLHE' 2-max (Play Money) Seat #1 is the button
Seat 1: s70n3fac3 (7509 in chips) 
Seat 2: FDIBA2009 (3738 in chips) 
s70n3fac3: posts small blind 50
FDIBA2009: posts big blind 100
*** HOLE CARDS ***
s70n3fac3: raises 100 to 200
FDIBA2009: calls 100
*** FLOP *** [4h Jd 8d]
FDIBA2009: checks 
s70n3fac3: bets 200
FDIBA2009: calls 200
*** TURN *** [4h Jd 8d] [2s]
FDIBA2009: checks 
s70n3fac3: bets 400
FDIBA2009: calls 400
*** RIVER *** [4h Jd 8d 2s] [Ts]
FDIBA2009: checks 
s70n3fac3: checks 
*** SHOW DOWN ***
FDIBA2009: shows [6c 7c] (high card Jack)
s70n3fac3: shows [9s 9d] (a pair of Nines)
s70n3fac3 collected 1512 from pot
*** SUMMARY ***
Total pot 1600 | Rake 88 
Board [4h Jd 8d 2s Ts]
Seat 1: s70n3fac3 (button) (small blind) showed [9s 9d] and won (1512) with a pair of Nines
Seat 2: FDIBA2009 (big blind) showed [6c 7c] and lost with high card Jack



PokerStars Home Game Hand #226759734645: {Club #4781089}  Hold'em No Limit (50/100) - 2021/05/15 0:56:57 EET [2021/05/14 17:56:57 ET]
Table 'VTTP NLHE' 2-max (Play Money) Seat #2 is the button
Seat 1: s70n3fac3 (8221 in chips) 
Seat 2: FDIBA2009 (2938 in chips) 
FDIBA2009: posts small blind 50
s70n3fac3: posts big blind 100
*** HOLE CARDS ***
FDIBA2009: raises 200 to 300
s70n3fac3: calls 200
*** FLOP *** [As Th Ah]
s70n3fac3: checks 
FDIBA2009: bets 283
s70n3fac3: raises 283 to 566
FDIBA2009: raises 2072 to 2638 and is all-in
s70n3fac3 has timed out
s70n3fac3: folds 
Uncalled bet (2072) returned to FDIBA2009
FDIBA2009 collected 1637 from pot
*** SUMMARY ***
Total pot 1732 | Rake 95 
Board [As Th Ah]
Seat 1: s70n3fac3 (big blind) folded on the Flop
Seat 2: FDIBA2009 (button) (small blind) collected (1637)



PokerStars Home Game Hand #226759752457: {Club #4781089}  Hold'em No Limit (50/100) - 2021/05/15 0:57:40 EET [2021/05/14 17:57:40 ET]
Table 'VTTP NLHE' 2-max (Play Money) Seat #1 is the button
Seat 1: s70n3fac3 (7355 in chips) 
Seat 2: FDIBA2009 (3709 in chips) 
s70n3fac3: posts small blind 50
FDIBA2009: posts big blind 100
*** HOLE CARDS ***
s70n3fac3: raises 100 to 200
FDIBA2009: calls 100
*** FLOP *** [7s 8c Qs]
FDIBA2009: checks 
s70n3fac3: bets 200
FDIBA2009: folds 
Uncalled bet (200) returned to s70n3fac3
s70n3fac3 collected 378 from pot
s70n3fac3: doesn't show hand 
*** SUMMARY ***
Total pot 400 | Rake 22 
Board [7s 8c Qs]
Seat 1: s70n3fac3 (button) (small blind) collected (378)
Seat 2: FDIBA2009 (big blind) folded on the Flop



PokerStars Home Game Hand #226759757027: {Club #4781089}  Hold'em No Limit (50/100) - 2021/05/15 0:57:52 EET [2021/05/14 17:57:52 ET]
Table 'VTTP NLHE' 2-max (Play Money) Seat #2 is the button
Seat 1: s70n3fac3 (7533 in chips) 
Seat 2: FDIBA2009 (3509 in chips) 
FDIBA2009: posts small blind 50
s70n3fac3: posts big blind 100
*** HOLE CARDS ***
FDIBA2009: raises 100 to 200
s70n3fac3: calls 100
*** FLOP *** [Ts Th 2d]
s70n3fac3: checks 
FDIBA2009: bets 189
s70n3fac3: folds 
Uncalled bet (189) returned to FDIBA2009
FDIBA2009 collected 378 from pot
*** SUMMARY ***
Total pot 400 | Rake 22 
Board [Ts Th 2d]
Seat 1: s70n3fac3 (big blind) folded on the Flop
Seat 2: FDIBA2009 (button) (small blind) collected (378)



PokerStars Home Game Hand #226759761052: {Club #4781089}  Hold'em No Limit (50/100) - 2021/05/15 0:58:02 EET [2021/05/14 17:58:02 ET]
Table 'VTTP NLHE' 2-max (Play Money) Seat #1 is the button
Seat 1: s70n3fac3 (7333 in chips) 
Seat 2: FDIBA2009 (3687 in chips) 
s70n3fac3: posts small blind 50
FDIBA2009: posts big blind 100
*** HOLE CARDS ***
s70n3fac3: raises 100 to 200
FDIBA2009: calls 100
*** FLOP *** [2d 3s 9s]
FDIBA2009: checks 
s70n3fac3: bets 200
FDIBA2009: calls 200
*** TURN *** [2d 3s 9s] [5h]
FDIBA2009: checks 
s70n3fac3: checks 
*** RIVER *** [2d 3s 9s 5h] [8c]
FDIBA2009: bets 500
s70n3fac3: folds 
Uncalled bet (500) returned to FDIBA2009
FDIBA2009 collected 756 from pot
*** SUMMARY ***
Total pot 800 | Rake 44 
Board [2d 3s 9s 5h 8c]
Seat 1: s70n3fac3 (button) (small blind) folded on the River
Seat 2: FDIBA2009 (big blind) collected (756)



PokerStars Home Game Hand #226759771861: {Club #4781089}  Hold'em No Limit (50/100) - 2021/05/15 0:58:28 EET [2021/05/14 17:58:28 ET]
Table 'VTTP NLHE' 2-max (Play Money) Seat #2 is the button
Seat 1: s70n3fac3 (6933 in chips) 
Seat 2: FDIBA2009 (4043 in chips) 
FDIBA2009: posts small blind 50
s70n3fac3: posts big blind 100
*** HOLE CARDS ***
FDIBA2009: raises 100 to 200
s70n3fac3: raises 300 to 500
FDIBA2009: calls 300
*** FLOP *** [8s 9s Ks]
s70n3fac3: checks 
FDIBA2009: bets 945
s70n3fac3: folds 
Uncalled bet (945) returned to FDIBA2009
FDIBA2009 collected 945 from pot
*** SUMMARY ***
Total pot 1000 | Rake 55 
Board [8s 9s Ks]
Seat 1: s70n3fac3 (big blind) folded on the Flop
Seat 2: FDIBA2009 (button) (small blind) collected (945)



PokerStars Home Game Hand #226759778480: {Club #4781089}  Hold'em No Limit (50/100) - 2021/05/15 0:58:45 EET [2021/05/14 17:58:45 ET]
Table 'VTTP NLHE' 2-max (Play Money) Seat #1 is the button
Seat 1: s70n3fac3 (6433 in chips) 
Seat 2: FDIBA2009 (4488 in chips) 
s70n3fac3: posts small blind 50
FDIBA2009: posts big blind 100
*** HOLE CARDS ***
s70n3fac3: raises 100 to 200
FDIBA2009: calls 100
*** FLOP *** [6d 2h Kc]
FDIBA2009: checks 
s70n3fac3: checks 
*** TURN *** [6d 2h Kc] [7s]
FDIBA2009: bets 100
s70n3fac3: calls 100
*** RIVER *** [6d 2h Kc 7s] [Ks]
FDIBA2009: checks 
s70n3fac3: checks 
*** SHOW DOWN ***
FDIBA2009: shows [2s Jh] (two pair, Kings and Deuces)
s70n3fac3: mucks hand 
FDIBA2009 collected 567 from pot
*** SUMMARY ***
Total pot 600 | Rake 33 
Board [6d 2h Kc 7s Ks]
Seat 1: s70n3fac3 (button) (small blind) mucked [Th Ac]
Seat 2: FDIBA2009 (big blind) showed [2s Jh] and won (567) with two pair, Kings and Deuces



PokerStars Home Game Hand #226759784518: {Club #4781089}  Hold'em No Limit (50/100) - 2021/05/15 0:59:00 EET [2021/05/14 17:59:00 ET]
Table 'VTTP NLHE' 2-max (Play Money) Seat #2 is the button
Seat 1: s70n3fac3 (6133 in chips) 
Seat 2: FDIBA2009 (4755 in chips) 
FDIBA2009: posts small blind 50
s70n3fac3: posts big blind 100
*** HOLE CARDS ***
FDIBA2009: raises 100 to 200
s70n3fac3: calls 100
*** FLOP *** [Kd 4d 7h]
s70n3fac3: checks 
FDIBA2009: bets 100
s70n3fac3: calls 100
*** TURN *** [Kd 4d 7h] [Qd]
s70n3fac3: checks 
FDIBA2009: checks 
*** RIVER *** [Kd 4d 7h Qd] [2d]
s70n3fac3: bets 600
FDIBA2009: folds 
Uncalled bet (600) returned to s70n3fac3
s70n3fac3 collected 567 from pot
s70n3fac3: doesn't show hand 
*** SUMMARY ***
Total pot 600 | Rake 33 
Board [Kd 4d 7h Qd 2d]
Seat 1: s70n3fac3 (big blind) collected (567)
Seat 2: FDIBA2009 (button) (small blind) folded on the River



PokerStars Home Game Hand #226759790992: {Club #4781089}  Hold'em No Limit (50/100) - 2021/05/15 0:59:16 EET [2021/05/14 17:59:16 ET]
Table 'VTTP NLHE' 2-max (Play Money) Seat #1 is the button
Seat 1: s70n3fac3 (6400 in chips) 
Seat 2: FDIBA2009 (4455 in chips) 
s70n3fac3: posts small blind 50
FDIBA2009: posts big blind 100
*** HOLE CARDS ***
s70n3fac3: folds 
Uncalled bet (50) returned to FDIBA2009
FDIBA2009 collected 100 from pot
*** SUMMARY ***
Total pot 100 | Rake 0 
Seat 1: s70n3fac3 (button) (small blind) folded before Flop
Seat 2: FDIBA2009 (big blind) collected (100)



PokerStars Home Game Hand #226759792519: {Club #4781089}  Hold'em No Limit (50/100) - 2021/05/15 0:59:20 EET [2021/05/14 17:59:20 ET]
Table 'VTTP NLHE' 2-max (Play Money) Seat #2 is the button
Seat 1: s70n3fac3 (6350 in chips) 
Seat 2: FDIBA2009 (4505 in chips) 
FDIBA2009: posts small blind 50
s70n3fac3: posts big blind 100
*** HOLE CARDS ***
FDIBA2009: raises 100 to 200
s70n3fac3: folds 
Uncalled bet (100) returned to FDIBA2009
FDIBA2009 collected 200 from pot
*** SUMMARY ***
Total pot 200 | Rake 0 
Seat 1: s70n3fac3 (big blind) folded before Flop
Seat 2: FDIBA2009 (button) (small blind) collected (200)



PokerStars Home Game Hand #226759794548: {Club #4781089}  Hold'em No Limit (50/100) - 2021/05/15 0:59:25 EET [2021/05/14 17:59:25 ET]
Table 'VTTP NLHE' 2-max (Play Money) Seat #1 is the button
Seat 1: s70n3fac3 (6250 in chips) 
Seat 2: FDIBA2009 (4605 in chips) 
s70n3fac3: posts small blind 50
FDIBA2009: posts big blind 100
*** HOLE CARDS ***
s70n3fac3: raises 100 to 200
FDIBA2009: raises 100 to 300
s70n3fac3: calls 100
*** FLOP *** [Ks 6h 8d]
FDIBA2009: bets 567
s70n3fac3: calls 567
*** TURN *** [Ks 6h 8d] [Kh]
FDIBA2009: checks 
s70n3fac3: checks 
*** RIVER *** [Ks 6h 8d Kh] [2c]
FDIBA2009: checks 
s70n3fac3: bets 1200
FDIBA2009: folds 
Uncalled bet (1200) returned to s70n3fac3
s70n3fac3 collected 1639 from pot
s70n3fac3: doesn't show hand 
*** SUMMARY ***
Total pot 1734 | Rake 95 
Board [Ks 6h 8d Kh 2c]
Seat 1: s70n3fac3 (button) (small blind) collected (1639)
Seat 2: FDIBA2009 (big blind) folded on the River



PokerStars Home Game Hand #226759806449: {Club #4781089}  Hold'em No Limit (50/100) - 2021/05/15 0:59:56 EET [2021/05/14 17:59:56 ET]
Table 'VTTP NLHE' 2-max (Play Money) Seat #2 is the button
Seat 1: s70n3fac3 (7022 in chips) 
Seat 2: FDIBA2009 (3738 in chips) 
FDIBA2009: posts small blind 50
s70n3fac3: posts big blind 100
*** HOLE CARDS ***
FDIBA2009: raises 100 to 200
s70n3fac3: calls 100
*** FLOP *** [7d Ah 6h]
s70n3fac3: checks 
FDIBA2009: bets 378
s70n3fac3: folds 
Uncalled bet (378) returned to FDIBA2009
FDIBA2009 collected 378 from pot
*** SUMMARY ***
Total pot 400 | Rake 22 
Board [7d Ah 6h]
Seat 1: s70n3fac3 (big blind) folded on the Flop
Seat 2: FDIBA2009 (button) (small blind) collected (378)



PokerStars Home Game Hand #226759810901: {Club #4781089}  Hold'em No Limit (50/100) - 2021/05/15 1:00:06 EET [2021/05/14 18:00:06 ET]
Table 'VTTP NLHE' 2-max (Play Money) Seat #1 is the button
Seat 1: s70n3fac3 (6822 in chips) 
Seat 2: FDIBA2009 (3916 in chips) 
s70n3fac3: posts small blind 50
FDIBA2009: posts big blind 100
*** HOLE CARDS ***
s70n3fac3: folds 
Uncalled bet (50) returned to FDIBA2009
FDIBA2009 collected 100 from pot
*** SUMMARY ***
Total pot 100 | Rake 0 
Seat 1: s70n3fac3 (button) (small blind) folded before Flop
Seat 2: FDIBA2009 (big blind) collected (100)



PokerStars Home Game Hand #226759812717: {Club #4781089}  Hold'em No Limit (50/100) - 2021/05/15 1:00:11 EET [2021/05/14 18:00:11 ET]
Table 'VTTP NLHE' 2-max (Play Money) Seat #2 is the button
Seat 1: s70n3fac3 (6772 in chips) 
Seat 2: FDIBA2009 (3966 in chips) 
FDIBA2009: posts small blind 50
s70n3fac3: posts big blind 100
*** HOLE CARDS ***
FDIBA2009: raises 100 to 200
s70n3fac3: folds 
Uncalled bet (100) returned to FDIBA2009
FDIBA2009 collected 200 from pot
*** SUMMARY ***
Total pot 200 | Rake 0 
Seat 1: s70n3fac3 (big blind) folded before Flop
Seat 2: FDIBA2009 (button) (small blind) collected (200)



PokerStars Home Game Hand #226759814814: {Club #4781089}  Hold'em No Limit (50/100) - 2021/05/15 1:00:16 EET [2021/05/14 18:00:16 ET]
Table 'VTTP NLHE' 2-max (Play Money) Seat #1 is the button
Seat 1: s70n3fac3 (6672 in chips) 
Seat 2: FDIBA2009 (4066 in chips) 
s70n3fac3: posts small blind 50
FDIBA2009: posts big blind 100
*** HOLE CARDS ***
s70n3fac3: raises 150 to 250
FDIBA2009: raises 150 to 400
s70n3fac3: calls 150
*** FLOP *** [6d Qh Th]
FDIBA2009: checks 
s70n3fac3: checks 
*** TURN *** [6d Qh Th] [6h]
FDIBA2009: checks 
s70n3fac3: checks 
*** RIVER *** [6d Qh Th 6h] [Qc]
FDIBA2009: bets 756
s70n3fac3: folds 
Uncalled bet (756) returned to FDIBA2009
FDIBA2009 collected 756 from pot
*** SUMMARY ***
Total pot 800 | Rake 44 
Board [6d Qh Th 6h Qc]
Seat 1: s70n3fac3 (button) (small blind) folded on the River
Seat 2: FDIBA2009 (big blind) collected (756)



PokerStars Home Game Hand #226759828601: {Club #4781089}  Hold'em No Limit (50/100) - 2021/05/15 1:00:47 EET [2021/05/14 18:00:47 ET]
Table 'VTTP NLHE' 2-max (Play Money) Seat #2 is the button
Seat 1: s70n3fac3 (6272 in chips) 
Seat 2: FDIBA2009 (4422 in chips) 
FDIBA2009: posts small blind 50
s70n3fac3: posts big blind 100
*** HOLE CARDS ***
FDIBA2009: raises 100 to 200
s70n3fac3: calls 100
*** FLOP *** [Qs 2s 9s]
s70n3fac3: checks 
FDIBA2009: checks 
*** TURN *** [Qs 2s 9s] [Js]
s70n3fac3: checks 
FDIBA2009: checks 
*** RIVER *** [Qs 2s 9s Js] [Ks]
s70n3fac3: checks 
FDIBA2009: bets 378
s70n3fac3: calls 378
*** SHOW DOWN ***
FDIBA2009: shows [7d 8s] (a flush, King high)
s70n3fac3: mucks hand 
FDIBA2009 collected 1092 from pot
*** SUMMARY ***
Total pot 1156 | Rake 64 
Board [Qs 2s 9s Js Ks]
Seat 1: s70n3fac3 (big blind) mucked [6d Jd]
Seat 2: FDIBA2009 (button) (small blind) showed [7d 8s] and won (1092) with a flush, King high



PokerStars Home Game Hand #226759835947: {Club #4781089}  Hold'em No Limit (50/100) - 2021/05/15 1:01:03 EET [2021/05/14 18:01:03 ET]
Table 'VTTP NLHE' 2-max (Play Money) Seat #1 is the button
Seat 1: s70n3fac3 (5694 in chips) 
Seat 2: FDIBA2009 (4936 in chips) 
s70n3fac3: posts small blind 50
FDIBA2009: posts big blind 100
*** HOLE CARDS ***
s70n3fac3: folds 
Uncalled bet (50) returned to FDIBA2009
FDIBA2009 collected 100 from pot
*** SUMMARY ***
Total pot 100 | Rake 0 
Seat 1: s70n3fac3 (button) (small blind) folded before Flop
Seat 2: FDIBA2009 (big blind) collected (100)



PokerStars Home Game Hand #226759837978: {Club #4781089}  Hold'em No Limit (50/100) - 2021/05/15 1:01:08 EET [2021/05/14 18:01:08 ET]
Table 'VTTP NLHE' 2-max (Play Money) Seat #2 is the button
Seat 1: s70n3fac3 (5644 in chips) 
Seat 2: FDIBA2009 (4986 in chips) 
FDIBA2009: posts small blind 50
s70n3fac3: posts big blind 100
*** HOLE CARDS ***
FDIBA2009: raises 100 to 200
s70n3fac3: calls 100
*** FLOP *** [7h 5d 3h]
s70n3fac3: checks 
FDIBA2009: bets 189
s70n3fac3: raises 311 to 500
FDIBA2009: raises 4286 to 4786 and is all-in
s70n3fac3: calls 4286
*** TURN *** [7h 5d 3h] [Jc]
*** RIVER *** [7h 5d 3h Jc] [5s]
*** SHOW DOWN ***
s70n3fac3: shows [7d Td] (two pair, Sevens and Fives)
FDIBA2009: shows [4h Th] (a pair of Fives)
s70n3fac3 collected 9424 from pot
*** SUMMARY ***
Total pot 9972 | Rake 548 
Board [7h 5d 3h Jc 5s]
Seat 1: s70n3fac3 (big blind) showed [7d Td] and won (9424) with two pair, Sevens and Fives
Seat 2: FDIBA2009 (button) (small blind) showed [4h Th] and lost with a pair of Fives



